"TotalCases","StudentCases","EmployeeCases","nycsr_locationsiteid","nycsr_sitename","nycsr_building.nycsr_buildingid","nycsr_building.nycsr_longitude","nycsr_building.nycsr_latitude","nycsr_building.nycsr_buildingname","nycsr_building.nycsr_address"
1,1,0,"46b4977a-32f4-ea11-b882-24ee9a37d45c","Aviation Career & Technical Education High School - Q610 - Q610 - 24Q610 - 45-30 36 STREET","44b4977a-32f4-ea11-b882-24ee9a37d45c",-73929577,40743309,"AVIATION HS - Q","45-30 36 STREET"
1,0,1,"99dab801-ecf6-ea11-b883-24ee9a37d459","The Bronx School for Continuous Learners - X469 - X410 - 75X469 - 240 EAST 172 STREET","c856635c-33f4-ea11-b882-24ee9a37d45c",-73911366,40839307,"WILLIAM H. TAFT HS - X","240 EAST 172 STREET"
1,0,1,"74f4a0ef-eaf6-ea11-b883-24ee9a37d459","P.S. 370 - K370 - K370 - 75K370 - 3000 WEST 1 STREET","0be2abc9-30f4-ea11-b882-24ee9a37d45c",-73969872,40577709,"P.S. 370 - BROOKLYN","3000 WEST 1 STREET"
4,1,3,"d08521d0-32f4-ea11-b882-24ee9a37d45c","Port Richmond School for Visionary Learning - R068 - R066 - 31R068 - 1625 FOREST AVENUE","d18521d0-32f4-ea11-b882-24ee9a37d45c",-74142526,40624781,"ECC @1625 FOREST AVENUE - STATEN ISLAND","1625 FOREST AVENUE"
3,3,0,"d03159fa-30f4-ea11-b882-24ee9a37d45c","Sunset Park High School - K667 - K564 - 15K667 - 153 35th Street","18fc3df4-30f4-ea11-b882-24ee9a37d45c",-74004342,40655583,"SUNSET PARK HS - BROOKLYN","153 35th Street"
1,1,0,"cc0d3c5b-30f4-ea11-b882-24ee9a37d45c","P.S. 97 The Highlawn - K097 - K097 - 21K097 - 1855 Stillwell Avenue","cd0d3c5b-30f4-ea11-b882-24ee9a37d45c",-73985570,40601191,"P.S. 97 - BROOKLYN","1855 Stillwell Avenue"
2,2,0,"8a34aa92-31f4-ea11-b882-24ee9a37d45c","Essex Street Academy - M294 - M445 - 02M294 - 350 GRAND STREET","8834aa92-31f4-ea11-b882-24ee9a37d45c",-73989329,40717329,"SEWARD PARK HS - MANHATTAN","350 GRAND STREET"
6,5,1,"e8ed94c3-31f4-ea11-b882-24ee9a37d45c","Beacon High School - M479 - M912 - 03M479 - 522 WEST 44TH STREET","e7ed94c3-31f4-ea11-b882-24ee9a37d45c",-73996262,40760858,"BEACON HIGH SCHOOL - MANHATTAN","522 WEST 44TH STREET"
1,0,1,"882aa42b-33f4-ea11-b882-24ee9a37d45c","P186X Walter J. Damrosch School - X186 - X136 - 75X186 - 750 Jennings Street","892aa42b-33f4-ea11-b882-24ee9a37d45c",-73897797,40831388,"P.S. 186 (OLD J136) - BRONX","750 Jennings Street"
2,2,0,"9a886843-31f4-ea11-b882-24ee9a37d45c","Frederick Douglass Academy - M499 - M010 - 05M499 - 2581 7TH AVENUE","9b886843-31f4-ea11-b882-24ee9a37d45c",-73935746,40823988,"I.S. 10 (TANDEM M200) - MANHATTAN","2581 7TH AVENUE"
15,15,0,"75d92255-30f4-ea11-b882-24ee9a37d45c","J.H.S. 088 Peter Rouget - K088 - K088 - 15K088 - 544 7TH AVENUE","76d92255-30f4-ea11-b882-24ee9a37d45c",-73988743,40660805,"I.S. 88 - BROOKLYN","544 7TH AVENUE"
2,2,0,"a672c880-32f4-ea11-b882-24ee9a37d45c","Queens Metropolitan High School - Q686 - Q686 - 28Q686 - 91-30 METROPOLITAN AVENUE","a372c880-32f4-ea11-b882-24ee9a37d45c",-73855543,40708431,"METROPOLITAN AVENUE CAMPUS - QUEENS","91-30 METROPOLITAN AVENUE"
1,1,0,"ced27c6d-30f4-ea11-b882-24ee9a37d45c","Brooklyn Collaborative Studies - K448 - K142 - 15K448 - 610 HENRY STREET","cfd27c6d-30f4-ea11-b882-24ee9a37d45c",-74002022,40679462,"J.H.S. 142 - BROOKLYN","610 HENRY STREET"
6,5,1,"516e70b7-31f4-ea11-b882-24ee9a37d45c","P.S. 527 - East Side School for Social Action - M527 - M816 - 02M527 - 323 EAST 91 STREET","526e70b7-31f4-ea11-b882-24ee9a37d45c",-73947856,40780652,"P.S. 527 - East Side School for Social Action","323 EAST 91 STREET"
1,0,1,"73593c87-33f4-ea11-b882-24ee9a37d45c","P.S. 196 - X196 - X823 - 12X196 - 1025 Morrison Avenue","34a31781-33f4-ea11-b882-24ee9a37d45c",-73874162,40824989,"I.S. 123 MINISCHOOL - BRONX","1025 Morrison Avenue"
2,0,2,"290b210d-33f4-ea11-b882-24ee9a37d45c","P.S. 196 - X196 - X077 - 12X196 - 1250 WARD AVENUE","230b210d-33f4-ea11-b882-24ee9a37d45c",-73877305,40830811,"P.S. 195 - BRONX","1250 WARD AVENUE"
1,0,1,"ca92e6d5-30f4-ea11-b882-24ee9a37d45c","Academy of Innovative Technology - K618 - K420 - 19K618 - 999 JAMAICA AVENUE","c692e6d5-30f4-ea11-b882-24ee9a37d45c",-73869305,40693002,"FRANKLIN K. LANE HS - K","999 JAMAICA AVENUE"
1,0,1,"11af1f69-ebf6-ea11-b883-24ee9a37d459","District 2 Pre-K Center - M391 - M471 - 02M391 - 355 EAST 76 STREET","3fa6ba98-31f4-ea11-b882-24ee9a37d45c",-73954803,40770929,"PRE-K CENTER @ 355 EAST 76 STREET - MANHATTAN","355 EAST 76 STREET"
2,0,2,"35ebaa73-30f4-ea11-b882-24ee9a37d45c","P.S. 164 Caesar Rodney - K164 - K164 - 20K164 - 4211 14 AVENUE","36ebaa73-30f4-ea11-b882-24ee9a37d45c",-73985739,40637101,"P.S. 164 - BROOKLYN","4211 14 AVENUE"
3,0,3,"d917b7f4-32f4-ea11-b882-24ee9a37d45c","PS/MS 20 P.O.George J. Werdann, III - X020 - X020 - 10X020 - 3050 WEBSTER AVENUE","d817b7f4-32f4-ea11-b882-24ee9a37d45c",-73878731,40869482,"P.S. 20 - BRONX","3050 WEBSTER AVENUE"
1,0,1,"369ebaee-32f4-ea11-b882-24ee9a37d45c","P.S. 018 John Peter Zenger - X018 - X018 - 07X018 - 502 MORRIS AVENUE","379ebaee-32f4-ea11-b882-24ee9a37d45c",-73922697,40816369,"P.S. 18 - BRONX","502 MORRIS AVENUE"
5,5,0,"c7e0838c-31f4-ea11-b882-24ee9a37d45c","Battery Park City School - M276 - M276 - 02M276 - 55 BATTERY PLACE","c6e0838c-31f4-ea11-b882-24ee9a37d45c",-74017456,40706384,"P.S./I.S. 276 - MANHATTAN","55 BATTERY PLACE"
2,0,2,"682f7d06-31f4-ea11-b882-24ee9a37d45c","Excellence Boys Charter School - K593 - K783 - 84K593 - 225 Patchen Avenue","692f7d06-31f4-ea11-b882-24ee9a37d45c",-73925851,40683446,"Charter School of Excellence - Brooklyn","225 Patchen Avenue"
2,2,0,"ed1aad3c-30f4-ea11-b882-24ee9a37d45c","P.S. 029 John M. Harrigan - K029 - K029 - 15K029 - 425 HENRY STREET","ee1aad3c-30f4-ea11-b882-24ee9a37d45c",-73997447,40686843,"P.S. 29 - BROOKLYN","425 HENRY STREET"
5,5,0,"45474313-33f4-ea11-b882-24ee9a37d45c","Explorations Academy H.S. - X251 - X098 - 12X251 - 1619 BOSTON ROAD","3c474313-33f4-ea11-b882-24ee9a37d45c",-73890591,40836245,"I.S. 98 - BRONX","1619 BOSTON ROAD"
2,2,0,"efc1392a-30f4-ea11-b882-24ee9a37d45c","P.S. 003 The Bedford Village - K003 - K003 - 13K003 - 50 JEFFERSON AVENUE","f0c1392a-30f4-ea11-b882-24ee9a37d45c",-73955219,40682311,"P.S. 3 - BROOKLYN","50 JEFFERSON AVENUE"
4,0,4,"f58a0044-33f4-ea11-b882-24ee9a37d45c","The Urban Assembly Bronx Academy of Letters - X551 - X183 - 07X551 - 339 MORRIS AVENUE","ef8a0044-33f4-ea11-b882-24ee9a37d45c",-73925995,40813681,"J.H.S. 203 - BRONX","339 MORRIS AVENUE"
1,0,1,"2d6e3d68-31f4-ea11-b882-24ee9a37d45c","P.S. 38 Roberto Clemente - M038 - M121 - 04M038 - 232 EAST 103 STREET","2b6e3d68-31f4-ea11-b882-24ee9a37d45c",-73944762,40788668,"P.S. 38 (OLD M121) - MANHATTAN","232 EAST 103 STREET"
3,2,1,"a2778cb8-ebf6-ea11-b883-24ee9a37d459","P.S. Q993 - Q993 - Q570 - 75Q993 - 35-12 35TH AVENUE","2eb4977a-32f4-ea11-b882-24ee9a37d45c",-73925182,40756099,"FRANK SINATRA HIGH SCHOOL-Q","35-12 35TH AVENUE"
1,0,1,"15497593-33f4-ea11-b882-24ee9a37d45c","P.S. 9 Ryer Avenue Elementary School - X009 - X930 - 10X009 - 230 EAST 183 STREET","16497593-33f4-ea11-b882-24ee9a37d45c",-73898821,40856440,"P.S. 9 TEMP. C.R. BLDG. - X","230 EAST 183 STREET"
10,5,5,"0878931f-33f4-ea11-b882-24ee9a37d45c","Young Women's Leadership School of the Bronx - X568 - X117 - 09X568 - 1865 MORRIS AVENUE","0578931f-33f4-ea11-b882-24ee9a37d45c",-73909022,40848552,"I.S. 117 - BRONX","1865 MORRIS AVENUE"
2,0,2,"3fde5eb7-30f4-ea11-b882-24ee9a37d45c","P.S. 298 Dr. Betty Shabazz - K298 - K298 - 23K298 - 85 WATKINS STREET","3dde5eb7-30f4-ea11-b882-24ee9a37d45c",-73907718,40671015,"P.S. 298 - BROOKLYN","85 WATKINS STREET"
2,0,2,"139ebaee-32f4-ea11-b882-24ee9a37d45c","P.S. 006 West Farms - X006 - X006 - 12X006 - 1000 EAST TREMONT AVENUE","0e9ebaee-32f4-ea11-b882-24ee9a37d45c",-73882531,40840445,"P.S. 6 - BRONX","1000 EAST TREMONT AVENUE"
1,0,1,"cf2ff20c-32f4-ea11-b882-24ee9a37d45c","P.S./I.S. 116 William C. Hughley - Q116 - Q116 - 29Q116 - 107-25 WREN PLACE","d02ff20c-32f4-ea11-b882-24ee9a37d45c",-73781839,40700840,"P.S. 116 - QUEENS","107-25 WREN PLACE"
1,0,1,"5c2f77fa-31f4-ea11-b882-24ee9a37d45c","P.S. 060 Woodhaven - Q060 - Q060 - 27Q060 - 91-02 88 AVENUE","8e8946f4-31f4-ea11-b882-24ee9a37d45c",-73852792,40691467,"P.S. 60 - QUEENS","91-02 88 AVENUE"
3,0,3,"eeb98b86-30f4-ea11-b882-24ee9a37d45c","P.S. 195 Manhattan Beach - K195 - K195 - 22K195 - 131 IRWIN STREET","efb98b86-30f4-ea11-b882-24ee9a37d45c",-73943498,40580161,"P.S. 195 - BROOKLYN","131 IRWIN STREET"
2,2,0,"1c6e3d68-31f4-ea11-b882-24ee9a37d45c","P.S. 116 Mary Lindley Murray - M116 - M116 - 02M116 - 210 East 33 Street","1d6e3d68-31f4-ea11-b882-24ee9a37d45c",-73977906,40744511,"P.S. 116 - MANHATTAN","210 East 33 Street"
1,1,0,"969c11e8-30f4-ea11-b882-24ee9a37d45c","Park Slope Collegiate - K464 - K460 - 15K464 - 237 7 AVENUE","929c11e8-30f4-ea11-b882-24ee9a37d45c",-73978580,40669255,"John Jay Educational Campus","237 7 AVENUE"
1,1,0,"2fff3d8d-33f4-ea11-b882-24ee9a37d45c","Community School for Social Justice - X427 - X884 - 07X427 - 350 Gerard Avenue","2dff3d8d-33f4-ea11-b882-24ee9a37d45c",-73929960,40815712,"HEALTH OPPORTUNITIES HS - X","350 Gerard Avenue"
1,0,1,"45416e00-31f4-ea11-b882-24ee9a37d45c","District 20 Pre-K Center - K768 - K678 - 20K768 - 1423 62ND STREET","46416e00-31f4-ea11-b882-24ee9a37d45c",-73996423,40625978,"PRE-K CENTER @62ND STREET - BROOKLYN","1423 62ND STREET"
2,2,0,"39de5eb7-30f4-ea11-b882-24ee9a37d45c","P.S. 297 Abraham Stockton - K297 - K297 - 14K297 - 700 PARK AVENUE","38de5eb7-30f4-ea11-b882-24ee9a37d45c",-73948166,40697377,"P.S. 297 - BROOKLYN","700 PARK AVENUE"
4,3,1,"d1d27c6d-30f4-ea11-b882-24ee9a37d45c","The Brooklyn New School, P.S. 146 - K146 - K142 - 15K146 - 610 HENRY STREET","cfd27c6d-30f4-ea11-b882-24ee9a37d45c",-74002022,40679462,"J.H.S. 142 - BROOKLYN","610 HENRY STREET"
2,2,0,"c6b66262-32f4-ea11-b882-24ee9a37d45c","Business Technology Early College High School - Q315 - Q435 - 26Q315 - 230-17 HILLSIDE AVENUE","c4b66262-32f4-ea11-b882-24ee9a37d45c",-73739726,40733888,"MARTIN VAN BUREN HS - QUEENS","230-17 HILLSIDE AVENUE"
1,1,0,"8803194f-30f4-ea11-b882-24ee9a37d45c","Brooklyn Environmental Exploration School (BEES) - K664 - K073 - 23K664 - 251 MAC DOUGAL STREET","8503194f-30f4-ea11-b882-24ee9a37d45c",-73910719,40680679,"P.S. 73 - BROOKLYN","251 MAC DOUGAL STREET"
1,1,0,"e4454b50-32f4-ea11-b882-24ee9a37d45c","Learners and Leaders - Q305 - Q320 - 24Q305 - 360 SENECA AVENUE","e5454b50-32f4-ea11-b882-24ee9a37d45c",-73915359,40707343,"P.S. 320 - QUEENS","360 SENECA AVENUE"
4,3,1,"1402926e-32f4-ea11-b882-24ee9a37d45c","Academy of Medical Technology: A College Board School - Q309 - Q465 - 27Q309 - 8-21 BAY 25 STREET","0b02926e-32f4-ea11-b882-24ee9a37d45c",-73763995,40601537,"FAR ROCKAWAY HS - Q","8-21 BAY 25 STREET"
2,2,0,"4e767649-31f4-ea11-b882-24ee9a37d45c","P.S. 040 Augustus Saint-Gaudens - M040 - M040 - 02M040 - 320 EAST 20TH STREET","46767649-31f4-ea11-b882-24ee9a37d45c",-73981536,40735328,"P.S. 40 - MANHATTAN","320 EAST 20TH STREET"
1,1,0,"dca2f813-ebf6-ea11-b883-24ee9a37d459","The Joan Snow Pre-K Center - K853 - K063 - 22K853 - 1340 EAST 29TH STREET","c879df48-30f4-ea11-b882-24ee9a37d45c",-73946330,40618450,"PRE-K CENTER @1340 EAST 29TH STREET - BROOKLYN","1340 EAST 29TH STREET"
2,2,0,"ab0e6e25-32f4-ea11-b882-24ee9a37d45c","P.S. 183 Dr. Richard R. Green - Q183 - Q183 - 27Q183 - 2-45 BEACH 79 STREET","a30e6e25-32f4-ea11-b882-24ee9a37d45c",-73805866,40589220,"P.S. 183 - QUEENS","2-45 BEACH 79 STREET"
1,1,0,"fbcaf33e-6f01-ed11-b8db-24ee9a37d45c","Mosaic Pre-K Center - Q331 - Q369 - 24Q331 - 46-01 111th Street","96ccad4f-f81e-eb11-b885-24ee9a37d45c",-73843333,40747262,"PRE-K CENTER @ 111TH STREET - QUEENS","46-01 111th Street"
2,1,1,"29a10a44-32f4-ea11-b882-24ee9a37d45c","Learners and Leaders - Q305 - Q245 - 24Q305 - 378 Seneca Avenue","26a10a44-32f4-ea11-b882-24ee9a37d45c",-73914990,40706837,"P.S. 245 ECC - QUEENS","378 Seneca Avenue"
2,2,0,"1f005d7a-31f4-ea11-b882-24ee9a37d45c","P.S. 158 Bayard Taylor - M158 - M158 - 02M158 - 1458 YORK AVENUE","1d005d7a-31f4-ea11-b882-24ee9a37d45c",-73950745,40770215,"P.S. 158 - MANHATTAN","1458 YORK AVENUE"
2,1,1,"bbfab455-31f4-ea11-b882-24ee9a37d45c","James Weldon Johnson - M057 - M057 - 04M057 - 176 EAST 115 STREET","bcfab455-31f4-ea11-b882-24ee9a37d45c",-73941598,40797205,"P.S. 57 - MANHATTAN","176 EAST 115 STREET"
1,0,1,"532f7d06-31f4-ea11-b882-24ee9a37d45c","District 20 Pre-K Center - K768 - K767 - 20K768 - 1668 46th Street","542f7d06-31f4-ea11-b882-24ee9a37d45c",-73982211,40631776,"PRE-K CENTER @1668 46TH STREET, BROOKLYN, NY 11204","1668 46th Street"
3,1,2,"9669c231-32f4-ea11-b882-24ee9a37d45c","P.S. 201 The Discovery School for Inquiry and Research - Q201 - Q201 - 25Q201 - 65-11 155 STREET","9769c231-32f4-ea11-b882-24ee9a37d45c",-73813011,40736541,"P.S. 201 - QUEENS","65-11 155 STREET"
1,1,0,"8603194f-30f4-ea11-b882-24ee9a37d45c","Brooklyn Landmark Elementary School - K599 - K073 - 23K599 - 251 MAC DOUGAL STREET","8503194f-30f4-ea11-b882-24ee9a37d45c",-73910719,40680679,"P.S. 73 - BROOKLYN","251 MAC DOUGAL STREET"
1,1,0,"989c11e8-30f4-ea11-b882-24ee9a37d45c","Millennium Brooklyn HS - K684 - K460 - 15K684 - 237 7 AVENUE","929c11e8-30f4-ea11-b882-24ee9a37d45c",-73978580,40669255,"John Jay Educational Campus","237 7 AVENUE"
2,1,1,"58507380-31f4-ea11-b882-24ee9a37d45c","P.S./I.S. 187 Hudson Cliffs - M187 - M187 - 06M187 - 349 CABRINI BOULEVARD","59507380-31f4-ea11-b882-24ee9a37d45c",-73936840,40856239,"P.S./I.S. 187 - MANHATTAN","349 CABRINI BOULEVARD"
1,0,1,"4c5bc58c-30f4-ea11-b882-24ee9a37d45c","P.S. 214 Michael Friedsam - K214 - K214 - 19K214 - 2944 PITKIN AVENUE","4b5bc58c-30f4-ea11-b882-24ee9a37d45c",-73862961,40675881,"P.S. 214 - BROOKLYN","2944 PITKIN AVENUE"
2,0,2,"8128a20c-31f4-ea11-b882-24ee9a37d45c","Achievement First Endeavor Charter School - K508 - K784 - 84K508 - 510 WAVERLY AVENUE","8228a20c-31f4-ea11-b882-24ee9a37d45c",-73965928,40682422,"ACHIEVEMENT FIRST ENDEAVOR CHARTER SCHOOL - K","510 WAVERLY AVENUE"
1,1,0,"18f32ce2-31f4-ea11-b882-24ee9a37d45c","P.S. 019 Marino Jeantet - Q019 - Q019 - 24Q019 - 98-02 ROOSEVELT AVENUE","19f32ce2-31f4-ea11-b882-24ee9a37d45c",-73866557,40748600,"P.S. 19 - QUEENS","98-02 ROOSEVELT AVENUE"
1,1,0,"1a9ebaee-32f4-ea11-b882-24ee9a37d45c","P.S. 008 Isaac Varian - X008 - X008 - 10X008 - 3010 BRIGGS AVENUE","1b9ebaee-32f4-ea11-b882-24ee9a37d45c",-73883339,40872259,"P.S. 8 - BRONX","3010 BRIGGS AVENUE"
1,0,1,"2d0d6d19-33f4-ea11-b882-24ee9a37d45c","Bronx Little School - X691 - X102 - 12X691 - 1827 ARCHER STREET","290d6d19-33f4-ea11-b882-24ee9a37d45c",-73866038,40838151,"P.S. 102 - BRONX","1827 ARCHER STREET"
1,1,0,"ce92e6d5-30f4-ea11-b882-24ee9a37d45c","Cypress Hills Collegiate Preparatory School - K659 - K420 - 19K659 - 999 JAMAICA AVENUE","c692e6d5-30f4-ea11-b882-24ee9a37d45c",-73869305,40693002,"FRANKLIN K. LANE HS - K","999 JAMAICA AVENUE"
1,0,1,"c38442ee-31f4-ea11-b882-24ee9a37d45c","The Jermaine L. Green STEM Institute of Queens - Q354 - Q030 - 28Q354 - 126-10 BEDELL STREET","c48442ee-31f4-ea11-b882-24ee9a37d45c",-73774668,40679843,"P.S. 30 - QUEENS","126-10 BEDELL STREET"
2,0,2,"4b953aac-ebf6-ea11-b883-24ee9a37d459","Mosaic Pre-K Center - Q331 - Q391 - 24Q331 - 4415 Judge Street","9deb6056-32f4-ea11-b882-24ee9a37d45c",-73877451,40742972,"PRE-K CENTER @ 44-15 JUDGE STREET - QUEENS","4415 Judge Street"
2,2,0,"77c280bd-31f4-ea11-b882-24ee9a37d45c","The Clinton School - M260 - M868 - 02M260 - 10 East 15th Street","78c280bd-31f4-ea11-b882-24ee9a37d45c",-73992727,40736526,"THE CLINTON SCHOOL - MANHATTAN","10 East 15th Street"
1,1,0,"0d68ee1e-31f4-ea11-b882-24ee9a37d45c","New Visions A.I.M. Charter High School I - K395 - K907 - 84K395 - 1150 East New York Avenue","0b68ee1e-31f4-ea11-b882-24ee9a37d45c",-73923881,40666251,"BROWNSVILLE DIPLOMA PLUS HS - K","1150 East New York Avenue"
2,2,0,"44ff3d8d-33f4-ea11-b882-24ee9a37d45c","High School of American Studies at Lehman College - X696 - X905 - 10X696 - 2925 Goulden Avenue","45ff3d8d-33f4-ea11-b882-24ee9a37d45c",-73895543,40874725,"HS OF AMERICAN STUDIES - BRONX","2925 Goulden Avenue"
9,9,0,"435b4cd6-32f4-ea11-b882-24ee9a37d45c","New Dorp High School - R440 - R435 - 31R440 - 465 NEW DORP LANE","fb8521d0-32f4-ea11-b882-24ee9a37d45c",-74105878,40570909,"NEW DORP HS (NEW) - S. I.","465 NEW DORP LANE"
1,0,1,"2b0d6d19-33f4-ea11-b882-24ee9a37d45c","Archer Elementary School - X531 - X102 - 12X531 - 1827 ARCHER STREET","290d6d19-33f4-ea11-b882-24ee9a37d45c",-73866038,40838151,"P.S. 102 - BRONX","1827 ARCHER STREET"
1,0,1,"52395a2c-ebf6-ea11-b883-24ee9a37d459","Community Partnership Charter School - K702 - K256 - 84K702 - 114 KOSCIUSZKO STREET","9f83ff9e-30f4-ea11-b882-24ee9a37d45c",-73949610,40690595,"P.S. 256 - BROOKLYN","114 KOSCIUSZKO STREET"
2,1,1,"8f977d2b-32f4-ea11-b882-24ee9a37d45c","P.S. 196 Grand Central Parkway - Q196 - Q196 - 28Q196 - 71-25 113 STREET","90977d2b-32f4-ea11-b882-24ee9a37d45c",-73837379,40722792,"P.S. 196 - QUEENS","71-25 113 STREET"
2,2,0,"fd8052e9-ebf6-ea11-b883-24ee9a37d459","Mott Hall Charter School - X177 - X063 - 84X177 - 1260 FRANKLIN AVENUE","8736d900-33f4-ea11-b882-24ee9a37d45c",-73901859,40830930,"P.S. 63 - BRONX","1260 FRANKLIN AVENUE"
1,0,1,"077eed06-32f4-ea11-b882-24ee9a37d45c","P.S. 082 Hammond - Q082 - Q082 - 28Q082 - 88-02 144 STREET","e3e8ce00-32f4-ea11-b882-24ee9a37d45c",-73812200,40703897,"P.S. 82 - QUEENS","88-02 144 STREET"
1,0,1,"470410ca-32f4-ea11-b882-24ee9a37d45c","The Harbor View School - R059 - R059 - 31R059 - 300 Richmond Terrace","480410ca-32f4-ea11-b882-24ee9a37d45c",-74083408,40647898,"THE HARBOR VIEW SCHOOL - STATEN ISLAND","300 Richmond Terrace"
2,0,2,"553cbf01-ebf6-ea11-b883-24ee9a37d459","The David Marquis School of the Arts - R037 - R840 - 75R037 - 15 Fairfield Street","81be7adc-32f4-ea11-b882-24ee9a37d45c",-74151368,40564100,"P.S. 37 ( OLD I24X)-STATEN ISLAND","15 Fairfield Street"
1,0,1,"37767649-31f4-ea11-b882-24ee9a37d45c","P.S. 138 - M138 - M030 - 75M138 - 144-176 EAST 128 STREET","38767649-31f4-ea11-b882-24ee9a37d45c",-73935461,40805653,"P.S. 30 - MANHATTAN","144-176 EAST 128 STREET"
4,1,3,"9b53dd74-33f4-ea11-b882-24ee9a37d45c","Bronx School of Law and Finance - X284 - X475 - 10X284 - 99 TERRACE VIEW AVENUE","9853dd74-33f4-ea11-b882-24ee9a37d45c",-73912686,40877379,"JOHN F. KENNEDY HS - X","99 TERRACE VIEW AVENUE"
2,2,0,"9cd810ab-31f4-ea11-b882-24ee9a37d45c","NYC iSchool - M376 - M615 - 02M376 - 131 AVENUE OF THE AMERICAS","9ad810ab-31f4-ea11-b882-24ee9a37d45c",-74005058,40724630,"CHELSEA VOC HS - MANHATTAN","131 AVENUE OF THE AMERICAS"
2,1,1,"82f4a0ef-eaf6-ea11-b883-24ee9a37d459","The Little Brooklyn Pre-K Center - K767 - K749 - 15K767 - 173-177 25TH STREET","492f7d06-31f4-ea11-b882-24ee9a37d45c",-73998973,40661059,"PRE-K CENTER @25TH STREET - BROOKLYN","173-177 25TH STREET"
1,0,1,"2d0b210d-33f4-ea11-b882-24ee9a37d45c","P.S. 078 Anne Hutchinson - X078 - X078 - 11X078 - 1400 NEEDHAM AVENUE","2e0b210d-33f4-ea11-b882-24ee9a37d45c",-73850563,40878474,"P.S. 78 - BRONX","1400 NEEDHAM AVENUE"
1,0,1,"8ba87f90-5a04-ec11-b8b4-24ee9a37d45c","Hunters Point Elementary School - Q384 - Q375 - 30Q384 - 1-35 57 Avenue","8ca87f90-5a04-ec11-b8b4-24ee9a37d45c",-73960836,40738864,"Hunters Point","1-35 57 Avenue"
1,0,1,"92977d2b-32f4-ea11-b882-24ee9a37d45c","P.S. 197 The Ocean School - Q197 - Q197 - 27Q197 - 825 HICKSVILLE ROAD","93977d2b-32f4-ea11-b882-24ee9a37d45c",-73744128,40599664,"P.S. 197 - QUEENS","825 HICKSVILLE ROAD"
1,0,1,"ea17b7f4-32f4-ea11-b882-24ee9a37d45c","P.S. 023 The New Children's School - X023 - X023 - 10X023 - 2151 WASHINGTON AVENUE","eb17b7f4-32f4-ea11-b882-24ee9a37d45c",-73894951,40853294,"P.S. 23 - BRONX","2151 WASHINGTON AVENUE"
1,1,0,"58767649-31f4-ea11-b882-24ee9a37d45c","Urban Assembly School for the Performing Arts - M369 - M043 - 05M369 - 509 WEST 129 STREET","59767649-31f4-ea11-b882-24ee9a37d45c",-73955520,40815747,"I.S. 172 (OLD 43) - MANHATTAN","509 WEST 129 STREET"
1,0,1,"4a9587f5-ebf6-ea11-b883-24ee9a37d459","P.S. X010 - X010 - X162 - 75X010 - 600 SAINT ANN'S AVENUE","032ed53d-33f4-ea11-b882-24ee9a37d45c",-73912038,40814857,"I.S. 162 - BRONX","600 SAINT ANN'S AVENUE"
1,0,1,"60fdc1bd-32f4-ea11-b882-24ee9a37d45c","P.S. 019 The Curtis School - R019 - R019 - 31R019 - 780 Post Avenue","61fdc1bd-32f4-ea11-b882-24ee9a37d45c",-74126851,40630563,"P.S. 19 - STATEN ISLAND","780 Post Avenue"
2,2,0,"f8ce496e-31f4-ea11-b882-24ee9a37d45c","Castle Bridge School - M513 - M128 - 06M513 - 560 WEST 169 STREET","f9ce496e-31f4-ea11-b882-24ee9a37d45c",-73938701,40841032,"P.S. 128 - MANHATTAN","560 WEST 169 STREET"
1,0,1,"1206003e-32f4-ea11-b882-24ee9a37d45c","P.S. 232 Lindenwood - Q232 - Q232 - 27Q232 - 153-23 83 STREET","1106003e-32f4-ea11-b882-24ee9a37d45c",-73850622,40665408,"P.S. 232 - QUEENS","153-23 83 STREET"
