"TotalCases","StudentCases","EmployeeCases","nycsr_locationsiteid","nycsr_sitename","nycsr_building.nycsr_buildingid","nycsr_building.nycsr_longitude","nycsr_building.nycsr_latitude","nycsr_building.nycsr_buildingname","nycsr_building.nycsr_address"
4,0,4,"47953aac-ebf6-ea11-b883-24ee9a37d459","Mosaic Pre-K Center - Q331 - Q372 - 24Q331 - 104-14 ROOSEVELT AVENUE","8beb6056-32f4-ea11-b882-24ee9a37d45c",-73861044,40749771,"PRE-K CENTER @ 104-14 ROOSEVELT AVENUE - QUEENS","104-14 ROOSEVELT AVENUE"
1,1,0,"dff57030-30f4-ea11-b882-24ee9a37d45c","P.S. 011 Purvis J. Behan - K011 - K011 - 13K011 - 419 WAVERLY AVENUE","e0f57030-30f4-ea11-b882-24ee9a37d45c",-73965890,40685896,"P.S. 11 - BROOKLYN","419 WAVERLY AVENUE"
4,3,1,"46b4977a-32f4-ea11-b882-24ee9a37d45c","Aviation Career & Technical Education High School - Q610 - Q610 - 24Q610 - 45-30 36 STREET","44b4977a-32f4-ea11-b882-24ee9a37d45c",-73929577,40743309,"AVIATION HS - Q","45-30 36 STREET"
1,0,1,"4c9f4974-31f4-ea11-b882-24ee9a37d45c","P.S. 145, The Bloomingdale School - M145 - M145 - 03M145 - 150 West 105 Street","4a9f4974-31f4-ea11-b882-24ee9a37d45c",-73965611,40799098,"P.S. 145 - MANHATTAN","150 West 105 Street"
15,12,3,"435b4cd6-32f4-ea11-b882-24ee9a37d45c","New Dorp High School - R440 - R435 - 31R440 - 465 NEW DORP LANE","fb8521d0-32f4-ea11-b882-24ee9a37d45c",-74105878,40570909,"NEW DORP HS (NEW) - S. I.","465 NEW DORP LANE"
2,1,1,"9669c231-32f4-ea11-b882-24ee9a37d45c","P.S. 201 The Discovery School for Inquiry and Research - Q201 - Q201 - 25Q201 - 65-11 155 STREET","9769c231-32f4-ea11-b882-24ee9a37d45c",-73813011,40736541,"P.S. 201 - QUEENS","65-11 155 STREET"
3,0,3,"cc201dab-30f4-ea11-b882-24ee9a37d45c","P.S. 272 Curtis Estabrook - K272 - K272 - 18K272 - 101-24 SEAVIEW AVENUE","cd201dab-30f4-ea11-b882-24ee9a37d45c",-73886373,40635542,"P.S. 272 - BROOKLYN","101-24 SEAVIEW AVENUE"
2,2,0,"539d7c62-33f4-ea11-b882-24ee9a37d45c","Pan American International High School at Monroe - X388 - X420 - 12X388 - 1300 BOYNTON AVENUE","519d7c62-33f4-ea11-b882-24ee9a37d45c",-73878191,40832508,"JAMES MONROE EDUCATIONAL CAMPUS - X","1300 BOYNTON AVENUE"
2,2,0,"aa72c880-32f4-ea11-b882-24ee9a37d45c","High School for Law Enforcement and Public Safety - Q690 - Q690 - 28Q690 - 116-25 GUY R BREWER BOULEVARD","a972c880-32f4-ea11-b882-24ee9a37d45c",-73783438,40685838,"HS FOR LAW ENFORCEMENT - QUEENS","116-25 GUY R BREWER BOULEVARD"
4,1,3,"822f77fa-31f4-ea11-b882-24ee9a37d45c","P.S. 071 Forest - Q071 - Q071 - 24Q071 - 62-85 FOREST AVENUE","802f77fa-31f4-ea11-b882-24ee9a37d45c",-73904798,40711388,"P.S. 71 - QUEENS","62-85 FOREST AVENUE"
1,1,0,"80a78d44-ebf6-ea11-b883-24ee9a37d459","The Little Brooklyn Pre-K Center - K767 - K692 - 15K767 - 305-307 THIRD AVENUE","50416e00-31f4-ea11-b882-24ee9a37d45c",-73986646,40676679,"PRE-K CENTER @THIRD AVENUE - BROOKLYN","305-307 THIRD AVENUE"
1,1,0,"a153dd74-33f4-ea11-b882-24ee9a37d45c","New Visions Charter High School for Advanced Math and Science - X539 - X475 - 84X539 - 99 TERRACE VIEW AVENUE","9853dd74-33f4-ea11-b882-24ee9a37d45c",-73912686,40877379,"JOHN F. KENNEDY HS - X","99 TERRACE VIEW AVENUE"
1,1,0,"ebd10307-33f4-ea11-b882-24ee9a37d45c","P.S. 069 Journey Prep School - X069 - X069 - 08X069 - 560 THIERIOT AVENUE","ecd10307-33f4-ea11-b882-24ee9a37d45c",-73860460,40816700,"P.S. 69 - BRONX","560 THIERIOT AVENUE"
1,0,1,"89283fb1-30f4-ea11-b882-24ee9a37d45c","Achievement First Brownsville Charter School - K626 - K292 - 84K626 - 301 VERMONT STREET","8a283fb1-30f4-ea11-b882-24ee9a37d45c",-73893319,40671601,"I.S. 292 - BROOKLYN","301 VERMONT STREET"
1,1,0,"39de5eb7-30f4-ea11-b882-24ee9a37d45c","P.S. 297 Abraham Stockton - K297 - K297 - 14K297 - 700 PARK AVENUE","38de5eb7-30f4-ea11-b882-24ee9a37d45c",-73948166,40697377,"P.S. 297 - BROOKLYN","700 PARK AVENUE"
2,0,2,"8341e65b-31f4-ea11-b882-24ee9a37d45c","P.S. 083 Luis Munoz Rivera - M083 - M083 - 04M083 - 219 East 109 Street","8141e65b-31f4-ea11-b882-24ee9a37d45c",-73941955,40793363,"P.S. 83 - MANHATTAN","219 East 109 Street"
1,0,1,"f89b4c1f-32f4-ea11-b882-24ee9a37d45c","P.S. 160 Walter Francis Bishop - Q160 - Q160 - 28Q160 - 109-59 INWOOD STREET","ee9b4c1f-32f4-ea11-b882-24ee9a37d45c",-73799685,40688373,"P.S. 160 - QUEENS","109-59 INWOOD STREET"
2,2,0,"77c280bd-31f4-ea11-b882-24ee9a37d45c","The Clinton School - M260 - M868 - 02M260 - 10 East 15th Street","78c280bd-31f4-ea11-b882-24ee9a37d45c",-73992727,40736526,"THE CLINTON SCHOOL - MANHATTAN","10 East 15th Street"
2,2,0,"790e6e25-32f4-ea11-b882-24ee9a37d45c","P.S. 166 Henry Gradstein - Q166 - Q166 - 30Q166 - 33-09 35 AVENUE","7a0e6e25-32f4-ea11-b882-24ee9a37d45c",-73926249,40757497,"P.S. 166 - QUEENS","33-09 35 AVENUE"
6,6,0,"0878931f-33f4-ea11-b882-24ee9a37d45c","Young Women's Leadership School of the Bronx - X568 - X117 - 09X568 - 1865 MORRIS AVENUE","0578931f-33f4-ea11-b882-24ee9a37d45c",-73909022,40848552,"I.S. 117 - BRONX","1865 MORRIS AVENUE"
1,0,1,"4c5bc58c-30f4-ea11-b882-24ee9a37d45c","P.S. 214 Michael Friedsam - K214 - K214 - 19K214 - 2944 PITKIN AVENUE","4b5bc58c-30f4-ea11-b882-24ee9a37d45c",-73862961,40675881,"P.S. 214 - BROOKLYN","2944 PITKIN AVENUE"
1,0,1,"3c0b4f85-dafe-eb11-b8b2-24ee9a37d45c","District 12 Pre-K Center - X626 - X493 - 12X626 - 1222 Prospect Avenue","3d0b4f85-dafe-eb11-b8b2-24ee9a37d45c",-73898165,40827077,"3K CENTER @ PROSPECT AVENUE - BRONX","1222 Prospect Avenue"
2,0,2,"6336d900-33f4-ea11-b882-24ee9a37d45c","P.S. 053 Basheer Quisim - X053 - X053 - 09X053 - 360 EAST 168 STREET","6436d900-33f4-ea11-b882-24ee9a37d45c",-73911906,40832648,"P.S. 53 - BRONX","360 EAST 168 STREET"
1,0,1,"73593c87-33f4-ea11-b882-24ee9a37d45c","P.S. 196 - X196 - X823 - 12X196 - 1025 Morrison Avenue","34a31781-33f4-ea11-b882-24ee9a37d45c",-73874162,40824989,"I.S. 123 MINISCHOOL - BRONX","1025 Morrison Avenue"
1,0,1,"95593c87-33f4-ea11-b882-24ee9a37d45c","P.S. 053 Basheer Quisim - X053 - X851 - 09X053 - 360 EAST 168 STREET","96593c87-33f4-ea11-b882-24ee9a37d45c",-73911906,40832648,"P.S. 53 MINISCHOOL #1 - BRONX","360 EAST 168 STREET"
8,3,5,"f58a0044-33f4-ea11-b882-24ee9a37d45c","The Urban Assembly Bronx Academy of Letters - X551 - X183 - 07X551 - 339 MORRIS AVENUE","ef8a0044-33f4-ea11-b882-24ee9a37d45c",-73925995,40813681,"J.H.S. 203 - BRONX","339 MORRIS AVENUE"
4,4,0,"ed1aad3c-30f4-ea11-b882-24ee9a37d45c","P.S. 029 John M. Harrigan - K029 - K029 - 15K029 - 425 HENRY STREET","ee1aad3c-30f4-ea11-b882-24ee9a37d45c",-73997447,40686843,"P.S. 29 - BROOKLYN","425 HENRY STREET"
2,2,0,"3dc15a75-ebf6-ea11-b883-24ee9a37d459","Urban Assembly New York Harbor School - M551 - M871 - 02M551 - 134 CARDER ROAD","7bc280bd-31f4-ea11-b882-24ee9a37d45c",-74013582,40692063,"NYHS - BOATHOUSE","134 CARDER ROAD"
9,5,4,"8fa9d9c3-32f4-ea11-b882-24ee9a37d45c","P.S. 036 J. C. Drumgoole - R036 - R036 - 31R036 - 255 IONIA AVENUE","8ba9d9c3-32f4-ea11-b882-24ee9a37d45c",-74182548,40543433,"P.S. 36 - STATEN ISLAND","255 IONIA AVENUE"
6,4,2,"f9ae0313-32f4-ea11-b882-24ee9a37d45c","P.S. 124 Osmond A Church - Q124 - Q124 - 27Q124 - 129-15 150 AVENUE","faae0313-32f4-ea11-b882-24ee9a37d45c",-73811266,40665669,"P.S. 124 - QUEENS","129-15 150 AVENUE"
1,1,0,"d456635c-33f4-ea11-b882-24ee9a37d45c","Claremont International HS - X564 - X410 - 09X564 - 240 EAST 172 STREET","c856635c-33f4-ea11-b882-24ee9a37d45c",-73911366,40839307,"WILLIAM H. TAFT HS - X","240 EAST 172 STREET"
2,1,1,"3c9f4974-31f4-ea11-b882-24ee9a37d45c","P.S. 142 Amalia Castro - M142 - M142 - 01M142 - 100 ATTORNEY STREET","379f4974-31f4-ea11-b882-24ee9a37d45c",-73984116,40718121,"P.S. 142 - MANHATTAN","100 ATTORNEY STREET"
7,6,1,"29b7c337-32f4-ea11-b882-24ee9a37d45c","I.S. 227 Louis Armstrong - Q227 - Q227 - 30Q227 - 32-02 JUNCTION BOULEVARD","27b7c337-32f4-ea11-b882-24ee9a37d45c",-73874614,40757567,"I.S. 227 - QUEENS","32-02 JUNCTION BOULEVARD"
1,1,0,"c4ab074a-33f4-ea11-b882-24ee9a37d45c","I.S. 206 Ann Mersereau - X206 - X206 - 10X206 - 2280 AQUEDUCT AVENUE","c5ab074a-33f4-ea11-b882-24ee9a37d45c",-73906285,40859534,"I.S. 206B - BRONX","2280 AQUEDUCT AVENUE"
3,3,0,"3b0d6d19-33f4-ea11-b882-24ee9a37d45c","P.S. 106 Parkchester - X106 - X106 - 11X106 - 1514 OLMSTEAD AVENUE","3c0d6d19-33f4-ea11-b882-24ee9a37d45c",-73854823,40836974,"P.S. 106 - BRONX","1514 OLMSTEAD AVENUE"
21,17,4,"afd810ab-31f4-ea11-b882-24ee9a37d45c","Urban Assembly Gateway School for Technology - M507 - M625 - 02M507 - 439 WEST 49TH STREET","a9d810ab-31f4-ea11-b882-24ee9a37d45c",-73990318,40763655,"HS OF GRAPHIC COMMUNICATION ARTS-M","439 WEST 49TH STREET"
14,12,2,"75d92255-30f4-ea11-b882-24ee9a37d45c","J.H.S. 088 Peter Rouget - K088 - K088 - 15K088 - 544 7TH AVENUE","76d92255-30f4-ea11-b882-24ee9a37d45c",-73988743,40660805,"I.S. 88 - BROOKLYN","544 7TH AVENUE"
1,0,1,"95778cb8-ebf6-ea11-b883-24ee9a37d459","The Riverview School - Q277 - Q485 - 75Q277 - 21-27 HIMROD STREET","74bc9674-32f4-ea11-b882-24ee9a37d45c",-73909202,40711881,"GROVER CLEVELAND HS - Q","21-27 HIMROD STREET"
2,1,1,"82f4a0ef-eaf6-ea11-b883-24ee9a37d459","The Little Brooklyn Pre-K Center - K767 - K749 - 15K767 - 173-177 25TH STREET","492f7d06-31f4-ea11-b882-24ee9a37d45c",-73998973,40661059,"PRE-K CENTER @25TH STREET - BROOKLYN","173-177 25TH STREET"
4,2,2,"b1eb6056-32f4-ea11-b882-24ee9a37d45c","August Martin High School - Q400 - Q400 - 27Q400 - 156-10 BAISLEY BOULEVARD","a9eb6056-32f4-ea11-b882-24ee9a37d45c",-73782684,40673949,"AUGUST MARTIN HS - QUEENS","156-10 BAISLEY BOULEVARD"
1,0,1,"5ef4a0ef-eaf6-ea11-b883-24ee9a37d459","P.S. K140 - K140 - K258 - 75K140 - 141 MACON STREET","b183ff9e-30f4-ea11-b882-24ee9a37d45c",-73945600,40681920,"I.S. 258 - BROOKLYN","141 MACON STREET"
1,0,1,"ff3159fa-30f4-ea11-b882-24ee9a37d45c","ALC- Brighton Academy - K984 - K620 - 88K984 - 25 Brighton 4th Road","f73159fa-30f4-ea11-b882-24ee9a37d45c",-73963764,40583263,"WILLIAM E. GRADY VOC HS - K","25 Brighton 4th Road"
4,2,2,"c837fba4-31f4-ea11-b882-24ee9a37d45c","Park East High School - M495 - M495 - 04M495 - 230 EAST 105 STREET","c737fba4-31f4-ea11-b882-24ee9a37d45c",-73944092,40790191,"PARK EAST HS - MANHATTAN","230 EAST 105 STREET"
1,1,0,"16e63126-ebf6-ea11-b883-24ee9a37d459","235 Anx - K638 - K235 -  - 525 LENOX ROAD","53a5db98-30f4-ea11-b882-24ee9a37d45c",-73940922,40655337,"P.S. 235 - BROOKLYN","525 LENOX ROAD"
5,3,2,"ef9b4c1f-32f4-ea11-b882-24ee9a37d45c","J.H.S. 157 Stephen A. Halsey - Q157 - Q157 - 28Q157 - 63-55 102ND STREET","f09b4c1f-32f4-ea11-b882-24ee9a37d45c",-73852879,40732348,"J.H.S. 157 - QUEENS","63-55 102ND STREET"
3,2,1,"4c8dbfcf-30f4-ea11-b882-24ee9a37d45c","Midwood High School - K405 - K405 - 22K405 - 2839 BEDFORD AVENUE","4d8dbfcf-30f4-ea11-b882-24ee9a37d45c",-73952356,40632829,"MIDWOOD HS - K","2839 BEDFORD AVENUE"
3,2,1,"722f77fa-31f4-ea11-b882-24ee9a37d45c","J.H.S. 067 Louis Pasteur - Q067 - Q067 - 26Q067 - 51-60 MARATHON PARKWAY","732f77fa-31f4-ea11-b882-24ee9a37d45c",-73734832,40762241,"J.H.S. 67 - QUEENS","51-60 MARATHON PARKWAY"
1,0,1,"c1ba3c50-33f4-ea11-b882-24ee9a37d45c","I.S. 254 - X254 - X254 - 10X254 - 2452 WASHINGTON AVENUE","c2ba3c50-33f4-ea11-b882-24ee9a37d45c",-73889878,40858721,"I.S. 254 - BRONX","2452 WASHINGTON AVENUE"
2,0,2,"553cbf01-ebf6-ea11-b883-24ee9a37d459","The David Marquis School of the Arts - R037 - R840 - 75R037 - 15 Fairfield Street","81be7adc-32f4-ea11-b882-24ee9a37d45c",-74151368,40564100,"P.S. 37 ( OLD I24X)-STATEN ISLAND","15 Fairfield Street"
3,2,1,"340410ca-32f4-ea11-b882-24ee9a37d45c","The Barbara Esselborn School - R053 - R053 - 31R053 - 330 DURANT AVENUE","350410ca-32f4-ea11-b882-24ee9a37d45c",-74136640,40551926,"P.S. 53 - STATEN ISLAND","330 DURANT AVENUE"
2,1,1,"ac2aa42b-33f4-ea11-b882-24ee9a37d45c","The New School for Leadership and Journalism - X244 - X143 - 10X244 - 120 WEST 231 STREET","ad2aa42b-33f4-ea11-b882-24ee9a37d45c",-73901565,40875636,"I.S. 143 - BRONX","120 WEST 231 STREET"
1,0,1,"7ef4a0ef-eaf6-ea11-b883-24ee9a37d459","P.S. K721 - Brooklyn Occupational Training Center - K721 - K722 - 75K721 - 64 AVENUE X","392f7d06-31f4-ea11-b882-24ee9a37d45c",-73981925,40588070,"P.S. 721 OTC - BROOKLYN","64 AVENUE X"
2,1,1,"0dd1de79-30f4-ea11-b882-24ee9a37d45c","P.S. 177 The Marlboro - K177 - K177 - 21K177 - 346 AVENUE P","0ed1de79-30f4-ea11-b882-24ee9a37d45c",-73974425,40608169,"P.S. 177 - BROOKLYN","346 AVENUE P"
8,7,1,"8b01ce37-33f4-ea11-b882-24ee9a37d45c","Bronx Latin - X267 - X158 - 12X267 - 800 HOME STREET","8601ce37-33f4-ea11-b882-24ee9a37d45c",-73900593,40826933,"I.S. 158 - BRONX","800 HOME STREET"
6,6,0,"7aa9d9c3-32f4-ea11-b882-24ee9a37d45c","P.S. 029 Bardwell - R029 - R029 - 31R029 - 1581 VICTORY BOULEVARD","7ba9d9c3-32f4-ea11-b882-24ee9a37d45c",-74116197,40614039,"P.S. 29 - STATEN ISLAND","1581 VICTORY BOULEVARD"
3,3,0,"141bad3c-30f4-ea11-b882-24ee9a37d45c","I.S. 98 Bay Academy - K098 - K043 - 21K098 - 1401 EMMONS AVENUE","151bad3c-30f4-ea11-b882-24ee9a37d45c",-73954047,40583893,"I.S. 98 - BROOKLYN","1401 EMMONS AVENUE"
1,1,0,"cee0838c-31f4-ea11-b882-24ee9a37d45c","The River School - M281 - M281 - 02M281 - 425 East 35 Street","cde0838c-31f4-ea11-b882-24ee9a37d45c",-73972592,40744288,"P.S. 281 - MANHATTAN","425 East 35 Street"
1,1,0,"2cff3d8d-33f4-ea11-b882-24ee9a37d45c","Health Opportunities High School - X670 - X884 - 07X670 - 350 Gerard Avenue","2dff3d8d-33f4-ea11-b882-24ee9a37d45c",-73929960,40815712,"HEALTH OPPORTUNITIES HS - X","350 Gerard Avenue"
1,0,1,"10ba8b86-30f4-ea11-b882-24ee9a37d45c","P.S. 205 Clarion - K205 - K205 - 20K205 - 6701 20 AVENUE","11ba8b86-30f4-ea11-b882-24ee9a37d45c",-73986792,40614737,"P.S. 205 - BROOKLYN","6701 20 AVENUE"
4,4,0,"9d886843-31f4-ea11-b882-24ee9a37d45c","P.S. 011: The Sarah J. Garnet Elementary School - M011 - M011 - 02M011 - 320 WEST 21 STREET","9e886843-31f4-ea11-b882-24ee9a37d45c",-74000743,40744186,"P.S. 11 - MANHATTAN","320 WEST 21 STREET"
1,1,0,"1b474313-33f4-ea11-b882-24ee9a37d45c","Sheridan Academy for Young Leaders - X457 - X090 - 09X457 - 1116 SHERIDAN AVENUE","1c474313-33f4-ea11-b882-24ee9a37d45c",-73917526,40831873,"P.S. 90 - BRONX","1116 SHERIDAN AVENUE"
1,1,0,"7201ce37-33f4-ea11-b882-24ee9a37d45c","P.S. 154 Jonathan D. Hyatt - X154 - X154 - 07X154 - 333 EAST 135 STREET","7101ce37-33f4-ea11-b882-24ee9a37d45c",-73925459,40808194,"P.S. 154 - BRONX","333 EAST 135 STREET"
1,0,1,"55fdc1bd-32f4-ea11-b882-24ee9a37d45c","P.S. 016 John J. Driscoll - R016 - R016 - 31R016 - 195 DANIEL LOW TERRACE","56fdc1bd-32f4-ea11-b882-24ee9a37d45c",-74079594,40639638,"P.S. 16 - STATEN ISLAND","195 DANIEL LOW TERRACE"
5,4,1,"15f32ce2-31f4-ea11-b882-24ee9a37d45c","P.S. 018 Winchester - Q018 - Q018 - 26Q018 - 86-35 235 COURT","16f32ce2-31f4-ea11-b882-24ee9a37d45c",-73732290,40731853,"P.S. 18 - QUEENS","86-35 235 COURT"
2,2,0,"cbd27c6d-30f4-ea11-b882-24ee9a37d45c","P.S. 139 Alexine A. Fenty - K139 - K139 - 22K139 - 330 RUGBY ROAD","cad27c6d-30f4-ea11-b882-24ee9a37d45c",-73965862,40641340,"P.S. 139 - BROOKLYN","330 RUGBY ROAD"
1,1,0,"31c73b4a-32f4-ea11-b882-24ee9a37d45c","Elm Tree Elementary School - Q211 - Q298 - 24Q211 - 50-51 98th Street","30c73b4a-32f4-ea11-b882-24ee9a37d45c",-73863408,40741139,"Marie M. Daly Educational Building","50-51 98th Street"
3,3,0,"fcae0313-32f4-ea11-b882-24ee9a37d45c","I.S. 125 Thom J. McCann Woodside - Q125 - Q125 - 24Q125 - 46-02 47 AVENUE","fdae0313-32f4-ea11-b882-24ee9a37d45c",-73918762,40740452,"I.S. 125 - QUEENS","46-02 47 AVENUE"
1,0,1,"2baf0313-32f4-ea11-b882-24ee9a37d45c","P.S. 139 Rego Park - Q139 - Q139 - 28Q139 - 93-06 63 DRIVE","29af0313-32f4-ea11-b882-24ee9a37d45c",-73862561,40728012,"P.S. 139 - QUEENS","93-06 63 DRIVE"
5,3,2,"d90d3c5b-30f4-ea11-b882-24ee9a37d45c","P.S. 102 The Bayview - K102 - K102 - 20K102 - 211 72 STREET","da0d3c5b-30f4-ea11-b882-24ee9a37d45c",-74028758,40634318,"P.S. 102 - BROOKLYN","211 72 STREET"
3,2,1,"a332c3fb-eaf6-ea11-b883-24ee9a37d459","P.S. 131 Abigail Adams - Q131 - Q131 - 29Q131 - 170-21 84 Avenue","0eaf0313-32f4-ea11-b882-24ee9a37d45c",-73794061,40717150,"P.S. 131 - QUEENS","170-21 84 Avenue"
1,1,0,"efc1392a-30f4-ea11-b882-24ee9a37d45c","P.S. 003 The Bedford Village - K003 - K003 - 13K003 - 50 JEFFERSON AVENUE","f0c1392a-30f4-ea11-b882-24ee9a37d45c",-73955219,40682311,"P.S. 3 - BROOKLYN","50 JEFFERSON AVENUE"
1,0,1,"d39b4c1f-32f4-ea11-b882-24ee9a37d45c","P.S. 149 Christa McAuliffe - Q149 - Q149 - 30Q149 - 93-11 34 AVENUE","f3883319-32f4-ea11-b882-24ee9a37d45c",-73874505,40755759,"P.S. 149 - QUEENS","93-11 34 AVENUE"
1,0,1,"880e6e25-32f4-ea11-b882-24ee9a37d45c","P.S. 171 Peter G. Van Alst - Q171 - Q171 - 30Q171 - 14-14 29 AVENUE","870e6e25-32f4-ea11-b882-24ee9a37d45c",-73929093,40770926,"P.S. 171 - QUEENS","14-14 29 AVENUE"
1,0,1,"5236d900-33f4-ea11-b882-24ee9a37d45c","P.S. 048 Joseph R. Drake - X048 - X048 - 08X048 - 1290 SPOFFORD AVENUE","5336d900-33f4-ea11-b882-24ee9a37d45c",-73886834,40814034,"P.S. 48 - BRONX","1290 SPOFFORD AVENUE"
2,2,0,"f32ece86-32f4-ea11-b882-24ee9a37d45c","Queens High School for the Sciences at York College - Q687 - Q774 - 28Q687 - 94-50 159 Street","f42ece86-32f4-ea11-b882-24ee9a37d45c",-73798364,40700884,"QUEENS HIGH SCHOOL FOR THE SCIENCES","94-50 159 Street"
8,8,0,"e38521d0-32f4-ea11-b882-24ee9a37d45c","I.S. 072 Rocco Laurie - R072 - R072 - 31R072 - 33 FERNDALE AVENUE","e48521d0-32f4-ea11-b882-24ee9a37d45c",-74158618,40592132,"I.S. 72 - STATEN ISLAND","33 FERNDALE AVENUE"
1,0,1,"53fdc1bd-32f4-ea11-b882-24ee9a37d45c","P.S. 78 - R078 - R014 - 31R078 - 35 Hill Street","46fdc1bd-32f4-ea11-b882-24ee9a37d45c",-74079228,40622415,"P.S. 14 - STATEN ISLAND","35 Hill Street"
2,2,0,"347c21b7-32f4-ea11-b882-24ee9a37d45c","P.S. 003 The Margaret Gioiosa School - R003 - R003 - 31R003 - 80 SOUTH GOFF AVENUE","357c21b7-32f4-ea11-b882-24ee9a37d45c",-74211850,40520812,"P.S. 3 - STATEN ISLAND","80 SOUTH GOFF AVENUE"
2,0,2,"dbd096af-83ef-eb11-b8b1-24ee9a37d45c","P.S. M811 - Mickey Mantle School - M811 - M010 - 75M811 - 2581 7TH AVENUE","9b886843-31f4-ea11-b882-24ee9a37d45c",-73935746,40823988,"I.S. 10 (TANDEM M200) - MANHATTAN","2581 7TH AVENUE"
1,0,1,"1cba8b86-30f4-ea11-b882-24ee9a37d45c","P.S. 209 Margaret Mead - K209 - K209 - 21K209 - 2609 EAST 7 STREET","1dba8b86-30f4-ea11-b882-24ee9a37d45c",-73961191,40586800,"P.S. 209 - BROOKLYN","2609 EAST 7 STREET"
1,0,1,"5af4a0ef-eaf6-ea11-b883-24ee9a37d459","P.S. K771 - K771 - K225 - 75K771 - 1075 OCEAN VIEW AVENUE","e521d292-30f4-ea11-b882-24ee9a37d45c",-73955856,40580260,"P.S. 225 - BROOKLYN","1075 OCEAN VIEW AVENUE"
2,2,0,"ad9c11e8-30f4-ea11-b882-24ee9a37d45c","High School for Public Service: Heroes of Tomorrow - K546 - K470 - 17K546 - 600 KINGSTON AVENUE","aa9c11e8-30f4-ea11-b882-24ee9a37d45c",-73943839,40658671,"GEORGE W. WINGATE HS - K","600 KINGSTON AVENUE"
5,4,1,"1f7eed06-32f4-ea11-b882-24ee9a37d45c","P.S. 091 Richard Arkwright - Q091 - Q091 - 24Q091 - 68-10 CENTRAL AVE","207eed06-32f4-ea11-b882-24ee9a37d45c",-73883995,40703503,"P.S. 91 - QUEENS","68-10 CENTRAL AVE"
9,8,1,"5d07e99e-31f4-ea11-b882-24ee9a37d45c","Stuyvesant High School - M475 - M477 - 02M475 - 345 CHAMBERS STREET","5c07e99e-31f4-ea11-b882-24ee9a37d45c",-74013921,40718025,"STUYVESANT HS (NEW) - MANHATTAN","345 CHAMBERS STREET"
4,4,0,"4668acf3-b133-ed11-b0a6-088e901ef405","Samara Community School - X458 - X320 - 12X458 - 1570 Boone Avenue","4768acf3-b133-ed11-b0a6-088e901ef405",-73885081,40833595,"P.S. @ BOONE AVENUE - BRONX","1570 Boone Avenue"
4,4,0,"b42aa42b-33f4-ea11-b882-24ee9a37d45c","J.H.S. 144 Michelangelo - X144 - X144 - 11X144 - 2545 GUNTHER AVENUE","b22aa42b-33f4-ea11-b882-24ee9a37d45c",-73836525,40863842,"I.S. 144 - BRONX","2545 GUNTHER AVENUE"
1,0,1,"f6d10307-33f4-ea11-b882-24ee9a37d45c","P.S. 072 Dr. William Dorney - X072 - X072 - 08X072 - 2951 DEWEY AVENUE","f4d10307-33f4-ea11-b882-24ee9a37d45c",-73818172,40823237,"P.S. 72 - BRONX","2951 DEWEY AVENUE"
2,2,0,"f4201dab-30f4-ea11-b882-24ee9a37d45c","I.S. 281 Joseph B Cavallaro - K281 - K281 - 21K281 - 8787 24 AVENUE","f2201dab-30f4-ea11-b882-24ee9a37d45c",-73993565,40594648,"I.S. 281 - BROOKLYN","8787 24 AVENUE"
2,1,1,"840e6e25-32f4-ea11-b882-24ee9a37d45c","P.S. 169 Bay Terrace - Q169 - Q169 - 25Q169 - 18-25 212 STREET","820e6e25-32f4-ea11-b882-24ee9a37d45c",-73778430,40782331,"P.S. 169 - QUEENS","18-25 212 STREET"
1,1,0,"4e2b3eee-30f4-ea11-b882-24ee9a37d45c","The Christa McAuliffe School\I.S. 187 - K187 - K486 - 20K187 - 1171 65 STREET","4f2b3eee-30f4-ea11-b882-24ee9a37d45c",-74003883,40627929,"I.S. 187 - BROOKLYN","1171 65 STREET"
3,3,0,"f1454b50-32f4-ea11-b882-24ee9a37d45c","East Elmhurst Community School - Q329 - Q329 - 30Q329 - 26-25 97th Street","f0454b50-32f4-ea11-b882-24ee9a37d45c",-73872244,40761573,"EAST ELMHURST COMMUNITY SCHOOL - QUEENS","26-25 97th Street"
2,0,2,"f902cefa-32f4-ea11-b882-24ee9a37d45c","P.S. X188 - X188 - X034 - 75X188 - 770 GROTE STREET","fa02cefa-32f4-ea11-b882-24ee9a37d45c",-73883877,40850168,"P.S. 34 - BRONX","770 GROTE STREET"
1,0,1,"dbe13320-ebf6-ea11-b883-24ee9a37d459","Sid Miller Academy - K396 - K167 - 75K396 - 1025 EASTERN PARKWAY","4cebaa73-30f4-ea11-b882-24ee9a37d45c",-73934316,40669557,"P.S. 167 - BROOKLYN","1025 EASTERN PARKWAY"
2,2,0,"dc8442ee-31f4-ea11-b882-24ee9a37d45c","Jamaica Children's School - Q312 - Q040 - 28Q312 - 109-20 Union Hall Street","dd8442ee-31f4-ea11-b882-24ee9a37d45c",-73790975,40693559,"P.S. 40 (D28) - QUEENS","109-20 Union Hall Street"
1,0,1,"077eed06-32f4-ea11-b882-24ee9a37d45c","P.S. 082 Hammond - Q082 - Q082 - 28Q082 - 88-02 144 STREET","e3e8ce00-32f4-ea11-b882-24ee9a37d45c",-73812200,40703897,"P.S. 82 - QUEENS","88-02 144 STREET"
3,3,0,"c3e0838c-31f4-ea11-b882-24ee9a37d45c","P.S./I.S. 217 Roosevelt Island - M217 - M271 - 02M217 - 645 MAIN STREET","b8e0838c-31f4-ea11-b882-24ee9a37d45c",-73956435,40753598,"P.S./I.S. 217 - MANHATTAN","645 MAIN STREET"
4,1,3,"1e0b210d-33f4-ea11-b882-24ee9a37d45c","The Vida Bogart School for All Children - X352 - X075 - 75X352 - 984 FAILE STREET","1f0b210d-33f4-ea11-b882-24ee9a37d45c",-73888948,40822314,"P.S. 75 - BRONX","984 FAILE STREET"
5,5,0,"e292e6d5-30f4-ea11-b882-24ee9a37d45c","James Madison High School - K425 - K425 - 22K425 - 3787 BEDFORD AVENUE","e092e6d5-30f4-ea11-b882-24ee9a37d45c",-73947661,40610499,"JAMES MADISON HS - K","3787 BEDFORD AVENUE"
3,3,0,"d20d3c5b-30f4-ea11-b882-24ee9a37d45c","P.S. 100 The Coney Island School - K100 - K100 - 21K100 - 2951 WEST 3 STREET","ca0d3c5b-30f4-ea11-b882-24ee9a37d45c",-73970830,40577591,"P.S. 100 - BROOKLYN","2951 WEST 3 STREET"
1,0,1,"50fdc1bd-32f4-ea11-b882-24ee9a37d45c","P.S. 013 M. L. Lindemeyer - R013 - R013 - 31R013 - 191 VERMONT AVENUE","51fdc1bd-32f4-ea11-b882-24ee9a37d45c",-74068963,40613322,"P.S. 13 - STATEN ISLAND","191 VERMONT AVENUE"
2,2,0,"1c6e3d68-31f4-ea11-b882-24ee9a37d45c","P.S. 116 Mary Lindley Murray - M116 - M116 - 02M116 - 210 East 33 Street","1d6e3d68-31f4-ea11-b882-24ee9a37d45c",-73977906,40744511,"P.S. 116 - MANHATTAN","210 East 33 Street"
5,1,4,"270b210d-33f4-ea11-b882-24ee9a37d45c","P.S. 195 - X195 - X077 - 12X195 - 1250 WARD AVENUE","230b210d-33f4-ea11-b882-24ee9a37d45c",-73877305,40830811,"P.S. 195 - BRONX","1250 WARD AVENUE"
2,2,0,"377c21b7-32f4-ea11-b882-24ee9a37d45c","P.S. 004 Maurice Wollin - R004 - R004 - 31R004 - 200 NEDRA LANE","337c21b7-32f4-ea11-b882-24ee9a37d45c",-74195281,40552059,"P.S. 4 - STATEN ISLAND","200 NEDRA LANE"
7,6,1,"78977d2b-32f4-ea11-b882-24ee9a37d45c","J.H.S. 190 Russell Sage - Q190 - Q190 - 28Q190 - 68-17 AUSTIN STREET","75977d2b-32f4-ea11-b882-24ee9a37d45c",-73851700,40723478,"J.H.S. 190 - QUEENS","68-17 AUSTIN STREET"
1,0,1,"7de03d56-33f4-ea11-b882-24ee9a37d45c","P186X Walter J. Damrosch School - X186 - X392 - 75X186 - 928 Simpson Street","7ee03d56-33f4-ea11-b882-24ee9a37d45c",-73892961,40820388,"The Casita Maria Center for Arts and Education","928 Simpson Street"
1,1,0,"fc454b50-32f4-ea11-b882-24ee9a37d45c","College Point Collaborative - Q379 - Q336 - 25Q379 - 12406 14TH AVENUE","fd454b50-32f4-ea11-b882-24ee9a37d45c",-73843504,40785129,"The College Point Collaborative Educational Buildi","12406 14TH AVENUE"
1,0,1,"417c21b7-32f4-ea11-b882-24ee9a37d45c","P.S. 6 Corporal Allan F. Kivlehan School - R006 - R006 - 31R006 - 555 PAGE AVENUE","3c7c21b7-32f4-ea11-b882-24ee9a37d45c",-74230118,40510207,"P.S. 6 - STATEN ISLAND","555 PAGE AVENUE"
3,3,0,"512b3eee-30f4-ea11-b882-24ee9a37d45c","Fort Hamilton High School - K490 - K490 - 20K490 - 8301 SHORE ROAD","522b3eee-30f4-ea11-b882-24ee9a37d45c",-74038103,40626827,"FORT HAMILTON HS - K","8301 SHORE ROAD"
1,0,1,"f29b4c1f-32f4-ea11-b882-24ee9a37d45c","M.S. 158 Marie Curie - Q158 - Q158 - 26Q158 - 46-35 Oceania Street","f39b4c1f-32f4-ea11-b882-24ee9a37d45c",-73771878,40756562,"J.H.S. 158 - QUEENS","46-35 Oceania Street"
1,1,0,"52474313-33f4-ea11-b882-24ee9a37d45c","M.S. X101 Edward R. Byrne - X101 - X101 - 08X101 - 2750 LAFAYETTE AVENUE","4e474313-33f4-ea11-b882-24ee9a37d45c",-73829211,40827080,"I.S. 101 - BRONX","2750 LAFAYETTE AVENUE"
1,1,0,"6f2f77fa-31f4-ea11-b882-24ee9a37d45c","P.S. 066 Jacqueline Kennedy Onassis - Q066 - Q066 - 27Q066 - 85-11 102 Street","702f77fa-31f4-ea11-b882-24ee9a37d45c",-73846135,40697941,"P.S. 66 - QUEENS","85-11 102 Street"
2,0,2,"17cf496e-31f4-ea11-b882-24ee9a37d45c","P.S. 133 Fred R Moore - M133 - M133 - 05M133 - 2121 5 AVENUE","18cf496e-31f4-ea11-b882-24ee9a37d45c",-73939178,40809665,"P.S. 133 - MANHATTAN","2121 5 AVENUE"
3,2,1,"6cbc9674-32f4-ea11-b882-24ee9a37d45c","John Adams High School - Q480 - Q480 - 27Q480 - 101-01 ROCKAWAY BOULEVARD","6abc9674-32f4-ea11-b882-24ee9a37d45c",-73838616,40680065,"JOHN ADAMS HS - QUEENS","101-01 ROCKAWAY BOULEVARD"
2,2,0,"1eb4977a-32f4-ea11-b882-24ee9a37d45c","Townsend Harris High School - Q525 - Q515 - 25Q525 - 149-11 MELBOURNE AVENUE","1db4977a-32f4-ea11-b882-24ee9a37d45c",-73821532,40737038,"TOWNSEND HARRIS HS - Q","149-11 MELBOURNE AVENUE"
1,1,0,"2da10a44-32f4-ea11-b882-24ee9a37d45c","P.S. 128 The Lorraine Tuzzo, Juniper Valley Elementary School - Q128 - Q247 - 24Q128 - 69-10 65th Drive","2ca10a44-32f4-ea11-b882-24ee9a37d45c",-73885974,40715005,"PS/IS 128","69-10 65th Drive"
2,2,0,"fdd0de79-30f4-ea11-b882-24ee9a37d45c","P.S. 172 Beacon School of Excellence - K172 - K172 - 15K172 - 825 4 AVENUE","fed0de79-30f4-ea11-b882-24ee9a37d45c",-74000191,40657682,"P.S. 172 - BROOKLYN","825 4 AVENUE"
1,0,1,"51953aac-ebf6-ea11-b883-24ee9a37d459","The Riverview School - Q277 - Q404 - 75Q277 - 1-50 51ST AVENUE","65e2635c-32f4-ea11-b882-24ee9a37d45c",-73959183,40742964,"HUNTERS POINT CAMPUS - QUEENS","1-50 51ST AVENUE"
1,0,1,"3bef7338-ebf6-ea11-b883-24ee9a37d459","P.S. K053 - K053 - K422 - 75K053 - 1065 Elton Street","da92e6d5-30f4-ea11-b882-24ee9a37d45c",-73874064,40657266,"SPRING CREEK EDUCATIONAL CAMPUS - BROOKLYN","1065 Elton Street"
1,0,1,"16a198c3-30f4-ea11-b882-24ee9a37d45c","P.S./I.S. 30 Mary White Ovington - K030 - K331 - 20K030 - 7002 4TH AVENUE","15a198c3-30f4-ea11-b882-24ee9a37d45c",-74023950,40633598,"P.S./I.S.30 MARY WHITE OVINGTON - BROOKLYN","7002 4TH AVENUE"
3,3,0,"15a6ba98-31f4-ea11-b882-24ee9a37d45c","Gramercy Arts High School - M374 - M460 - 02M374 - 40 IRVING PLACE","16a6ba98-31f4-ea11-b882-24ee9a37d45c",-73987064,40735361,"WASHINGTON IRVING HS - MANHATTAN","40 IRVING PLACE"
3,1,2,"3e7c21b7-32f4-ea11-b882-24ee9a37d45c","P.S. 005 Huguenot - R005 - R005 - 31R005 - 348 DEISIUS STREET","3f7c21b7-32f4-ea11-b882-24ee9a37d45c",-74187276,40529389,"P.S. 5 - STATEN ISLAND","348 DEISIUS STREET"
8,6,2,"fe17b7f4-32f4-ea11-b882-24ee9a37d45c","P.S. 277 - X277 - X027 - 07X277 - 519 ST ANNS AVENUE","fc17b7f4-32f4-ea11-b882-24ee9a37d45c",-73913872,40813385,"P.S. 277 - BRONX","519 ST ANNS AVENUE"
2,0,2,"5ec0eb6c-4afb-ea11-b883-24ee9a37d459","MARC Academy and Family Center, Inc. - Webster Ave. - XATH - XAYF -  - 2863 Webster Avenue","5fc0eb6c-4afb-ea11-b883-24ee9a37d459",-73884218,40866939,"MiniVentures of NY, Inc.- Site #4","2863 Webster Avenue"
1,0,1,"87611579-4afb-ea11-b883-24ee9a37d459","Immanuel Genius - QBHM - QBHM -  - 253-01","88611579-4afb-ea11-b883-24ee9a37d459",-73735409,40770787,"Immanuel Genius","253-01"
3,3,0,"a5eb0e7b-33f4-ea11-b882-24ee9a37d45c","Bronx Academy for Software Engineering (BASE) - X264 - X660 - 10X264 - 2474 CROTONA AVENUE","a3eb0e7b-33f4-ea11-b882-24ee9a37d45c",-73882487,40855392,"GRACE H. DODGE VOC HS - X","2474 CROTONA AVENUE"
1,1,0,"299ebaee-32f4-ea11-b882-24ee9a37d45c","P.S. X014 Senator John Calandra - X014 - X014 - 08X014 - 3047 BRUCKNER BOULEVARD","2a9ebaee-32f4-ea11-b882-24ee9a37d45c",-73826277,40835318,"P.S. 14 - BRONX","3047 BRUCKNER BOULEVARD"
1,1,0,"c08442ee-31f4-ea11-b882-24ee9a37d45c","P.S. 029 Queens - Q029 - Q029 - 25Q029 - 125-10 23 AVENUE","c18442ee-31f4-ea11-b882-24ee9a37d45c",-73842967,40778029,"P.S. 29 - QUEENS","125-10 23 AVENUE"
6,6,0,"a472c880-32f4-ea11-b882-24ee9a37d45c","Metropolitan Expeditionary Learning School - Q167 - Q686 - 28Q167 - 91-30 METROPOLITAN AVENUE","a372c880-32f4-ea11-b882-24ee9a37d45c",-73855543,40708431,"METROPOLITAN AVENUE CAMPUS - QUEENS","91-30 METROPOLITAN AVENUE"
1,0,1,"1c7eed06-32f4-ea11-b882-24ee9a37d45c","P.S. 090 Horace Mann - Q090 - Q090 - 27Q090 - 86-50 109 STREET","1d7eed06-32f4-ea11-b882-24ee9a37d45c",-73839517,40696653,"P.S. 90 - QUEENS","86-50 109 STREET"
1,0,1,"fd6d3d68-31f4-ea11-b882-24ee9a37d45c","P.S. 138 - M138 - M108 - 75M138 - 1615 MADISON AVENUE","5be61462-31f4-ea11-b882-24ee9a37d45c",-73947855,40795032,"P.S. 108 - MANHATTAN","1615 MADISON AVENUE"
1,1,0,"d211f898-32f4-ea11-b882-24ee9a37d45c","P.S. 65 - The Raymond York Elementary School - Q065 - Q884 - 27Q065 - 103-22 99 STREET","d111f898-32f4-ea11-b882-24ee9a37d45c",-73841675,40682293,"P.S. 65 - QUEENS","103-22 99 STREET"
1,1,0,"1606003e-32f4-ea11-b882-24ee9a37d45c","P.S. 234 - Q234 - Q234 - 30Q234 - 30-15 29 STREET","1506003e-32f4-ea11-b882-24ee9a37d45c",-73923044,40766898,"P.S. 234 - QUEENS","30-14 30 STREET"
1,1,0,"94283fb1-30f4-ea11-b882-24ee9a37d45c","Digital Arts and Cinema Technology High School - K429 - K293 - 15K429 - 284 Baltic Street","91283fb1-30f4-ea11-b882-24ee9a37d45c",-73993293,40685006,"J.H.S. 293 - BROOKLYN","284 Baltic Street"
2,1,1,"cdfab455-31f4-ea11-b882-24ee9a37d45c","Neighborhood School - M363 - M063 - 01M363 - 121 EAST 3 STREET","cefab455-31f4-ea11-b882-24ee9a37d45c",-73986214,40724440,"P.S. 63 - MANHATTAN","121 EAST 3 STREET"
1,0,1,"be5ca1a9-4afb-ea11-b883-24ee9a37d459","Our Saviour Lutheran School - QADZ - QADZ -  - 64-33 WOODHAVEN BOULEVARD","bf5ca1a9-4afb-ea11-b883-24ee9a37d459",-73865354,40720742,"OUR SAVIOUR LUTHERAN SCHOOL","64-33 WOODHAVEN BOULEVARD"
2,0,2,"a70e6e25-32f4-ea11-b882-24ee9a37d45c","P.S. 181 Brookfield - Q181 - Q181 - 29Q181 - 148-15 230 Street","a80e6e25-32f4-ea11-b882-24ee9a37d45c",-73752948,40655674,"P.S. 181 - QUEENS","148-15 230 Street"
4,3,1,"6a5bc58c-30f4-ea11-b882-24ee9a37d45c","J.H.S. 220 John J. Pershing - K220 - K220 - 20K220 - 4812 9TH AVENUE","695bc58c-30f4-ea11-b882-24ee9a37d45c",-74001250,40640997,"I.S. 220 - BROOKLYN","4812 9TH AVENUE"
1,0,1,"0678931f-33f4-ea11-b882-24ee9a37d45c","I.S. 117 Joseph H. Wade - X117 - X117 - 09X117 - 1865 MORRIS AVENUE","0578931f-33f4-ea11-b882-24ee9a37d45c",-73909022,40848552,"I.S. 117 - BRONX","1865 MORRIS AVENUE"
3,3,0,"c6b66262-32f4-ea11-b882-24ee9a37d45c","Business Technology Early College High School - Q315 - Q435 - 26Q315 - 230-17 HILLSIDE AVENUE","c4b66262-32f4-ea11-b882-24ee9a37d45c",-73739726,40733888,"MARTIN VAN BUREN HS - QUEENS","230-17 HILLSIDE AVENUE"
1,1,0,"cc2ff20c-32f4-ea11-b882-24ee9a37d45c","The James J. Ambrose School - Q115 - Q115 - 26Q115 - 80-51 261 STREET","cd2ff20c-32f4-ea11-b882-24ee9a37d45c",-73709404,40744201,"The James J. Ambrose School","80-51 261 STREET"
1,1,0,"b056635c-33f4-ea11-b882-24ee9a37d45c","Arturo A. Schomburg Satellite Academy Bronx - X446 - X401 - 12X446 - 1010 REV. J. A. POLITE AVENUE","8ce03d56-33f4-ea11-b882-24ee9a37d45c",-73898265,40823124,"BRONX REGIONAL HS (OLD 133) - X","1010 REV. J. A. POLITE AVENUE"
1,1,0,"c50d3c5b-30f4-ea11-b882-24ee9a37d45c","I.S. 096 Seth Low - K096 - K096 - 21K096 - 99 AVENUE P","c10d3c5b-30f4-ea11-b882-24ee9a37d45c",-73984985,40608135,"I.S. 96 - BROOKLYN","99 AVENUE P"
2,2,0,"2b0410ca-32f4-ea11-b882-24ee9a37d45c","P.S. 050 Frank Hankinson - R050 - R050 - 31R050 - 200 ADELAIDE AVENUE","2c0410ca-32f4-ea11-b882-24ee9a37d45c",-74124332,40560954,"P.S. 50 - STATEN ISLAND","200 ADELAIDE AVENUE"
3,2,1,"a369c231-32f4-ea11-b882-24ee9a37d45c","Energy Tech High School - Q258 - Q204 - 30Q258 - 36-41 28 STREET","9c69c231-32f4-ea11-b882-24ee9a37d45c",-73932628,40756471,"I.S. 204 - QUEENS","36-41 28 STREET"
2,1,1,"89464e91-4afb-ea11-b883-24ee9a37d459","KINGSBRIDGE HEIGHTS COMMUNITY CENTER - XAOT - XAOT -  - 3101 KINGSBRIDGE TERRACE","8a464e91-4afb-ea11-b883-24ee9a37d459",-73900687,40877570,"KINGSBRIDGE HEIGHTS COMMUNITY CENTER","3101 KINGSBRIDGE TERRACE"
2,2,0,"9553dd74-33f4-ea11-b882-24ee9a37d45c","University Heights Secondary School - X495 - X470 - 07X495 - 701 ST. ANNS AVENUE","9253dd74-33f4-ea11-b882-24ee9a37d45c",-73911633,40818041,"SOUTH BRONX EDUCATIONAL CAMPUS (OLD 38) - X","701 ST. ANNS AVENUE"
1,1,0,"418dbfcf-30f4-ea11-b882-24ee9a37d45c","Kingsborough Early College School - K468 - K400 - 21K468 - 2630 BENSON AVENUE","3a8dbfcf-30f4-ea11-b882-24ee9a37d45c",-73986313,40593028,"Lafayette Educational Campus","2630 BENSON AVENUE"
1,1,0,"9641e65b-31f4-ea11-b882-24ee9a37d45c","I.S. 289 - M289 - M089 - 02M289 - 201 WARREN STREET","9741e65b-31f4-ea11-b882-24ee9a37d45c",-74013967,40717010,"P.S./I.S. 89 - MANHATTAN","201 WARREN STREET"
1,0,1,"51416e00-31f4-ea11-b882-24ee9a37d45c","District 20 Pre-K Center - K768 - K695 - 20K768 - 1258 65th Street","52416e00-31f4-ea11-b882-24ee9a37d45c",-74002487,40626562,"PRE-K CENTER @ 1258 65TH STREET - BROOKLYN","1258 65th Street"
2,1,1,"8fe657bd-30f4-ea11-b882-24ee9a37d45c","P.S. 503: The School of Discovery - K503 - K314 - 20K503 - 330 59 Street","8ee657bd-30f4-ea11-b882-24ee9a37d45c",-74019299,40641950,"P.S. 314 - BROOKLYN","330 59 Street"
2,2,0,"f59b4c1f-32f4-ea11-b882-24ee9a37d45c","P.S. 159 - Q159 - Q159 - 26Q159 - 205-01 33 AVENUE","f69b4c1f-32f4-ea11-b882-24ee9a37d45c",-73783973,40770108,"P.S. 159 - QUEENS","205-01 33 AVENUE"
1,1,0,"2c06003e-32f4-ea11-b882-24ee9a37d45c","P.S. 242 Leonard P. Stavisky Early Childhood School - Q242 - Q242 - 25Q242 - 29-66 137 STREET","2d06003e-32f4-ea11-b882-24ee9a37d45c",-73832005,40769752,"P.S. 242 - (ECC) - QUEENS","29-66 137 STREET"
1,0,1,"171bad3c-30f4-ea11-b882-24ee9a37d45c","P.S. 044 Marcus Garvey - K044 - K044 - 13K044 - 432 MONROE STREET","031bad3c-30f4-ea11-b882-24ee9a37d45c",-73940859,40686213,"P.S. 44 - BROOKLYN","432 MONROE STREET"
1,1,0,"9969c231-32f4-ea11-b882-24ee9a37d45c","J.H.S. 202 Robert H. Goddard - Q202 - Q202 - 27Q202 - 138-30 LAFAYETTE STREET","9169c231-32f4-ea11-b882-24ee9a37d45c",-73845992,40670905,"I.S. 202 - QUEENS","138-30 LAFAYETTE STREET"
2,2,0,"280d6d19-33f4-ea11-b882-24ee9a37d45c","P.S. 536 - X536 - X102 - 12X536 - 1827 ARCHER STREET","290d6d19-33f4-ea11-b882-24ee9a37d45c",-73866038,40838151,"P.S. 102 - BRONX","1827 ARCHER STREET"
3,1,2,"6ce2635c-32f4-ea11-b882-24ee9a37d45c","Bayside High School - Q495 - Q405 - 26Q495 - 32-24 CORPORAL KENNEDY STREET","6be2635c-32f4-ea11-b882-24ee9a37d45c",-73781041,40771398,"BAYSIDE HS - Q","32-24 CORPORAL KENNEDY STREET"
1,1,0,"8be657bd-30f4-ea11-b882-24ee9a37d45c","Urban Assembly Institute of Math and Science for Young Women - K527 - K313 - 13K527 - 283 ADAMS STREET","82e657bd-30f4-ea11-b882-24ee9a37d45c",-73988323,40694629,"ADAMS STREET EDUCATIONAL CAMPUS - K","283 ADAMS STREET"
2,0,2,"ea17b7f4-32f4-ea11-b882-24ee9a37d45c","P.S. 023 The New Children's School - X023 - X023 - 10X023 - 2151 WASHINGTON AVENUE","eb17b7f4-32f4-ea11-b882-24ee9a37d45c",-73894951,40853294,"P.S. 23 - BRONX","2151 WASHINGTON AVENUE"
4,2,2,"a183ff9e-30f4-ea11-b882-24ee9a37d45c","P.S. 253 - K253 - K253 - 21K253 - 601 OCEANVIEW AVENUE","a283ff9e-30f4-ea11-b882-24ee9a37d45c",-73961962,40580237,"P.S. 253 - BROOKLYN","601 OCEANVIEW AVENUE"
1,0,1,"197eed06-32f4-ea11-b882-24ee9a37d45c","P.S. 89Q: The Jose Peralta School of Dreamers - Q089 - Q089 - 24Q089 - 85-28 BRITTON AVENUE","1a7eed06-32f4-ea11-b882-24ee9a37d45c",-73879641,40745963,"P.S. 89 - QUEENS","85-28 BRITTON AVENUE"
2,2,0,"a22aa42b-33f4-ea11-b882-24ee9a37d45c","One World Middle School at Edenwald - X529 - X142 - 11X529 - 3750 BAYCHESTER AVENUE","a32aa42b-33f4-ea11-b882-24ee9a37d45c",-73839682,40886002,"I.S. 142 - BRONX","3750 BAYCHESTER AVENUE"
2,2,0,"9241e65b-31f4-ea11-b882-24ee9a37d45c","Wadleigh Secondary School for the Performing & Visual Arts - M415 - M088 - 03M415 - 215 WEST 114 STREET","8841e65b-31f4-ea11-b882-24ee9a37d45c",-73954152,40802610,"I.S. 88 - MANHATTAN","215 WEST 114 STREET"
1,0,1,"2ca31781-33f4-ea11-b882-24ee9a37d45c","P.S. 207 - X207 - X819 - 10X207 - 3030 GODWIN TERRACE","2ba31781-33f4-ea11-b882-24ee9a37d45c",-73906197,40878327,"P.S. 207 - BRONX","3030 GODWIN TERRACE"
3,3,0,"0dba8b86-30f4-ea11-b882-24ee9a37d45c","P.S. 204 Vince Lombardi - K204 - K204 - 20K204 - 8101 15 AVENUE","0eba8b86-30f4-ea11-b882-24ee9a37d45c",-74006137,40613535,"P.S. 204 - BROOKLYN","8101 15 AVENUE"
3,2,1,"989c11e8-30f4-ea11-b882-24ee9a37d45c","Millennium Brooklyn HS - K684 - K460 - 15K684 - 237 7 AVENUE","929c11e8-30f4-ea11-b882-24ee9a37d45c",-73978580,40669255,"John Jay Educational Campus","237 7 AVENUE"
1,1,0,"b3fc24e8-31f4-ea11-b882-24ee9a37d45c","P.S. 022 Thomas Jefferson - Q022 - Q022 - 25Q022 - 153-33 SANFORD AVENUE","b1fc24e8-31f4-ea11-b882-24ee9a37d45c",-73811373,40761744,"P.S. 22 - QUEENS","153-33 SANFORD AVENUE"
1,1,0,"c20d3c5b-30f4-ea11-b882-24ee9a37d45c","P.S. 095 The Gravesend - K095 - K095 - 21K095 - 345 VAN SICKLEN STREET","c30d3c5b-30f4-ea11-b882-24ee9a37d45c",-73974664,40595996,"P.S. 95 - BROOKLYN","345 VAN SICKLEN STREET"
6,6,0,"d3689025-33f4-ea11-b882-24ee9a37d45c","Pelham Academy of Academics and Community Engagement - X468 - X135 - 11X468 - 2441 WALLACE AVENUE","d4689025-33f4-ea11-b882-24ee9a37d45c",-73865028,40862098,"I.S. 135 - BRONX","2441 WALLACE AVENUE"
7,6,1,"cee8ce00-32f4-ea11-b882-24ee9a37d45c","J.H.S. 074 Nathaniel Hawthorne - Q074 - Q074 - 26Q074 - 61-15 Oceania Street","cfe8ce00-32f4-ea11-b882-24ee9a37d45c",-73766653,40744743,"I.S. 74 - QUEENS","61-15 Oceania Street"
4,3,1,"db21d292-30f4-ea11-b882-24ee9a37d45c","P.S. 222 Katherine R. Snyder - K222 - K222 - 22K222 - 3301 QUENTIN ROAD","dc21d292-30f4-ea11-b882-24ee9a37d45c",-73939205,40614005,"P.S. 222 - BROOKLYN","3301 QUENTIN ROAD"
1,0,1,"7fe03d56-33f4-ea11-b882-24ee9a37d45c","Bronx Studio School for Writers and Artists - X269 - X392 - 08X269 - 928 Simpson Street","7ee03d56-33f4-ea11-b882-24ee9a37d45c",-73892961,40820388,"The Casita Maria Center for Arts and Education","928 Simpson Street"
4,3,1,"ea21d292-30f4-ea11-b882-24ee9a37d45c","P.S. 226 Alfred De B. Mason - K226 - K226 - 21K226 - 6006 23 AVENUE","eb21d292-30f4-ea11-b882-24ee9a37d45c",-73977099,40615405,"P.S. 226 - BROOKLYN","6006 23 AVENUE"
2,1,1,"7da9d9c3-32f4-ea11-b882-24ee9a37d45c","P.S. 030 Westerleigh - R030 - R030 - 31R030 - 200 Wardwell Avenue","73a9d9c3-32f4-ea11-b882-24ee9a37d45c",-74133080,40618097,"P.S. 30 - STATEN ISLAND","200 Wardwell Avenue"
1,1,0,"89d810ab-31f4-ea11-b882-24ee9a37d45c","Urban Assembly School of Design and Construction, The - M300 - M535 - 02M300 - 525 WEST 50TH STREET","f137fba4-31f4-ea11-b882-24ee9a37d45c",-73992700,40765474,"PARK WEST HS (ECF) - MANHATTAN","525 WEST 50TH STREET"
1,1,0,"4e767649-31f4-ea11-b882-24ee9a37d45c","P.S. 040 Augustus Saint-Gaudens - M040 - M040 - 02M040 - 320 EAST 20TH STREET","46767649-31f4-ea11-b882-24ee9a37d45c",-73981536,40735328,"P.S. 40 - MANHATTAN","320 EAST 20TH STREET"
2,2,0,"9069c231-32f4-ea11-b882-24ee9a37d45c","Robert H. Goddard High School of Communication Arts and Technology - Q308 - Q202 - 27Q308 - 138-30 LAFAYETTE STREET","9169c231-32f4-ea11-b882-24ee9a37d45c",-73845992,40670905,"I.S. 202 - QUEENS","138-30 LAFAYETTE STREET"
2,1,1,"ced27c6d-30f4-ea11-b882-24ee9a37d45c","Brooklyn Collaborative Studies - K448 - K142 - 15K448 - 610 HENRY STREET","cfd27c6d-30f4-ea11-b882-24ee9a37d45c",-74002022,40679462,"J.H.S. 142 - BROOKLYN","610 HENRY STREET"
1,1,0,"370410ca-32f4-ea11-b882-24ee9a37d45c","P.S. 054 Charles W. Leng - R054 - R054 - 31R054 - 1060 WILLOWBROOK ROAD","380410ca-32f4-ea11-b882-24ee9a37d45c",-74137259,40602779,"P.S. 54 - STATEN ISLAND","1060 WILLOWBROOK ROAD"
3,3,0,"79a5db98-30f4-ea11-b882-24ee9a37d45c","Launch Expeditionary Learning Charter School - K360 - K243 - 84K360 - 1580 DEAN STREET","7aa5db98-30f4-ea11-b882-24ee9a37d45c",-73935093,40675675,"P.S. 243 - BROOKLYN","1580 DEAN STREET"
3,2,1,"d2b66262-32f4-ea11-b882-24ee9a37d45c","Forest Hills High School - Q440 - Q440 - 28Q440 - 67-01 110 STREET","d3b66262-32f4-ea11-b882-24ee9a37d45c",-73843972,40730017,"FOREST HILLS HS - Q","67-01 110 STREET"
7,7,0,"63ffcc6e-33f4-ea11-b882-24ee9a37d45c","The Bronx High School of Science - X445 - X445 - 10X445 - 75 WEST 205 STREET","64ffcc6e-33f4-ea11-b882-24ee9a37d45c",-73889011,40879958,"BRONX HS OF SCIENCE - X","75 WEST 205 STREET"
1,1,0,"e28442ee-31f4-ea11-b882-24ee9a37d45c","P.S. 040 Samuel Huntington - Q040 - Q040 - 28Q040 - 109-20 Union Hall Street","dd8442ee-31f4-ea11-b882-24ee9a37d45c",-73790975,40693559,"P.S. 40 (D28) - QUEENS","109-20 Union Hall Street"
1,1,0,"66e2635c-32f4-ea11-b882-24ee9a37d45c","Hunters Point Community Middle School - Q291 - Q404 - 30Q291 - 1-50 51ST AVENUE","65e2635c-32f4-ea11-b882-24ee9a37d45c",-73959183,40742964,"HUNTERS POINT CAMPUS - QUEENS","1-50 51ST AVENUE"
1,1,0,"d98a0044-33f4-ea11-b882-24ee9a37d45c","The Bronx Mathematics Preparatory School - X375 - X174 - 08X375 - 456 WHITE PLAINS ROAD","2a2ed53d-33f4-ea11-b882-24ee9a37d45c",-73856070,40815043,"I.S. 174 - BRONX","456 WHITE PLAINS ROAD"
1,0,1,"559d7c62-33f4-ea11-b882-24ee9a37d45c","The Metropolitan Soundview High School - X521 - X420 - 12X521 - 1300 BOYNTON AVENUE","519d7c62-33f4-ea11-b882-24ee9a37d45c",-73878191,40832508,"JAMES MONROE EDUCATIONAL CAMPUS - X","1300 BOYNTON AVENUE"
1,0,1,"3b3cbf01-ebf6-ea11-b883-24ee9a37d459","P.S. Q233 - Q233 - Q686 - 75Q233 - 91-30 METROPOLITAN AVENUE","a372c880-32f4-ea11-b882-24ee9a37d45c",-73855543,40708431,"METROPOLITAN AVENUE CAMPUS - QUEENS","91-30 METROPOLITAN AVENUE"
2,2,0,"21e85c61-30f4-ea11-b882-24ee9a37d45c","P.S. 112 Lefferts Park - K112 - K112 - 20K112 - 7115 15 AVENUE","22e85c61-30f4-ea11-b882-24ee9a37d45c",-74000565,40619417,"P.S. 112 - BROOKLYN","7115 15 AVENUE"
1,1,0,"df883319-32f4-ea11-b882-24ee9a37d45c","P.S. 144 Col Jeromus Remsen - Q144 - Q144 - 28Q144 - 69-20 JUNO STREET","e0883319-32f4-ea11-b882-24ee9a37d45c",-73852398,40714890,"P.S. 144 - QUEENS","69-20 JUNO STREET"
1,0,1,"462f7d06-31f4-ea11-b882-24ee9a37d45c","District 20 Pre-K Center - K768 - K747 - 20K768 - 21 Bay 11th Street","472f7d06-31f4-ea11-b882-24ee9a37d45c",-74008608,40609976,"PRE-K CENTER @ 21 BAY 11TH STREET - BROOKLYN","21 Bay 11th Street"
1,0,1,"100410ca-32f4-ea11-b882-24ee9a37d45c","P.S. 042 Eltingville - R042 - R042 - 31R042 - 380 GENESEE AVENUE","110410ca-32f4-ea11-b882-24ee9a37d45c",-74169038,40552213,"P.S. 42 - STATEN ISLAND","380 GENESEE AVENUE"
6,6,0,"0803cefa-32f4-ea11-b882-24ee9a37d45c","Longwood Preparatory Academy - X530 - X039 - 08X530 - 965 LONGWOOD AVENUE","0203cefa-32f4-ea11-b882-24ee9a37d45c",-73897876,40817741,"NEW SCH FOR ARTS AND SCIENCE - X","965 LONGWOOD AVENUE"
1,1,0,"9d69c231-32f4-ea11-b882-24ee9a37d45c","P.S. 203 Oakland Gardens - Q203 - Q203 - 26Q203 - 53-11 SPRINGFIELD BOULEVARD","9e69c231-32f4-ea11-b882-24ee9a37d45c",-73759822,40753606,"P.S. 203 - QUEENS","53-11 SPRINGFIELD BOULEVARD"
1,1,0,"1f03cefa-32f4-ea11-b882-24ee9a37d45c","P.S. 044 David C. Farragut - X044 - X044 - 12X044 - 1825 PROSPECT AVENUE","1d03cefa-32f4-ea11-b882-24ee9a37d45c",-73891086,40842564,"P.S. 44 - BRONX","1825 PROSPECT AVENUE"
2,2,0,"d9689025-33f4-ea11-b882-24ee9a37d45c","Bronx Green Middle School - X326 - X135 - 11X326 - 2441 WALLACE AVENUE","d4689025-33f4-ea11-b882-24ee9a37d45c",-73865028,40862098,"I.S. 135 - BRONX","2441 WALLACE AVENUE"
1,1,0,"d60d3c5b-30f4-ea11-b882-24ee9a37d45c","P.S. 101 The Verrazano - K101 - K101 - 21K101 - 8696 24 Avenue","d70d3c5b-30f4-ea11-b882-24ee9a37d45c",-73991962,40597379,"P.S. 101 - BROOKLYN","8696 24 Avenue"
3,1,2,"7d8946f4-31f4-ea11-b882-24ee9a37d45c","P.S. 055 Maure - Q055 - Q055 - 28Q055 - 131-10 97 Avenue","7b8946f4-31f4-ea11-b882-24ee9a37d45c",-73816156,40693610,"P.S. 55 - QUEENS","131-10 97 Avenue"
2,0,2,"df0d3c5b-30f4-ea11-b882-24ee9a37d45c","P.S. 105 The Blythebourne - K105 - K105 - 20K105 - 1031 59 STREET","e00d3c5b-30f4-ea11-b882-24ee9a37d45c",-74003635,40633320,"P.S. 105 - BROOKLYN","1031 59 STREET"
2,2,0,"337eed06-32f4-ea11-b882-24ee9a37d45c","P.S. 098 The Douglaston School - Q098 - Q098 - 26Q098 - 40-20 235 STREET","347eed06-32f4-ea11-b882-24ee9a37d45c",-73749998,40768906,"P.S. 98 - QUEENS","40-20 235 STREET"
2,2,0,"45e61462-31f4-ea11-b882-24ee9a37d45c","Bard High School Early College - M696 - M097 - 01M696 - 525 EAST HOUSTON STREET","46e61462-31f4-ea11-b882-24ee9a37d45c",-73976093,40718276,"BARD COLLEGE HS (OLD M097) - M","525 EAST HOUSTON STREET"
4,3,1,"8c886843-31f4-ea11-b882-24ee9a37d45c","P.S. 006 Lillie D. Blake - M006 - M006 - 02M006 - 45 EAST 81 STREET","8d886843-31f4-ea11-b882-24ee9a37d45c",-73960427,40777737,"P.S. 6 - MANHATTAN","45 EAST 81 STREET"
2,2,0,"dc8521d0-32f4-ea11-b882-24ee9a37d45c","P.S. 069 Daniel D. Tompkins - R069 - R069 - 31R069 - 144 KEATING PLACE","dd8521d0-32f4-ea11-b882-24ee9a37d45c",-74157327,40591480,"P.S. 69 - STATEN ISLAND","144 KEATING PLACE"
1,0,1,"47474313-33f4-ea11-b882-24ee9a37d45c","Bronx Envision Academy - X511 - X098 - 12X511 - 1619 BOSTON ROAD","3c474313-33f4-ea11-b882-24ee9a37d45c",-73890591,40836245,"I.S. 98 - BRONX","1619 BOSTON ROAD"
2,2,0,"77e2635c-32f4-ea11-b882-24ee9a37d45c","Channel View School for Research - Q262 - Q410 - 27Q262 - 100-00 BEACH CHANNEL DRIVE","71e2635c-32f4-ea11-b882-24ee9a37d45c",-73825317,40586012,"Beach Channel Educational Campus","100-00 BEACH CHANNEL DRIVE"
8,6,2,"1e0410ca-32f4-ea11-b882-24ee9a37d45c","P.S. 045 John Tyler - R045 - R045 - 31R045 - 58 LAWRENCE AVENUE","1f0410ca-32f4-ea11-b882-24ee9a37d45c",-74107537,40628419,"P.S. 45 - STATEN ISLAND","58 LAWRENCE AVENUE"
1,0,1,"673cbf01-ebf6-ea11-b883-24ee9a37d459","P.S. X596 - X596 - X178 - 75X596 - 850 BAYCHESTER AVENUE","e38a0044-33f4-ea11-b882-24ee9a37d45c",-73831669,40874035,"P.S. 178 - BRONX","850 BAYCHESTER AVENUE"
1,1,0,"7d36d900-33f4-ea11-b882-24ee9a37d45c","E.S.M.T- I.S. 190 - X190 - X061 - 12X190 - 1550 CROTONA PARK EAST","7e36d900-33f4-ea11-b882-24ee9a37d45c",-73892784,40836156,"P.S. 61 - BRONX","1550 CROTONA PARK EAST"
3,3,0,"6affcc6e-33f4-ea11-b882-24ee9a37d45c","Antonia Pantoja Preparatory Academy: A College Board School - X376 - X450 - 08X376 - 1980 LAFAYETTE AVENUE","62ffcc6e-33f4-ea11-b882-24ee9a37d45c",-73855930,40821218,"Adlai E. Stevenson Educational Campus","1980 LAFAYETTE AVENUE"
1,1,0,"907e21a6-ebf6-ea11-b883-24ee9a37d459","P.S./I.S. 78Q - Q078 - Q312 - 30Q078 - 46-08 5TH STREET","cf454b50-32f4-ea11-b882-24ee9a37d45c",-73955145,40747077,"P.S./.IS. 78 - QUEENS","46-08 5TH STREET"
3,3,0,"8b11b2e2-32f4-ea11-b882-24ee9a37d45c","Staten Island School of Civic Leadership - R861 - R861 - 31R861 - 280 REGIS DRIVE","8a11b2e2-32f4-ea11-b882-24ee9a37d45c",-74164427,40620310,"ELIZABETH A. CONNELLY CAMPUS - S.I.","280 REGIS DRIVE"
4,4,0,"af69c231-32f4-ea11-b882-24ee9a37d45c","P.S. 207 Rockwood Park - Q207 - Q207 - 27Q207 - 159-15 88 STREET","b069c231-32f4-ea11-b882-24ee9a37d45c",-73843881,40657736,"PS/MS 207 Queens","159-15 88 STREET"
1,1,0,"a132c3fb-eaf6-ea11-b883-24ee9a37d459","P.S. 085 Judge Charles Vallone - Q085 - Q085 - 30Q085 - 23-70 31 STREET","0a7eed06-32f4-ea11-b882-24ee9a37d45c",-73915039,40773126,"P.S. 85 - QUEENS","23-70 31 STREET"
1,1,0,"f1d10307-33f4-ea11-b882-24ee9a37d45c","P.S. 071 Rose E. Scala - X071 - X071 - 08X071 - 3040 ROBERTS AVENUE","e3d10307-33f4-ea11-b882-24ee9a37d45c",-73829562,40845379,"P.S. 71 - BRONX","3040 ROBERTS AVENUE"
3,0,3,"8e476368-32f4-ea11-b882-24ee9a37d45c","International High School for Health Sciences - Q236 - Q455 - 24Q236 - 48-01 90 STREET","8c476368-32f4-ea11-b882-24ee9a37d45c",-73874129,40740824,"NEWTOWN HS - Q","48-01 90 STREET"
1,1,0,"9f28a20c-31f4-ea11-b882-24ee9a37d45c","P.S. 163 Bath Beach - K163 - K807 - 20K163 - 109 BAY 14TH STREET","9b28a20c-31f4-ea11-b882-24ee9a37d45c",-74007469,40606739,"P.S./ I.S. 163 - BROOKLYN","109 BAY 14TH STREET"
3,1,2,"a932c3fb-eaf6-ea11-b883-24ee9a37d459","P.S. Q004 - Q004 - Q179 - 75Q004 - 196-25 Peck Avenue","9c0e6e25-32f4-ea11-b882-24ee9a37d45c",-73778118,40741700,"P.S. 179 - QUEENS","196-25 Peck Avenue"
2,2,0,"f721d292-30f4-ea11-b882-24ee9a37d45c","P.S. 230 Doris L. Cohen - K230 - K230 - 15K230 - 1 ALBEMARLE ROAD","f321d292-30f4-ea11-b882-24ee9a37d45c",-73980515,40645609,"P.S. 230 - BROOKLYN","1 ALBEMARLE ROAD"
1,1,0,"90c280bd-31f4-ea11-b882-24ee9a37d45c","Harvest Collegiate High School - M534 - M883 - 02M534 - 34 WEST 14 STREET","8fc280bd-31f4-ea11-b882-24ee9a37d45c",-73995731,40736416,"LEGACY HS FOR INTEGR. STUDIES - M","34 WEST 14 STREET"
2,1,1,"0506003e-32f4-ea11-b882-24ee9a37d45c","P.S. 229 Emanuel Kaplan - Q229 - Q229 - 24Q229 - 67-25 51 ROAD","0106003e-32f4-ea11-b882-24ee9a37d45c",-73897108,40734682,"P.S. 229 - QUEENS","67-25 51 ROAD"
1,0,1,"17af1f69-ebf6-ea11-b883-24ee9a37d459","P.S. M169 - Robert F. Kennedy - M169 - M488 - 75M169 - 231-249 EAST 56 STREET","6d07e99e-31f4-ea11-b882-24ee9a37d45c",-73967204,40759248,"MIDTOWN EAST CAMPUS - MANHATTAN","231-249 EAST 56 STREET"
3,2,1,"20ebaa73-30f4-ea11-b882-24ee9a37d45c","P.S./ I.S. 155 Nicholas Herkimer - K155 - K155 - 23K155 - 1355 HERKIMER STREET","f6d27c6d-30f4-ea11-b882-24ee9a37d45c",-73908682,40677634,"P.S. 155 - BROOKLYN","1355 HERKIMER STREET"
1,0,1,"5b8946f4-31f4-ea11-b882-24ee9a37d45c","P.S. 045 Clarence Witherspoon - Q045 - Q045 - 27Q045 - 126-28 150 STREET","5c8946f4-31f4-ea11-b882-24ee9a37d45c",-73788866,40671871,"P.S. 45 - QUEENS","126-28 150 STREET"
3,3,0,"f2ae0313-32f4-ea11-b882-24ee9a37d45c","P.S. 122 Mamie Fay - Q122 - Q122 - 30Q122 - 21-21 DITMARS BOULEVARD","cb2ff20c-32f4-ea11-b882-24ee9a37d45c",-73915785,40780507,"P.S. 122 - QUEENS","21-21 DITMARS BOULEVARD"
4,3,1,"b779df48-30f4-ea11-b882-24ee9a37d45c","P.S. 058 The Carroll - K058 - K058 - 15K058 - 330 SMITH STREET","b879df48-30f4-ea11-b882-24ee9a37d45c",-73995486,40680379,"P.S. 58 - BROOKLYN","330 SMITH STREET"
1,0,1,"b5b36d80-30f4-ea11-b882-24ee9a37d45c","P.S. 179 Kensington - K179 - K179 - 20K179 - 202 AVENUE C","13d1de79-30f4-ea11-b882-24ee9a37d45c",-73977260,40640127,"P.S. 179 - BROOKLYN","202 AVENUE C"
4,4,0,"b73aa668-33f4-ea11-b882-24ee9a37d45c","Fordham High School for the Arts - X437 - X435 - 10X437 - 500 EAST FORDHAM ROAD","b03aa668-33f4-ea11-b882-24ee9a37d45c",-73888625,40859466,"THEODORE ROOSEVELT EDUCATIONAL CAMPUS - X","500 EAST FORDHAM ROAD"
3,1,2,"01f32ce2-31f4-ea11-b882-24ee9a37d45c","P.S. 012 James B. Colgate - Q012 - Q012 - 24Q012 - 42-00 72 STREET","02f32ce2-31f4-ea11-b882-24ee9a37d45c",-73893466,40742284,"P.S. 12 - QUEENS","42-00 72 STREET"
1,0,1,"e83159fa-30f4-ea11-b882-24ee9a37d45c","Clara Barton High School - K600 - K600 - 17K600 - 901 CLASSON AVENUE","e13159fa-30f4-ea11-b882-24ee9a37d45c",-73960689,40669805,"CLARA BARTON HS - K","901 CLASSON AVENUE"
2,2,0,"af2ff20c-32f4-ea11-b882-24ee9a37d45c","P.S. 105 The Bay School - Q105 - Q105 - 27Q105 - 420 BEACH 51 STREET","b02ff20c-32f4-ea11-b882-24ee9a37d45c",-73780961,40595911,"P.S. 105 - QUEENS","420 BEACH 51 STREET"
6,6,0,"db315367-30f4-ea11-b882-24ee9a37d45c","P.S. 132 The Conselyea School - K132 - K132 - 14K132 - 320 MANHATTAN AVENUE","dc315367-30f4-ea11-b882-24ee9a37d45c",-73945663,40714772,"P.S. 132 - BROOKLYN","320 MANHATTAN AVENUE"
2,2,0,"70a5db98-30f4-ea11-b882-24ee9a37d45c","P.S. 235 Janice Marie Knight School - K235 - K242 - 18K235 - 755 EAST 100 STREET","71a5db98-30f4-ea11-b882-24ee9a37d45c",-73898607,40645965,"P.S. 235 ANNEX - BROOKLYN","755 EAST 100 STREET"
5,3,2,"58507380-31f4-ea11-b882-24ee9a37d45c","P.S./I.S. 187 Hudson Cliffs - M187 - M187 - 06M187 - 349 CABRINI BOULEVARD","59507380-31f4-ea11-b882-24ee9a37d45c",-73936840,40856239,"P.S./I.S. 187 - MANHATTAN","349 CABRINI BOULEVARD"
4,3,1,"89e657bd-30f4-ea11-b882-24ee9a37d45c","The Urban Assembly School for Law and Justice - K483 - K313 - 13K483 - 283 ADAMS STREET","82e657bd-30f4-ea11-b882-24ee9a37d45c",-73988323,40694629,"ADAMS STREET EDUCATIONAL CAMPUS - K","283 ADAMS STREET"
1,0,1,"848946f4-31f4-ea11-b882-24ee9a37d45c","P.S. 58 - The School of Heroes - Q058 - Q058 - 24Q058 - 72-24 GRAND AVENUE","808946f4-31f4-ea11-b882-24ee9a37d45c",-73890638,40728517,"P.S. 58 - QUEENS","72-24 GRAND AVENUE"
1,0,1,"5d323483-e21e-eb11-b885-24ee9a37d45c","The Richmond Pre-K Center - R066 - R096 - 31R066 - 2040 Forest Avenue","5e323483-e21e-eb11-b885-24ee9a37d45c",-74157162,40625220,"3K CENTER @ 2040 FOREST AVENUE - STATEN ISLAND","2040 Forest Avenue"
1,1,0,"240410ca-32f4-ea11-b882-24ee9a37d45c","Naples Street Elementary School - R009 - R048 - 31R009 - 1055 Targee Street","250410ca-32f4-ea11-b882-24ee9a37d45c",-74090245,40602650,"P.S. 48 - STATEN ISLAND","1055 Targee Street"
1,1,0,"039ebaee-32f4-ea11-b882-24ee9a37d45c","P.S. 3 Raul Julia Micro Society - X003 - X003 - 10X003 - 2100 LAFONTAINE AVENUE","049ebaee-32f4-ea11-b882-24ee9a37d45c",-73891630,40850131,"P.S. 3 - BRONX","2100 LAFONTAINE AVENUE"
1,0,1,"c68442ee-31f4-ea11-b882-24ee9a37d45c","P.S. 031 Bayside - Q031 - Q031 - 26Q031 - 211-45 46 ROAD","c78442ee-31f4-ea11-b882-24ee9a37d45c",-73768994,40757701,"P.S. 31 - QUEENS","211-45 46 ROAD"
2,0,2,"9d32c3fb-eaf6-ea11-b883-24ee9a37d459","P.S. 009 - Q009 - Q009 - 75Q009 - 58-74 57 STREET","f8f22ce2-31f4-ea11-b882-24ee9a37d45c",-73912458,40718234,"P.S. 9 (W REED SCHOOL) - QUEENS","58-74 57 STREET"
1,1,0,"d792e6d5-30f4-ea11-b882-24ee9a37d45c","Cypress Hills Collegiate Preparatory School - K659 - K421 - 19K659 - 999 Jamaica Avenue","d892e6d5-30f4-ea11-b882-24ee9a37d45c",-73869305,40693002,"FRANKLIN K. LANE AF - BROOKLYN","999 Jamaica Avenue"
2,0,2,"0ba198c3-30f4-ea11-b882-24ee9a37d45c","Hyde Leadership Charter School- Brooklyn - K769 - K328 - 84K769 - 330 ALABAMA AVENUE","0ca198c3-30f4-ea11-b882-24ee9a37d45c",-73898249,40667985,"P.S. 328 - BROOKLYN","330 ALABAMA AVENUE"
1,0,1,"7e34aa92-31f4-ea11-b882-24ee9a37d45c","Quest to Learn - M422 - M440 - 02M422 - 351 WEST 18 STREET","7834aa92-31f4-ea11-b882-24ee9a37d45c",-74002540,40743407,"BAYARD RUSTIN EDUCATIONAL COMP-M","351 WEST 18 STREET"
1,0,1,"5d9f4974-31f4-ea11-b882-24ee9a37d45c","P.S. 153 Adam Clayton Powell - M153 - M153 - 06M153 - 1750 AMSTERDAM AVENUE","589f4974-31f4-ea11-b882-24ee9a37d45c",-73947599,40826514,"P.S. 153 - MANHATTAN","1750 AMSTERDAM AVENUE"
2,1,1,"c2c4bd60-4afb-ea11-b883-24ee9a37d459","1199 FUTURE OF AMERICA LEARNING CENTER - XAPN - XAPN -  - 2500 CRESTON AVENUE","c3c4bd60-4afb-ea11-b883-24ee9a37d459",-73897419,40862856,"1199 FUTURE OF AMERICA LEARNING CENTER","2500 CRESTON AVENUE"
5,5,0,"6707e99e-31f4-ea11-b882-24ee9a37d45c","Talent Unlimited High School - M519 - M480 - 02M519 - 317 EAST 67 STREET","6007e99e-31f4-ea11-b882-24ee9a37d45c",-73959777,40765638,"JULIA RICHMAN ED. COMPLEX - M","317 EAST 67 STREET"
1,1,0,"89886843-31f4-ea11-b882-24ee9a37d45c","P.S. 005 Ellen Lurie - M005 - M005 - 06M005 - 3703 TENTH AVENUE","8a886843-31f4-ea11-b882-24ee9a37d45c",-73922277,40857633,"P.S. 5 - MANHATTAN","3703 TENTH AVENUE"
1,1,0,"2c005d7a-31f4-ea11-b882-24ee9a37d45c","Community Math & Science Prep - M328 - M164 - 06M328 - 401 WEST 164 STREET","2a005d7a-31f4-ea11-b882-24ee9a37d45c",-73937263,40836982,"I.S. 164 - MANHATTAN","401 WEST 164 STREET"
2,1,1,"18a6ba98-31f4-ea11-b882-24ee9a37d45c","Success Academy Charter School - Union Square - M174 - M460 - 84M174 - 40 IRVING PLACE","16a6ba98-31f4-ea11-b882-24ee9a37d45c",-73987064,40735361,"WASHINGTON IRVING HS - MANHATTAN","40 IRVING PLACE"
1,0,1,"aeb66262-32f4-ea11-b882-24ee9a37d45c","Excelsior Preparatory High School - Q265 - Q420 - 29Q265 - 143-10 SPRINGFIELD BOULEVARD","abb66262-32f4-ea11-b882-24ee9a37d45c",-73757744,40669030,"SPRINGFIELD GARDENS HS - Q","143-10 SPRINGFIELD BOULEVARD"
2,1,1,"d0ba3c50-33f4-ea11-b882-24ee9a37d45c","Young Voices Academy of the Bronx - X357 - X292 - 11X357 - 800 LYDIG AVENUE","d1ba3c50-33f4-ea11-b882-24ee9a37d45c",-73863733,40854423,"THE DOMINIC CASTORE EDUCATIONAL CAMPUS - BRONX","800 LYDIG AVENUE"
9,9,0,"6ba5db98-30f4-ea11-b882-24ee9a37d45c","Mark Twain I.S. 239 for the Gifted & Talented - K239 - K239 - 21K239 - 2401 NEPTUNE AVENUE","6ca5db98-30f4-ea11-b882-24ee9a37d45c",-73992447,40578640,"I.S. 239 - BROOKLYN","2401 NEPTUNE AVENUE"
2,2,0,"48507380-31f4-ea11-b882-24ee9a37d45c","Amistad Dual Language School - M311 - M176 - 06M311 - 4862 BROADWAY","46507380-31f4-ea11-b882-24ee9a37d45c",-73923818,40866381,"P.S./I.S. 176 - MANHATTAN","4862 BROADWAY"
1,1,0,"52767649-31f4-ea11-b882-24ee9a37d45c","P.S. 041 Greenwich Village - M041 - M041 - 02M041 - 116 WEST 11 STREET","53767649-31f4-ea11-b882-24ee9a37d45c",-73999094,40735450,"P.S. 41 - MANHATTAN","116 WEST 11 STREET"
1,1,0,"68a5db98-30f4-ea11-b882-24ee9a37d45c","I. S. 381 - K381 - K240 - 22K381 - 2500 NOSTRAND AVENUE","69a5db98-30f4-ea11-b882-24ee9a37d45c",-73946836,40623788,"I.S. 240 - BROOKLYN","2500 NOSTRAND AVENUE"
3,1,2,"a5edf392-32f4-ea11-b882-24ee9a37d45c","Joseph F. Quinn Intermediate School 77 - Q077 - Q849 - 24Q077 - 976 Seneca Avenue","a4edf392-32f4-ea11-b882-24ee9a37d45c",-73902147,40699101,"I.S. 77 - QUEENS","976 Seneca Avenue"
2,2,0,"23005d7a-31f4-ea11-b882-24ee9a37d45c","P.S. 161 Pedro Albizu Campos - M161 - M161 - 05M161 - 499 WEST 133 STREET","22005d7a-31f4-ea11-b882-24ee9a37d45c",-73952476,40817719,"P.S. 161 - MANHATTAN","499 WEST 133 STREET"
1,1,0,"18474313-33f4-ea11-b882-24ee9a37d45c","P.S. 086 Kingsbridge Heights - X086 - X086 - 10X086 - 2756 RESERVOIR AVENUE","19474313-33f4-ea11-b882-24ee9a37d45c",-73897066,40869061,"P.S. 86 - BRONX","2756 RESERVOIR AVENUE"
1,0,1,"868946f4-31f4-ea11-b882-24ee9a37d45c","Success Academy Charter School - Springfield Gardens - New York 6 - Q339 - Q059 - 84Q339 - 132-55 RIDGEDALE STREET","878946f4-31f4-ea11-b882-24ee9a37d45c",-73752772,40681881,"I.S. 59 - QUEENS","132-55 RIDGEDALE STREET"
9,6,3,"380d6d19-33f4-ea11-b882-24ee9a37d45c","P.S. 105 Sen Abraham Bernstein - X105 - X105 - 11X105 - 725 Brady Avenue","390d6d19-33f4-ea11-b882-24ee9a37d45c",-73866264,40853075,"P.S. 105 - BRONX","725 Brady Avenue"
2,0,2,"5b3cbf01-ebf6-ea11-b883-24ee9a37d459","Success Academy Charter School - Bronx 2 - X494 - X055 - 84X494 - 450 SAINT PAUL'S PLACE","6236d900-33f4-ea11-b882-24ee9a37d45c",-73904970,40835934,"P.S. 55 - BRONX","450 SAINT PAUL'S PLACE"
2,2,0,"d9968d36-30f4-ea11-b882-24ee9a37d45c","P.S. 020 Clinton Hill - K020 - K020 - 13K020 - 225 ADELPHI STREET","d1968d36-30f4-ea11-b882-24ee9a37d45c",-73970896,40690742,"P.S. 20 - BROOKLYN","225 ADELPHI STREET"
2,2,0,"4be61462-31f4-ea11-b882-24ee9a37d45c","M.S. 224 Manhattan East School for Arts & Academics - M224 - M099 - 04M224 - 410 EAST 100 STREET","3de61462-31f4-ea11-b882-24ee9a37d45c",-73942154,40785107,"I.S. 99 - MANHATTAN","410 EAST 100 STREET"
3,2,1,"cd689025-33f4-ea11-b882-24ee9a37d45c","Success Academy Charter School - Bronx 4 - New York 2 - X464 - X131 - 84X464 - 885 Bolton Avenue","c8689025-33f4-ea11-b882-24ee9a37d45c",-73859998,40822925,"I.S. 131 - BRONX","885 Bolton Avenue"
1,1,0,"399f4974-31f4-ea11-b882-24ee9a37d45c","P.S. 140 Nathan Straus - M140 - M140 - 01M140 - 123 RIDGE STREET","3a9f4974-31f4-ea11-b882-24ee9a37d45c",-73983769,40719148,"P.S. 140 - MANHATTAN","123 RIDGE STREET"
2,2,0,"440b210d-33f4-ea11-b882-24ee9a37d45c","I.S. 232 - X232 - X082 - 09X232 - 1700 MACOMBS ROAD","3f0b210d-33f4-ea11-b882-24ee9a37d45c",-73915217,40849416,"I.S. 232 - BRONX","1700 MACOMBS ROAD"
2,1,1,"2ee61462-31f4-ea11-b882-24ee9a37d45c","KIPP NYC Washington Heights Academy Charter School - M068 - M090 - 84M068 - 21 JUMEL PLACE","2ce61462-31f4-ea11-b882-24ee9a37d45c",-73935815,40839139,"I.S. 90 - MANHATTAN","21 JUMEL PLACE"
1,1,0,"84a9d9c3-32f4-ea11-b882-24ee9a37d45c","P.S. 032 The Gifford School - R032 - R032 - 31R032 - 232 Barlow Avenue","80a9d9c3-32f4-ea11-b882-24ee9a37d45c",-74155400,40557900,"P.S. 32 - STATEN ISLAND","232 Barlow Avenue"
2,0,2,"2aeabc42-30f4-ea11-b882-24ee9a37d45c","P.S. 052 Sheepshead Bay - K052 - K052 - 22K052 - 2675 EAST 29 STREET","26eabc42-30f4-ea11-b882-24ee9a37d45c",-73940135,40588372,"P.S. 52 - BROOKLYN","2675 EAST 29 STREET"
3,1,2,"e3315367-30f4-ea11-b882-24ee9a37d45c","P.S. 138 Brooklyn - K138 - K138 - 17K138 - 760 PROSPECT PLACE","e4315367-30f4-ea11-b882-24ee9a37d45c",-73951559,40673943,"P.S. 138 - BROOKLYN","760 PROSPECT PLACE"
1,1,0,"4febaa73-30f4-ea11-b882-24ee9a37d45c","New Bridges Elementary - K532 - K167 - 17K532 - 1025 EASTERN PARKWAY","4cebaa73-30f4-ea11-b882-24ee9a37d45c",-73934316,40669557,"P.S. 167 - BROOKLYN","1025 EASTERN PARKWAY"
3,3,0,"9369c231-32f4-ea11-b882-24ee9a37d45c","P.S./M.S. 200 - The Magnet School of Global Studies and Leadership - Q200 - Q200 - 25Q200 - 70-10 164 STREET","9469c231-32f4-ea11-b882-24ee9a37d45c",-73805759,40731070,"P.S. 200 - QUEENS","70-10 164 STREET"
1,1,0,"9ee657bd-30f4-ea11-b882-24ee9a37d45c","I.S. 318 Eugenio Maria De Hostos - K318 - K318 - 14K318 - 101 WALTON STREET","9de657bd-30f4-ea11-b882-24ee9a37d45c",-73948771,40703034,"I.S. 318 - BROOKLYN","101 WALTON STREET"
4,3,1,"40474313-33f4-ea11-b882-24ee9a37d45c","P.S. 097 Bronx - X097 - X097 - 11X097 - 1375 Mace Avenue","41474313-33f4-ea11-b882-24ee9a37d45c",-73846768,40863524,"P.S. 97 - BRONX","1375 Mace Avenue"
4,3,1,"6ca9d9c3-32f4-ea11-b882-24ee9a37d45c","I.S. 024 Myra S. Barnes - R024 - R024 - 31R024 - 750 DURANT AVENUE","5bfdc1bd-32f4-ea11-b882-24ee9a37d45c",-74145558,40545490,"I.S. 24 - STATEN ISLAND","750 DURANT AVENUE"
2,2,0,"45507380-31f4-ea11-b882-24ee9a37d45c","Muscota - M314 - M176 - 06M314 - 4862 BROADWAY","46507380-31f4-ea11-b882-24ee9a37d45c",-73923818,40866381,"P.S./I.S. 176 - MANHATTAN","4862 BROADWAY"
4,3,1,"92977d2b-32f4-ea11-b882-24ee9a37d45c","P.S. 197 The Ocean School - Q197 - Q197 - 27Q197 - 825 HICKSVILLE ROAD","93977d2b-32f4-ea11-b882-24ee9a37d45c",-73744128,40599664,"P.S. 197 - QUEENS","825 HICKSVILLE ROAD"
1,1,0,"d28442ee-31f4-ea11-b882-24ee9a37d45c","P.S. 035 Nathaniel Woodhull - Q035 - Q035 - 29Q035 - 90-01 191 Street","bb8442ee-31f4-ea11-b882-24ee9a37d45c",-73768894,40713438,"P.S. 35 - QUEENS","191-02 90 Avenue"
4,4,0,"362f7d06-31f4-ea11-b882-24ee9a37d45c","Brooklyn Studio Secondary School - K690 - K721 - 21K690 - 8310 21ST AVENUE","56416e00-31f4-ea11-b882-24ee9a37d45c",-73995084,40604980,"BROOKLYN STUDIO (TANDEM K128) - K","8310 21ST AVENUE"
1,1,0,"20a6ba98-31f4-ea11-b882-24ee9a37d45c","Academy for Software Engineering - M546 - M460 - 02M546 - 40 IRVING PLACE","16a6ba98-31f4-ea11-b882-24ee9a37d45c",-73987064,40735361,"WASHINGTON IRVING HS - MANHATTAN","40 IRVING PLACE"
5,4,1,"5c2f77fa-31f4-ea11-b882-24ee9a37d45c","P.S. 060 Woodhaven - Q060 - Q060 - 27Q060 - 91-02 88 AVENUE","8e8946f4-31f4-ea11-b882-24ee9a37d45c",-73852792,40691467,"P.S. 60 - QUEENS","91-02 88 AVENUE"
2,0,2,"d53159fa-30f4-ea11-b882-24ee9a37d45c","George Westinghouse Career and Technical Education High School - K605 - K580 - 13K605 - 105 TECH PLACE","d33159fa-30f4-ea11-b882-24ee9a37d45c",-73986105,40695444,"GEORGE WESTINGHOUSE VOC HS - K","105 TECH PLACE"
1,1,0,"7303194f-30f4-ea11-b882-24ee9a37d45c","P.S. 69 Vincent D. Grippo School - K069 - K069 - 20K069 - 6302 9TH AVENUE","7203194f-30f4-ea11-b882-24ee9a37d45c",-74009752,40632392,"P.S. 69 - BROOKLYN","6302 9TH AVENUE"
2,1,1,"ca92e6d5-30f4-ea11-b882-24ee9a37d45c","Academy of Innovative Technology - K618 - K420 - 19K618 - 999 JAMAICA AVENUE","c692e6d5-30f4-ea11-b882-24ee9a37d45c",-73869305,40693002,"FRANKLIN K. LANE HS - K","999 JAMAICA AVENUE"
1,1,0,"dd9b4c1f-32f4-ea11-b882-24ee9a37d45c","P.S. 152 Gwendoline N. Alleyne School - Q152 - Q152 - 30Q152 - 33-52 62 STREET","de9b4c1f-32f4-ea11-b882-24ee9a37d45c",-73900584,40753094,"P.S. 152 - QUEENS","33-52 62 STREET"
1,1,0,"0c78931f-33f4-ea11-b882-24ee9a37d45c","J.H.S. 118 William W. Niles - X118 - X118 - 10X118 - 577 EAST 179 STREET","0b78931f-33f4-ea11-b882-24ee9a37d45c",-73892482,40848702,"I.S. 118 - BRONX","577 EAST 179 STREET"
1,1,0,"c979df48-30f4-ea11-b882-24ee9a37d45c","Achievement First East New York Charter School - K358 - K065 - 84K358 - 158 RICHMOND STREET","ca79df48-30f4-ea11-b882-24ee9a37d45c",-73877256,40683399,"P.S. 65 - BROOKLYN","158 RICHMOND STREET"
2,2,0,"aefc24e8-31f4-ea11-b882-24ee9a37d45c","P.S. 021 Edward Hart - Q021 - Q021 - 25Q021 - 147-36 26 AVENUE","adfc24e8-31f4-ea11-b882-24ee9a37d45c",-73818581,40774134,"P.S. 21 - QUEENS","147-36 26 AVENUE"
1,1,0,"b6fab455-31f4-ea11-b882-24ee9a37d45c","University Neighborhood Middle School - M332 - M056 - 01M332 - 220 HENRY STREET","affab455-31f4-ea11-b882-24ee9a37d45c",-73986051,40713362,"J.H.S. 56 - MANHATTAN","220 HENRY STREET"
4,4,0,"5e8946f4-31f4-ea11-b882-24ee9a37d45c","P.S. 046 Alley Pond - Q046 - Q046 - 26Q046 - 64-45 218 STREET","5f8946f4-31f4-ea11-b882-24ee9a37d45c",-73758042,40745744,"P.S. 46 - QUEENS","64-45 218 STREET"
1,1,0,"72f4a0ef-eaf6-ea11-b883-24ee9a37d459","P.S. K369 - Coy L. Cox School - K369 - K369 - 75K369 - 383 STATE STREET","03e2abc9-30f4-ea11-b882-24ee9a37d45c",-73983312,40687432,"P.S. 369 (COY COX SCHOOL)-K","383 STATE STREET"
2,1,1,"35de5eb7-30f4-ea11-b882-24ee9a37d45c","Evergreen Middle School for Urban Exploration - K562 - K296 - 32K562 - 125 COVERT STREET","99283fb1-30f4-ea11-b882-24ee9a37d45c",-73910589,40688647,"I.S. 296 - BROOKLYN","125 COVERT STREET"
2,1,1,"1002926e-32f4-ea11-b882-24ee9a37d45c","Knowledge and Power Preparatory Academy VI - Q282 - Q465 - 27Q282 - 8-21 BAY 25 STREET","0b02926e-32f4-ea11-b882-24ee9a37d45c",-73763995,40601537,"FAR ROCKAWAY HS - Q","8-21 BAY 25 STREET"
1,1,0,"068b0044-33f4-ea11-b882-24ee9a37d45c","Bronx Delta School - X392 - X192 - 08X392 - 650 HOLLYWOOD AVENUE","078b0044-33f4-ea11-b882-24ee9a37d45c",-73818083,40826794,"I.S. 192 - BRONX","650 HOLLYWOOD AVENUE"
4,3,1,"cbe8ce00-32f4-ea11-b882-24ee9a37d45c","I.S. 73 - The Frank Sansivieri Intermediate School - Q073 - Q073 - 24Q073 - 70-02 54 AVENUE","cce8ce00-32f4-ea11-b882-24ee9a37d45c",-73893318,40728558,"I.S. 73 - QUEENS","70-02 54 AVENUE"
1,0,1,"31eabc42-30f4-ea11-b882-24ee9a37d45c","Achievement First Brownsville Charter School - K626 - K055 - 84K626 - 2021 BERGEN STREET","32eabc42-30f4-ea11-b882-24ee9a37d45c",-73912685,40674456,"I.S. 55 - BROOKLYN","2021 BERGEN STREET"
3,3,0,"430410ca-32f4-ea11-b882-24ee9a37d45c","Space Shuttle Columbia School - R058 - R058 - 31R058 - 77 MARSH AVENUE","2a0410ca-32f4-ea11-b882-24ee9a37d45c",-74160867,40582791,"P.S. 58 - STATEN ISLAND","77 MARSH AVENUE"
1,1,0,"429f4974-31f4-ea11-b882-24ee9a37d45c","Washington Heights Expeditionary Learning School - M348 - M143 - 06M348 - 511 WEST 182ND STREET","3f9f4974-31f4-ea11-b882-24ee9a37d45c",-73930991,40849311,"I.S. 143 - MANHATTAN","511 WEST 182ND STREET"
3,3,0,"f9b6c337-32f4-ea11-b882-24ee9a37d45c","P.S. 213 The Carl Ullman School - Q213 - Q213 - 26Q213 - 231-02 67 AVENUE","f8b6c337-32f4-ea11-b882-24ee9a37d45c",-73745390,40747457,"P.S. 213 - QUEENS","231-02 67 AVENUE"
2,1,1,"9383ff9e-30f4-ea11-b882-24ee9a37d45c","P.S. 250 George H. Lindsay - K250 - K250 - 14K250 - 108 MONTROSE AVENUE","9483ff9e-30f4-ea11-b882-24ee9a37d45c",-73945659,40706708,"P.S. 250 - BROOKLYN","108 MONTROSE AVENUE"
1,0,1,"64395a2c-ebf6-ea11-b883-24ee9a37d459","Achievement First Apollo Charter School - K774 - K292 - 84K774 - 301 VERMONT STREET","8a283fb1-30f4-ea11-b882-24ee9a37d45c",-73893319,40671601,"I.S. 292 - BROOKLYN","301 VERMONT STREET"
1,0,1,"ded27c6d-30f4-ea11-b882-24ee9a37d45c","P.S. 373 - Brooklyn Transition Center - K373 - K148 - 75K373 - 185 ELLERY STREET","dcd27c6d-30f4-ea11-b882-24ee9a37d45c",-73945211,40699214,"P.S. 373 (OLD P148) - BROOKLYN","185 ELLERY STREET"
3,3,0,"413cbf01-ebf6-ea11-b883-24ee9a37d459","The Riverview School - Q277 - Q777 - 75Q277 - 50-15 44th Street","f22ece86-32f4-ea11-b882-24ee9a37d45c",-73921346,40736680,"PS 199 ANNEX(@ST. TERESA'S) - QUEENS","50-15 44th Street"
1,0,1,"aadab801-ecf6-ea11-b883-24ee9a37d459","Pathways to Graduation - Q950 - X440 - 79Q950 - 100 WEST MOSHOLU PARKWAY SOUTH","4cffcc6e-33f4-ea11-b882-24ee9a37d45c",-73889011,40879958,"DEWITT CLINTON HS - X","100 WEST MOSHOLU PARKWAY SOUTH"
1,1,0,"2b7becf3-49fb-ea11-b883-24ee9a37d459","GUILD PRESCHOOL - KBAI - KBAI -  - 1273 57TH STREET","2c7becf3-49fb-ea11-b883-24ee9a37d459",-73996847,40630871,"GUILD FOR EXCEPTIONAL CHILDREN","1273 57TH STREET"
1,0,1,"1fba8b86-30f4-ea11-b882-24ee9a37d45c","M.S. K394 - K394 - K210 - 17K394 - 188 ROCHESTER AVENUE","08ba8b86-30f4-ea11-b882-24ee9a37d45c",-73928917,40672710,"I.S. 394 - BROOKLYN","188 ROCHESTER AVENUE"
3,3,0,"2645378b-4afb-ea11-b883-24ee9a37d459","RIVERDALE NEIGHBORHOOD HOUSE, INC - XAPA - XAPA -  - 5521 MOSHOLU AVENUE","2745378b-4afb-ea11-b883-24ee9a37d459",-73903843,40903491,"RIVERDALE NEIGHBORHOOD HOUSE, INC","5521 MOSHOLU AVENUE"
2,2,0,"2fa198c3-30f4-ea11-b882-24ee9a37d45c","Frederick Douglass Academy VIII Middle School - K452 - K346 - 19K452 - 1400 PENNSYLVANIA AVENUE","30a198c3-30f4-ea11-b882-24ee9a37d45c",-73881997,40646640,"P.S. 346 - BROOKLYN","1400 PENNSYLVANIA AVENUE"
2,1,1,"d1f57030-30f4-ea11-b882-24ee9a37d45c","P.S. 007 Abraham Lincoln - K007 - K007 - 19K007 - 858 JAMAICA AVENUE","fcc1392a-30f4-ea11-b882-24ee9a37d45c",-73872983,40689213,"P.S. 7 - BROOKLYN","858 JAMAICA AVENUE"
1,1,0,"502f7d06-31f4-ea11-b882-24ee9a37d45c","The Maurice Sendak Community School - K118 - K763 - 15K118 - 211 8TH STREET","512f7d06-31f4-ea11-b882-24ee9a37d45c",-73987602,40671145,"P.S. 118 MAURICE SENDAK COMMUNITY SCHOOL- BROOKLYN","211 8TH STREET"
4,2,2,"0804d718-31f4-ea11-b882-24ee9a37d45c","I.S. 340 - K340 - K874 - 17K340 - 227 Sterling Place","0904d718-31f4-ea11-b882-24ee9a37d45c",-73970315,40676357,"I.S. 340 (OLD 249 AX) - BROOKLYN","227 Sterling Place"
1,1,0,"25e0d393-ebf6-ea11-b883-24ee9a37d459","P.S. Q993 - Q993 - Q130 - 75Q993 - 200-01 42 AVENUE","04af0313-32f4-ea11-b882-24ee9a37d45c",-73784009,40760219,"P.S. 130 - QUEENS","200-01 42 AVENUE"
5,5,0,"2806003e-32f4-ea11-b882-24ee9a37d45c","P.S. 239 - Q239 - Q239 - 24Q239 - 17-15 WEIRFIELD STREET","2606003e-32f4-ea11-b882-24ee9a37d45c",-73903838,40699431,"P.S. 239 - QUEENS","17-15 WEIRFIELD STREET"
4,3,1,"440d6d19-33f4-ea11-b882-24ee9a37d45c","P.S. 108 Philip J. Abinanti - X108 - X108 - 11X108 - 1166 NEILL AVENUE","450d6d19-33f4-ea11-b882-24ee9a37d45c",-73853200,40854700,"P.S. 108 - BRONX","1166 NEILL AVENUE"
1,0,1,"12ae38fc-7001-ed11-b8db-24ee9a37d45c","The Richard H. Hungerford School - R721 - R086 - 75R721 - 715 L Ocean Terrace","713f38e4-e9e5-ec11-b8d9-24ee9a37d45c",-74108045,40608374,"I.S./H.S. @ 715L OCEAN TERRACE - STATEN ISLAND","715 L Ocean Terrace"
4,3,1,"4b71bd14-8b23-ed11-b0a2-088e901ef405","The East Village Community School - M315 - M019 - 01M315 - 185 1 AVENUE","2b767649-31f4-ea11-b882-24ee9a37d45c",-73984496,40730009,"P.S. 19 - MANHATTAN","185 1 AVENUE"
1,0,1,"e221d292-30f4-ea11-b882-24ee9a37d45c","P.S. 224 Hale A. Woodruff - K224 - K224 - 19K224 - 757 WORTMAN AVENUE","e121d292-30f4-ea11-b882-24ee9a37d45c",-73866542,40664143,"P.S. 224 - BROOKLYN","757 WORTMAN AVENUE"
1,1,0,"72283fb1-30f4-ea11-b882-24ee9a37d45c","Community Roots Charter School - K536 - K287 - 84K536 - 50 NAVY STREET","73283fb1-30f4-ea11-b882-24ee9a37d45c",-73981120,40697856,"P.S. 287 - BROOKLYN","50 NAVY STREET"
1,1,0,"438dbfcf-30f4-ea11-b882-24ee9a37d45c","Life Academy High School for Film and Music - K559 - K400 - 21K559 - 2630 BENSON AVENUE","3a8dbfcf-30f4-ea11-b882-24ee9a37d45c",-73986313,40593028,"Lafayette Educational Campus","2630 BENSON AVENUE"
1,1,0,"538dbfcf-30f4-ea11-b882-24ee9a37d45c","Abraham Lincoln High School - K410 - K410 - 21K410 - 2800 OCEAN PARKWAY","518dbfcf-30f4-ea11-b882-24ee9a37d45c",-73968733,40582627,"ABRAHAM LINCOLN HS - K","2800 OCEAN PARKWAY"
1,1,0,"307eed06-32f4-ea11-b882-24ee9a37d45c","P.S. 097 Forest Park - Q097 - Q097 - 27Q097 - 85-52 85 STREET","317eed06-32f4-ea11-b882-24ee9a37d45c",-73860031,40694232,"P.S. 97 - QUEENS","85-52 85 STREET"
1,1,0,"38c73b4a-32f4-ea11-b882-24ee9a37d45c","Corona Arts & Sciences Academy - Q311 - Q311 - 24Q311 - 98-11 44TH AVENUE","36c73b4a-32f4-ea11-b882-24ee9a37d45c",-73865239,40745920,"P.S./ I.S. 311 - QUEENS","98-11 44TH AVENUE"
1,0,1,"f6ae0313-32f4-ea11-b882-24ee9a37d45c","P.S. 123 - Q123 - Q123 - 27Q123 - 145-01 119 AVENUE","f7ae0313-32f4-ea11-b882-24ee9a37d45c",-73795571,40678913,"P.S. 123 - QUEENS","145-01 119 AVENUE"
2,2,0,"d1b36d80-30f4-ea11-b882-24ee9a37d45c","P.S. 186 Dr. Irving A Gladstone - K186 - K186 - 20K186 - 7601 19 AVENUE","d2b36d80-30f4-ea11-b882-24ee9a37d45c",-73994258,40610917,"P.S. 186 - BROOKLYN","7601 19 AVENUE"
3,3,0,"348dbfcf-30f4-ea11-b882-24ee9a37d45c","P.S. 398 Walter Weaver - K398 - K398 - 17K398 - 60 EAST 94 STREET","308dbfcf-30f4-ea11-b882-24ee9a37d45c",-73927979,40663388,"P.S. 398 (UDC) - BROOKLYN","60 EAST 94 STREET"
3,1,2,"399ebaee-32f4-ea11-b882-24ee9a37d45c","P.S. 019 Judith K. Weiss - X019 - X019 - 11X019 - 311 East 237 Street","319ebaee-32f4-ea11-b882-24ee9a37d45c",-73866949,40899351,"P.S. 19 - BRONX","311 East 237 Street"
3,3,0,"12c73b4a-32f4-ea11-b882-24ee9a37d45c","David N. Dinkins School - Q048 - Q276 - 28Q048 - 108-29 155 STREET","0ec73b4a-32f4-ea11-b882-24ee9a37d45c",-73796358,40693736,"THE WILLIAM WORDSWORTH EDUCATIONAL COMPLEX","108-29 155 STREET"
1,0,1,"78283fb1-30f4-ea11-b882-24ee9a37d45c","P.S. 288 The Shirley Tanyhill - K288 - K288 - 21K288 - 2950 WEST 25 STREET","79283fb1-30f4-ea11-b882-24ee9a37d45c",-73992393,40574029,"P.S. 288 - BROOKLYN","2950 WEST 25 STREET"
1,1,0,"d3ed94c3-31f4-ea11-b882-24ee9a37d45c","Young Women's Leadership School - M610 - M895 - 04M610 - 105 East 106th Street","d4ed94c3-31f4-ea11-b882-24ee9a37d45c",-73947171,40792932,"YOUNG WOMEN'S LEADERSHIP HS - M","105 East 106th Street"
13,12,1,"34eabc42-30f4-ea11-b882-24ee9a37d45c","Brooklyn Collegiate: A College Board School - K493 - K055 - 23K493 - 2021 BERGEN STREET","32eabc42-30f4-ea11-b882-24ee9a37d45c",-73912685,40674456,"I.S. 55 - BROOKLYN","2021 BERGEN STREET"
2,1,1,"f391111a-ebf6-ea11-b883-24ee9a37d459","P.S. 372 -The Children's School - K372 - K113 - 75K372 - 300 ADELPHI STREET","1fe85c61-30f4-ea11-b882-24ee9a37d45c",-73971474,40688769,"I.S. 113 - BROOKLYN","300 ADELPHI STREET"
5,4,1,"7107e99e-31f4-ea11-b882-24ee9a37d45c","Fiorello H. LaGuardia High School of Music & Art and Performing Arts - M485 - M485 - 03M485 - 100 Amsterdam Avenue","7207e99e-31f4-ea11-b882-24ee9a37d45c",-73985976,40774202,"FIORELLO LAGUARDIA HS - MANHATTAN","100 Amsterdam Avenue"
1,0,1,"2102926e-32f4-ea11-b882-24ee9a37d45c","Queens Collegiate: A College Board School - Q310 - Q470 - 28Q310 - 167-01 GOTHIC DRIVE","1f02926e-32f4-ea11-b882-24ee9a37d45c",-73798658,40714551,"JAMAICA HS - Q","167-01 GOTHIC DRIVE"
4,3,1,"2e0410ca-32f4-ea11-b882-24ee9a37d45c","I.S. 051 Edwin Markham - R051 - R051 - 31R051 - 80 WILLOWBROOK ROAD","2f0410ca-32f4-ea11-b882-24ee9a37d45c",-74145522,40623077,"I.S. 51 - STATEN ISLAND","80 WILLOWBROOK ROAD"
4,3,1,"82be7adc-32f4-ea11-b882-24ee9a37d45c","P.S. 65 The Academy of Innovative Learning - R065 - R829 - 31R065 - 98 GRANT STREET","83be7adc-32f4-ea11-b882-24ee9a37d45c",-74078337,40633666,"ARTHUR D. PHILLIPS SCHOOL - S.I.","98 GRANT STREET"
1,1,0,"612f7d06-31f4-ea11-b882-24ee9a37d45c","District 20 Pre-K Center - K768 - K780 - 20K768 - 7415 Fort Hamilton Parkway","622f7d06-31f4-ea11-b882-24ee9a37d45c",-74015894,40626158,"PRE-K CENTER @FORT HAMILTON PARKWAY - BROOKLYN","7415 Fort Hamilton Parkway"
2,2,0,"5907e99e-31f4-ea11-b882-24ee9a37d45c","High School for Health Professions and Human Services - M420 - M475 - 02M420 - 345 East 15th Street","5607e99e-31f4-ea11-b882-24ee9a37d45c",-73982590,40732665,"HEALTH PROFESSIONS HS (OL STY) - M","345 East 15th Street"
9,9,0,"0ab7c337-32f4-ea11-b882-24ee9a37d45c","P.S. 219 Paul Klapper - Q219 - Q219 - 25Q219 - 144-39 GRAVETT ROAD","0bb7c337-32f4-ea11-b882-24ee9a37d45c",-73823841,40737448,"P.S. 219 - QUEENS","144-39 GRAVETT ROAD"
2,2,0,"4f474313-33f4-ea11-b882-24ee9a37d45c","P.S. 100 Isaac Clason - X100 - X100 - 08X100 - 800 TAYLOR AVENUE","50474313-33f4-ea11-b882-24ee9a37d45c",-73862760,40822552,"P.S. 100 - BRONX","800 TAYLOR AVENUE"
1,0,1,"307c21b7-32f4-ea11-b882-24ee9a37d45c","I.S. R002 George L. Egbert - R002 - R002 - 31R002 - 333 Midland Avenue","2b7c21b7-32f4-ea11-b882-24ee9a37d45c",-74099685,40576728,"I.S. 2 - STATEN ISLAND","333 Midland Avenue"
1,1,0,"cd315367-30f4-ea11-b882-24ee9a37d45c","P.S. 127 Mckinley Park - K127 - K127 - 20K127 - 7805 7 Avenue","ce315367-30f4-ea11-b882-24ee9a37d45c",-74018429,40623687,"P.S. 127 - BROOKLYN","7805 7 Avenue"
1,1,0,"186e3d68-31f4-ea11-b882-24ee9a37d45c","P.S. 115 Alexander Humboldt - M115 - M115 - 06M115 - 586 WEST 177 STREET","166e3d68-31f4-ea11-b882-24ee9a37d45c",-73935140,40846116,"P.S. 115 - MANHATTAN","586 WEST 177 STREET"
1,1,0,"ffbdf08c-32f4-ea11-b882-24ee9a37d45c","Baccalaureate School for Global Education - Q580 - Q798 - 30Q580 - 34-12 36 AVENUE","00bef08c-32f4-ea11-b882-24ee9a37d45c",-73926977,40754975,"BACCALAUREATE SCL FOR GLOBAL ED-Q","34-12 36 AVENUE"
1,1,0,"c392e6d5-30f4-ea11-b882-24ee9a37d45c","Cultural Academy for the Arts and Sciences - K629 - K415 - 18K629 - 5800 TILDEN AVENUE","5b8dbfcf-30f4-ea11-b882-24ee9a37d45c",-73922212,40647728,"SAMUEL J. TILDEN EDUCATIONAL CAMPUS - K","5800 TILDEN AVENUE"
1,0,1,"533cbf01-ebf6-ea11-b883-24ee9a37d459","South Richmond High School I.S./P.S. 25 - R025 - R825 - 75R025 - 6581 HYLAN BOULEVARD","77be7adc-32f4-ea11-b882-24ee9a37d45c",-74218688,40512019,"P.S. 25 (MOUNT LORETTO) - S.I.","6581 HYLAN BOULEVARD"
1,1,0,"7be2635c-32f4-ea11-b882-24ee9a37d45c","Rockaway Collegiate High School - Q351 - Q410 - 27Q351 - 100-00 BEACH CHANNEL DRIVE","71e2635c-32f4-ea11-b882-24ee9a37d45c",-73825317,40586012,"Beach Channel Educational Campus","100-00 BEACH CHANNEL DRIVE"
1,0,1,"7ed92255-30f4-ea11-b882-24ee9a37d45c","P.S. 90 Edna Cohen School - K090 - K090 - 21K090 - 2840 WEST 12 STREET","7dd92255-30f4-ea11-b882-24ee9a37d45c",-73980387,40578192,"P.S. 90 - BROOKLYN","2840 WEST 12 STREET"
1,1,0,"e42ece86-32f4-ea11-b882-24ee9a37d45c","Young Women's Leadership School, Astoria - Q286 - Q739 - 30Q286 - 23-15 Newtown Avenue","e52ece86-32f4-ea11-b882-24ee9a37d45c",-73923830,40770769,"YOUNG WOMEN'S LEADERSHIP ACADEMY- QUEENS","23-15 Newtown Avenue"
2,2,0,"ba72c880-32f4-ea11-b882-24ee9a37d45c","Information Technology High School - Q502 - Q725 - 30Q502 - 21-16 44th Road","b972c880-32f4-ea11-b882-24ee9a37d45c",-73946488,40748502,"HS FOR INFORMATION TECH - QUEENS","21-16 44th Road"
1,1,0,"410d6d19-33f4-ea11-b882-24ee9a37d45c","Mott Hall III - X128 - X110 - 09X128 - 580 CROTONA PARK SOUTH","420d6d19-33f4-ea11-b882-24ee9a37d45c",-73900654,40834470,"P.S. 110 - BRONX","580 CROTONA PARK SOUTH"
1,1,0,"56275a30-4afb-ea11-b883-24ee9a37d459","BROOKLYN CHINESE AMERICAN ASSOCIATION - KBMM - KBMM -  - 812 54TH STREET","57275a30-4afb-ea11-b883-24ee9a37d459",-74005822,40638466,"BROOKLYN CHINESE AMERICAN ASSOCIATION","812 54TH STREET"
11,4,7,"05af0313-32f4-ea11-b882-24ee9a37d45c","P.S. 127 Aerospace Science Magnet School - Q127 - Q127 - 30Q127 - 98-01 25 AVENUE","06af0313-32f4-ea11-b882-24ee9a37d45c",-73870931,40765507,"P.S. 127 - QUEENS","98-01 25 AVENUE"
1,1,0,"692f77fa-31f4-ea11-b882-24ee9a37d45c","P.S. 063 Old South - Q063 - Q063 - 27Q063 - 90-15 SUTTER AVENUE","6a2f77fa-31f4-ea11-b882-24ee9a37d45c",-73846796,40676978,"P.S. 63 - QUEENS","90-15 SUTTER AVENUE"
2,1,1,"9748b1f5-eaf6-ea11-b883-24ee9a37d459","P.S. 372 -The Children's School - K372 - K834 - 75K372 - 512 CARROLL STREET","fcd7cf12-31f4-ea11-b882-24ee9a37d45c",-73985500,40676198,"P.S. 372 (OUR LADY OF PEACE)-K","512 CARROLL STREET"
2,2,0,"f302cefa-32f4-ea11-b882-24ee9a37d45c","P.S. 032 Belmont - X032 - X032 - 10X032 - 690 EAST 183 STREET","f402cefa-32f4-ea11-b882-24ee9a37d45c",-73886220,40851724,"P.S. 32 - BRONX","690 EAST 183 STREET"
6,4,2,"b9b66262-32f4-ea11-b882-24ee9a37d45c","John Bowne High School - Q425 - Q425 - 25Q425 - 63-25 MAIN STREET","bab66262-32f4-ea11-b882-24ee9a37d45c",-73823841,40737448,"JOHN BOWNE HS - QUEENS","63-25 MAIN STREET"
5,3,2,"38005d7a-31f4-ea11-b882-24ee9a37d45c","J.H.S. 167 Robert F. Wagner - M167 - M167 - 02M167 - 220 EAST 76 STREET","39005d7a-31f4-ea11-b882-24ee9a37d45c",-73957827,40771541,"I.S. 167 - MANHATTAN","220 EAST 76 STREET"
1,1,0,"bbbfa431-33f4-ea11-b882-24ee9a37d45c","The Laboratory School of Finance and Technology: X223 - X223 - X149 - 07X223 - 360 EAST 145 STREET","bcbfa431-33f4-ea11-b882-24ee9a37d45c",-73920851,40813612,"J.H.S. 149 - BRONX","360 EAST 145 STREET"
1,0,1,"983c646f-e21e-eb11-b885-24ee9a37d45c","The David Marquis School of the Arts - R037 - R089 - 75R037 - 15a Fairfield Street","993c646f-e21e-eb11-b885-24ee9a37d45c",-74151375,40564093,"D75 REPLACEMENT @ 15 FAIRFIELD STREET - S.I.","15a Fairfield Street"
1,1,0,"f58ac007-ebf6-ea11-b883-24ee9a37d459","Garden of Learning and Discovery Pre-K Center - X582 - X582 - 09X582 - 1434 OGDEN AVENUE","84eb0e7b-33f4-ea11-b882-24ee9a37d45c",-73923738,40843378,"PRE-K CENTER @OGDEN AVENUE","1434 OGDEN AVENUE"
2,2,0,"458dbfcf-30f4-ea11-b882-24ee9a37d45c","Leaders High School - K572 - K400 - 21K572 - 2630 BENSON AVENUE","3a8dbfcf-30f4-ea11-b882-24ee9a37d45c",-73986313,40593028,"Lafayette Educational Campus","2630 BENSON AVENUE"
2,1,1,"1d2ed53d-33f4-ea11-b882-24ee9a37d45c","Baychester Academy - X169 - X169 - 11X169 - 3500 EDSON AVENUE","1e2ed53d-33f4-ea11-b882-24ee9a37d45c",-73839386,40881344,"THE WILLIE ELLA PASCHAL BOWMAN CAMPUS - X","3500 EDSON AVENUE"
1,1,0,"2b2ed53d-33f4-ea11-b882-24ee9a37d45c","P.S. 236 Langston Hughes - X236 - X173 - 09X236 - 1871 WALTON AVENUE","2c2ed53d-33f4-ea11-b882-24ee9a37d45c",-73909936,40848907,"P.S. 236 (P173 ECC) - BRONX","1871 WALTON AVENUE"
1,1,0,"cf2ff20c-32f4-ea11-b882-24ee9a37d45c","P.S./I.S. 116 William C. Hughley - Q116 - Q116 - 29Q116 - 107-25 WREN PLACE","d02ff20c-32f4-ea11-b882-24ee9a37d45c",-73781839,40700840,"P.S. 116 - QUEENS","107-25 WREN PLACE"
2,2,0,"95eb6056-32f4-ea11-b882-24ee9a37d45c","District 29 Pre-K Center - Q381 - Q381 - 29Q381 - 168-42 JAMAICA AVENUE","96eb6056-32f4-ea11-b882-24ee9a37d45c",-73791304,40706724,"PRE-K CENTER @168-42 JAMAICA AVENUE - QUEENS","168-42 JAMAICA AVENUE"
1,0,1,"470410ca-32f4-ea11-b882-24ee9a37d45c","The Harbor View School - R059 - R059 - 31R059 - 300 Richmond Terrace","480410ca-32f4-ea11-b882-24ee9a37d45c",-74083408,40647898,"THE HARBOR VIEW SCHOOL - STATEN ISLAND","300 Richmond Terrace"
14,11,3,"c5fab455-31f4-ea11-b882-24ee9a37d45c","East Side Community School - M450 - M060 - 01M450 - 420 East 12 Street","c1fab455-31f4-ea11-b882-24ee9a37d45c",-73982472,40729152,"J.H.S. 60 - MANHATTAN","420 East 12 Street"
1,1,0,"9f53dd74-33f4-ea11-b882-24ee9a37d45c","Marble Hill High School for International Studies - X477 - X475 - 10X477 - 99 TERRACE VIEW AVENUE","9853dd74-33f4-ea11-b882-24ee9a37d45c",-73912686,40877379,"JOHN F. KENNEDY HS - X","99 TERRACE VIEW AVENUE"
1,1,0,"e7ba3c50-33f4-ea11-b882-24ee9a37d45c","P.S. 204 Morris Heights - X204 - X338 - 09X204 - 1780 DR. MARTIN LUTHER KING JR. BLVD","e3ba3c50-33f4-ea11-b882-24ee9a37d45c",-73915217,40849416,"MORRIS HEIGHTS EDUCATIONAL COMPLEX - BRONX","1780 DR. MARTIN LUTHER KING JR. BLVD"
1,1,0,"ca85f462-ebf6-ea11-b883-24ee9a37d459","P.S. M811 - Mickey Mantle School - M811 - M149 - 75M811 - 34 West 118 Street","539f4974-31f4-ea11-b882-24ee9a37d45c",-73948088,40802649,"P.S. 149 (TANDEM M207) - MANHATTAN","34 West 118 Street"
2,1,1,"eace496e-31f4-ea11-b882-24ee9a37d45c","P.S. 124 Yung Wing - M124 - M124 - 02M124 - 40 DIVISION STREET","e8ce496e-31f4-ea11-b882-24ee9a37d45c",-73996017,40715097,"P.S. 124 (ECF) - MANHATTAN","40 DIVISION STREET"
3,2,1,"f6f57030-30f4-ea11-b882-24ee9a37d45c","P.S. 015 Patrick F. Daly - K015 - K015 - 15K015 - 71 SULLIVAN STREET","f5f57030-30f4-ea11-b882-24ee9a37d45c",-74011864,40677085,"P.S. 15 - BROOKLYN","71 SULLIVAN STREET"
2,2,0,"f6b98b86-30f4-ea11-b882-24ee9a37d45c","P.S. 197 - The Kings Highway Academy - K197 - K197 - 22K197 - 1599 EAST 22 STREET","f7b98b86-30f4-ea11-b882-24ee9a37d45c",-73951398,40612339,"P.S. 197 - BROOKLYN","1599 EAST 22 STREET"
1,0,1,"24e2abc9-30f4-ea11-b882-24ee9a37d45c","KIPP AMP Charter School - K357 - K390 - 84K357 - 1224 PARK PLACE","25e2abc9-30f4-ea11-b882-24ee9a37d45c",-73937601,40672290,"I.S. 390 - BROOKLYN","1224 PARK PLACE"
4,3,1,"e377bb9f-33f4-ea11-b882-24ee9a37d45c","Urban Assembly School for Applied Math and Science, The - X241 - X970 - 09X241 - 1595 BATHGATE AVENUE","e177bb9f-33f4-ea11-b882-24ee9a37d45c",-73901774,40839508,"BATHGATE HS - BRONX","1595 BATHGATE AVENUE"
4,2,2,"40b4977a-32f4-ea11-b882-24ee9a37d45c","Queens Technical High School - Q600 - Q600 - 24Q600 - 37-02 47 AVENUE","41b4977a-32f4-ea11-b882-24ee9a37d45c",-73927995,40741658,"QUEENS VOC HS - Q","37-02 47 AVENUE"
2,2,0,"49ebaa73-30f4-ea11-b882-24ee9a37d45c","The East New York Arts and Civics High School - K953 - K166 - 19K953 - 800 VAN SICLEN AVE","41ebaa73-30f4-ea11-b882-24ee9a37d45c",-73885704,40659934,"I.S. 166 - BROOKLYN","800 VAN SICLEN AVE"
1,1,0,"e7f22ce2-31f4-ea11-b882-24ee9a37d45c","I.S. 5 - The Walter Crowley Intermediate School - Q005 - Q005 - 24Q005 - 50-40 JACOBUS STREET","9adc32dc-31f4-ea11-b882-24ee9a37d45c",-73888133,40737405,"I.S. 5 - QUEENS","50-40 JACOBUS STREET"
3,1,2,"66a5db98-30f4-ea11-b882-24ee9a37d45c","P.S. 238 Anne Sullivan - K238 - K238 - 21K238 - 1633 EAST 8 STREET","65a5db98-30f4-ea11-b882-24ee9a37d45c",-73964586,40608801,"P.S. 238 - BROOKLYN","1633 EAST 8 STREET"
1,0,1,"f38ac007-ebf6-ea11-b883-24ee9a37d459","P.S. X176 - X176 - X455 - 75X176 - 750 BAYCHESTER AVENUE","8253dd74-33f4-ea11-b882-24ee9a37d45c",-73831669,40874035,"HARRY S. TRUMAN HS - X","750 BAYCHESTER AVENUE"
1,0,1,"19e85c61-30f4-ea11-b882-24ee9a37d45c","I.S. 347 School of Humanities - K347 - K111 - 32K347 - 35 STARR STREET","18e85c61-30f4-ea11-b882-24ee9a37d45c",-73927938,40700810,"I.S. 111 - BROOKLYN","35 STARR STREET"
1,0,1,"e9968d36-30f4-ea11-b882-24ee9a37d45c","Success Academy Charter School - Bed Stuy 3 - K883 - K025 - 84K883 - 787 LAFAYETTE AVENUE","ea968d36-30f4-ea11-b882-24ee9a37d45c",-73940749,40691472,"P.S. 25 - BROOKLYN","787 LAFAYETTE AVENUE"
1,0,1,"d4e8ce00-32f4-ea11-b882-24ee9a37d45c","P.S. 076 William Hallet - Q076 - Q076 - 30Q076 - 36-36 10 Street","d2e8ce00-32f4-ea11-b882-24ee9a37d45c",-73941630,40760862,"P.S. 76 - QUEENS","36-36 10 Street"
1,0,1,"692b3eee-30f4-ea11-b882-24ee9a37d45c","Franklin Delano Roosevelt High School - K505 - K505 - 20K505 - 5800 20 AVENUE","682b3eee-30f4-ea11-b882-24ee9a37d45c",-73982583,40621299,"FRANKLIN D. ROOSEVELT HS - K","5800 20 AVENUE"
2,1,1,"e6454b50-32f4-ea11-b882-24ee9a37d45c","Queens Explorers Elementary School - Q316 - Q316 - 27Q316 - 90-07 101ST AVENUE","e7454b50-32f4-ea11-b882-24ee9a37d45c",-73850123,40683112,"THE OZONE PARK EDUCATIONAL CAMPUS - QUEENS","90-07 101ST AVENUE"
2,2,0,"8b476368-32f4-ea11-b882-24ee9a37d45c","Newtown High School - Q455 - Q455 - 24Q455 - 48-01 90 STREET","8c476368-32f4-ea11-b882-24ee9a37d45c",-73874129,40740824,"NEWTOWN HS - Q","48-01 90 STREET"
1,1,0,"68dc32dc-31f4-ea11-b882-24ee9a37d45c","Success Academy Charter School - Hudson Yards - M358 - MBMO - 84M358 - 500 West 41 Street","dd430bd6-31f4-ea11-b882-24ee9a37d45c",-73996499,40758759,"Hudson Yards","500 West 41 Street"
2,2,0,"22d8cf12-31f4-ea11-b882-24ee9a37d45c","Success Academy Charter School - Bergen Beach - New York 4 - K781 - K864 - 84K781 - 3109 NEWKIRK AVENUE","23d8cf12-31f4-ea11-b882-24ee9a37d45c",-73947025,40640551,"P.S. 361 (OLD 89) - BROOKLYN","3109 NEWKIRK AVENUE"
1,1,0,"db8fd20d-ebf6-ea11-b883-24ee9a37d459","P.S. K771 - K771 - K014 - 75K771 - 2424 BATCHELDER STREET","eef57030-30f4-ea11-b882-24ee9a37d45c",-73938107,40593232,"I.S. 14 - BROOKLYN","2424 BATCHELDER STREET"
3,3,0,"1f005d7a-31f4-ea11-b882-24ee9a37d45c","P.S. 158 Bayard Taylor - M158 - M158 - 02M158 - 1458 YORK AVENUE","1d005d7a-31f4-ea11-b882-24ee9a37d45c",-73950745,40770215,"P.S. 158 - MANHATTAN","1458 YORK AVENUE"
2,2,0,"d08521d0-32f4-ea11-b882-24ee9a37d45c","Port Richmond School for Visionary Learning - R068 - R066 - 31R068 - 1625 FOREST AVENUE","d18521d0-32f4-ea11-b882-24ee9a37d45c",-74142526,40624781,"ECC @1625 FOREST AVENUE - STATEN ISLAND","1625 FOREST AVENUE"
1,1,0,"27ceb75a-4afb-ea11-b883-24ee9a37d459","Brooklyn Treehouse Preschool, Inc. - KCMK - KCMK -  - 639 4 AVENUE","28ceb75a-4afb-ea11-b883-24ee9a37d459",-73994638,40663716,"Brooklyn Treehouse Preeschool, Inc.","639 4 AVENUE"
1,1,0,"e8b98b86-30f4-ea11-b882-24ee9a37d45c","M.S. 582 - K582 - K196 - 14K582 - 207 BUSHWICK AVENUE","e9b98b86-30f4-ea11-b882-24ee9a37d45c",-73939385,40708804,"P.S. 196 - BROOKLYN","207 BUSHWICK AVENUE"
1,1,0,"8803194f-30f4-ea11-b882-24ee9a37d45c","Brooklyn Environmental Exploration School (BEES) - K664 - K073 - 23K664 - 251 MAC DOUGAL STREET","8503194f-30f4-ea11-b882-24ee9a37d45c",-73910719,40680679,"P.S. 73 - BROOKLYN","251 MAC DOUGAL STREET"
1,0,1,"68f4a0ef-eaf6-ea11-b883-24ee9a37d459","P.S. K811 Connie Lekas School - K811 - K286 - 75K811 - 2525 HARING STREET","6e283fb1-30f4-ea11-b882-24ee9a37d45c",-73938610,40591132,"P.S. 811 (OLD P286) - BROOKLYN","2525 HARING STREET"
2,1,1,"edc88e4f-31f4-ea11-b882-24ee9a37d45c","Inwood Early College for Health and Information Technologies - M211 - M052 - 06M211 - 650 ACADEMY STREET","e6c88e4f-31f4-ea11-b882-24ee9a37d45c",-73925464,40865556,"I.S. 52 - MANHATTAN","650 ACADEMY STREET"
1,0,1,"58de5eb7-30f4-ea11-b882-24ee9a37d45c","Achievement First Aspire Charter School - K680 - K306 - 84K680 - 970 VERMONT STREET","59de5eb7-30f4-ea11-b882-24ee9a37d45c",-73886620,40655340,"P.S. 306 - BROOKLYN","970 VERMONT STREET"
1,0,1,"9d48b1f5-eaf6-ea11-b883-24ee9a37d459","P.S. K077 - K077 - K902 - 75K077 - 62 PARK PLACE","2604d718-31f4-ea11-b882-24ee9a37d45c",-73976648,40678809,"P.S. 77 ANNEX - BROOKLYN","62 PARK PLACE"
1,1,0,"bbba3c50-33f4-ea11-b882-24ee9a37d45c","Comprehensive Model School Project M.S. 327 - X327 - X240 - 09X327 - 1501 JEROME AVENUE","baba3c50-33f4-ea11-b882-24ee9a37d45c",-73916084,40842503,"DOE NEW SETTLEMENT COMMUNITY CAMPUS - X","1501 JEROME AVENUE"
1,1,0,"d7f57030-30f4-ea11-b882-24ee9a37d45c","Public School 9 The Sarah Smith Garnet School - K009 - K009 - 13K009 - 80 UNDERHILL AVENUE","d8f57030-30f4-ea11-b882-24ee9a37d45c",-73966333,40678554,"P.S. 9 - BROOKLYN","80 UNDERHILL AVENUE"
1,0,1,"81a5db98-30f4-ea11-b882-24ee9a37d45c","P.S. 244 Richard R. Green - K244 - K244 - 18K244 - 5404 TILDEN AVENUE","7fa5db98-30f4-ea11-b882-24ee9a37d45c",-73925592,40647851,"P.S. 244 - BROOKLYN","5404 TILDEN AVENUE"
1,1,0,"bd69c231-32f4-ea11-b882-24ee9a37d45c","P.S. 212 - Q212 - Q212 - 30Q212 - 34-25 82 STREET","b969c231-32f4-ea11-b882-24ee9a37d45c",-73884458,40753035,"P.S. 212 - QUEENS","34-25 82 STREET"
1,1,0,"0db7c337-32f4-ea11-b882-24ee9a37d45c","P.S. 220 Edward Mandel - Q220 - Q220 - 28Q220 - 62-10 108 STREET","0eb7c337-32f4-ea11-b882-24ee9a37d45c",-73852621,40736314,"P.S. 220 - QUEENS","62-10 108 STREET"
6,6,0,"07fc3df4-30f4-ea11-b882-24ee9a37d45c","John Dewey High School - K540 - K540 - 21K540 - 50 AVENUE X","05fc3df4-30f4-ea11-b882-24ee9a37d45c",-73981925,40588070,"JOHN DEWEY HS - K","50 AVENUE X"
2,2,0,"9ae657bd-30f4-ea11-b882-24ee9a37d45c","P.S. 133 William A. Butler - K133 - K317 - 13K133 - 610 Baltic Street","99e657bd-30f4-ea11-b882-24ee9a37d45c",-73980455,40679916,"P.S. 133 WILLIAM A. BUTLER - BROOKLYN","610 Baltic Street"
4,2,2,"1b78931f-33f4-ea11-b882-24ee9a37d45c","P.S. 121 Throop - X121 - X121 - 11X121 - 2750 THROOP AVENUE","1c78931f-33f4-ea11-b882-24ee9a37d45c",-73850510,40866474,"P.S. 121 - BRONX","2750 THROOP AVENUE"
1,1,0,"009c4c1f-32f4-ea11-b882-24ee9a37d45c","P.S. 162 John Golden - Q162 - Q162 - 26Q162 - 201-02 53 AVENUE","019c4c1f-32f4-ea11-b882-24ee9a37d45c",-73776576,40748405,"P.S. 162 - QUEENS","201-02 53 AVENUE"
2,1,1,"21c73b4a-32f4-ea11-b882-24ee9a37d45c","Helen M. Marshall School - Q330 - Q287 - 24Q330 - 110-08 NORTHERN BOULEVARD","20c73b4a-32f4-ea11-b882-24ee9a37d45c",-73859202,40757888,"P.S. 330 - QUEENS","110-08 NORTHERN BOULEVARD"
3,2,1,"a7e657bd-30f4-ea11-b882-24ee9a37d45c","P.S. 375 Jackie Robinson School - K375 - K320 - 17K375 - 46 MCKEEVER PLACE","a1e657bd-30f4-ea11-b882-24ee9a37d45c",-73959484,40665199,"P.S. 375 - BROOKLYN","46 MCKEEVER PLACE"
1,1,0,"92eb0e7b-33f4-ea11-b882-24ee9a37d45c","New Visions Charter High School for Advanced Math and Science II - X202 - X650 - 84X202 - 900 TINTON AVENUE","91eb0e7b-33f4-ea11-b882-24ee9a37d45c",-73902892,40821723,"JANE ADDAMS HS - X","900 TINTON AVENUE"
1,1,0,"4bde5eb7-30f4-ea11-b882-24ee9a37d45c","Rachel Carson High School for Coastal Studies - K344 - K303 - 21K344 - 521 WEST AVENUE","4cde5eb7-30f4-ea11-b882-24ee9a37d45c",-73972009,40582518,"I.S. 303 - BROOKLYN","521 WEST AVENUE"
1,1,0,"a6778cb8-ebf6-ea11-b883-24ee9a37d459","Pathways to Graduation - Q950 - Q595 - 79Q950 - 162-02 HILLSIDE AVENUE","39b4977a-32f4-ea11-b882-24ee9a37d45c",-73799532,40708204,"AUX. SERV. - JAMAICA LEARN CT - Q","162-02 HILLSIDE AVENUE"
4,1,3,"7deb0e7b-33f4-ea11-b882-24ee9a37d45c","P.S./M.S. 11X498 - Van Nest Academy - X498 - X498 - 11X498 - 1640 BRONXDALE AVE","7eeb0e7b-33f4-ea11-b882-24ee9a37d45c",-73857989,40845023,"THE LT. CURTIS MEYRAN AND JOHN BELLEW ED COMPLEX","1640 BRONXDALE AVE"
1,1,0,"e39b4c1f-32f4-ea11-b882-24ee9a37d45c","P.S. 154 Queens - Q154 - Q154 - 25Q154 - 75-02 162 Street","d69b4c1f-32f4-ea11-b882-24ee9a37d45c",-73807750,40726473,"P.S. 154 - QUEENS","75-02 162 Street"
1,1,0,"0d0410ca-32f4-ea11-b882-24ee9a37d45c","The Stephanie A. Vierno School - R041 - R041 - 31R041 - 216 CLAWSON STREET","0e0410ca-32f4-ea11-b882-24ee9a37d45c",-74108492,40573599,"P.S. 41 - STATEN ISLAND","216 CLAWSON STREET"
1,0,1,"993aa668-33f4-ea11-b882-24ee9a37d45c","High School for Contemporary Arts - X544 - X425 - 11X544 - 800 EAST GUN HILL ROAD","699d7c62-33f4-ea11-b882-24ee9a37d45c",-73861649,40875172,"EVANDER CHILDS HS - X","800 EAST GUN HILL ROAD"
1,1,0,"f38052e9-ebf6-ea11-b883-24ee9a37d459","School for Cooperative Technical Education - M645 - X039 - 79M645 - 965 LONGWOOD AVENUE","0203cefa-32f4-ea11-b882-24ee9a37d45c",-73897876,40817741,"NEW SCH FOR ARTS AND SCIENCE - X","965 LONGWOOD AVENUE"
1,0,1,"42ebaa73-30f4-ea11-b882-24ee9a37d45c","P.S. 165 Ida Posner - K165 - K165 - 23K165 - 76 LOTT AVENUE","43ebaa73-30f4-ea11-b882-24ee9a37d45c",-73910938,40657061,"P.S. 165 - BROOKLYN","76 LOTT AVENUE"
1,1,0,"11af0313-32f4-ea11-b882-24ee9a37d45c","P.S. 132 Ralph Bunche - Q132 - Q132 - 29Q132 - 132-15 218 STREET","12af0313-32f4-ea11-b882-24ee9a37d45c",-73749300,40681948,"P.S. 132 - QUEENS","132-15 218 STREET"
1,1,0,"31005d7a-31f4-ea11-b882-24ee9a37d45c","P.S. 165 Robert E. Simon - M165 - M165 - 03M165 - 234 West 109 Street","2f005d7a-31f4-ea11-b882-24ee9a37d45c",-73965949,40802653,"P.S. 165 - MANHATTAN","234 West 109 Street"
1,1,0,"6241e65b-31f4-ea11-b882-24ee9a37d45c","Yorkville Community School - M151 - M066 - 02M151 - 421 East 88 Street","6341e65b-31f4-ea11-b882-24ee9a37d45c",-73947287,40777948,"RICHARD R GREEN HS OF TEACHING - M","421 East 88 Street"
1,0,1,"cdba3c50-33f4-ea11-b882-24ee9a37d45c","The Highbridge Green School - X361 - X285 - 09X361 - 200 West 167th Street","ceba3c50-33f4-ea11-b882-24ee9a37d45c",-73927892,40838232,"HIGHBRIDGE ENVIRONMENTAL EDUCATION CAMPUS - BRONX","200 West 167th Street"
1,1,0,"ba9c11e8-30f4-ea11-b882-24ee9a37d45c","The Academy of Urban Planning and Engineering - K552 - K480 - 32K552 - 400 IRVING AVENUE","b39c11e8-30f4-ea11-b882-24ee9a37d45c",-73911751,40696457,"BUSHWICK EDUCATIONAL CAMPUS - K","400 IRVING AVENUE"
1,1,0,"862aa42b-33f4-ea11-b882-24ee9a37d45c","Bronx Park Middle School - X556 - X135 - 11X556 - 2441 WALLACE AVENUE","d4689025-33f4-ea11-b882-24ee9a37d45c",-73865028,40862098,"I.S. 135 - BRONX","2441 WALLACE AVENUE"
1,1,0,"57042f6f-ebf6-ea11-b883-24ee9a37d459","Success Academy Charter School - Harlem 1 - M351 - M620 - 84M351 - 111 EAST 33RD STREET","a0d810ab-31f4-ea11-b882-24ee9a37d45c",-73981070,40746510,"NORMAN THOMAS HS (ECF) - MANHATTAN","111 EAST 33RD STREET"
9,6,3,"14e85c61-30f4-ea11-b882-24ee9a37d45c","P.S. 110 The Monitor - K110 - K110 - 14K110 - 124 MONITOR STREET","e50d3c5b-30f4-ea11-b882-24ee9a37d45c",-73941926,40723743,"P.S. 110 - BROOKLYN","124 MONITOR STREET"
1,1,0,"f5454b50-32f4-ea11-b882-24ee9a37d45c","P.S. 376 - Q376 - Q332 - 26Q376 - 210-21 48 AVENUE","f6454b50-32f4-ea11-b882-24ee9a37d45c",-73770314,40754954,"Bayside Hills School of Excellence","210-21 48 AVENUE"
1,1,0,"acab074a-33f4-ea11-b882-24ee9a37d45c","Mott Hall Community School - X467 - X192 - 08X467 - 650 HOLLYWOOD AVENUE","078b0044-33f4-ea11-b882-24ee9a37d45c",-73818083,40826794,"I.S. 192 - BRONX","650 HOLLYWOOD AVENUE"
1,1,0,"693cbf01-ebf6-ea11-b883-24ee9a37d459","P.S. X017 - X017 - X184 - 75X017 - 778 FOREST AVENUE","f88a0044-33f4-ea11-b882-24ee9a37d45c",-73905389,40818703,"I.S. 184 - BRONX","778 FOREST AVENUE"
1,1,0,"39a6ba98-31f4-ea11-b882-24ee9a37d45c","Frank McCourt High School - M417 - M470 - 03M417 - 145 WEST 84 STREET","33a6ba98-31f4-ea11-b882-24ee9a37d45c",-73974483,40786134,"LOUIS D. BRANDEIS HS - MANHATTAN","145 WEST 84 STREET"
1,0,1,"c056635c-33f4-ea11-b882-24ee9a37d45c","Herbert H. Lehman High School - X405 - X405 - 08X405 - 3000 EAST TREMONT AVENUE","b556635c-33f4-ea11-b882-24ee9a37d45c",-73839583,40839775,"HERBERT H. LEHMAN HS - X","3000 EAST TREMONT AVENUE"
1,1,0,"4a0d6d19-33f4-ea11-b882-24ee9a37d45c","P.S. 110 Theodore Schoenfeld - X110 - X110 - 09X110 - 580 CROTONA PARK SOUTH","420d6d19-33f4-ea11-b882-24ee9a37d45c",-73900654,40834470,"P.S. 110 - BRONX","580 CROTONA PARK SOUTH"
1,1,0,"d99319d7-ebf6-ea11-b883-24ee9a37d459","The Richmond Pre-K Center - R066 - R068 - 31R066 - 1 TELEPORT DRIVE","d98521d0-32f4-ea11-b882-24ee9a37d45c",-74178183,40607104,"PRE-K CENTER @ 1 TELEPORT DRIVE - STATEN ISLAND","1 TELEPORT DRIVE"
1,0,1,"a2d810ab-31f4-ea11-b882-24ee9a37d45c","Manhattan Academy For Arts & Language - M427 - M620 - 02M427 - 111 EAST 33RD STREET","a0d810ab-31f4-ea11-b882-24ee9a37d45c",-73981070,40746510,"NORMAN THOMAS HS (ECF) - MANHATTAN","111 EAST 33RD STREET"
2,2,0,"4c5b4cd6-32f4-ea11-b882-24ee9a37d45c","Staten Island Technical High School - R605 - R440 - 31R605 - 485 CLAWSON STREET","4b5b4cd6-32f4-ea11-b882-24ee9a37d45c",-74117086,40568299,"STATEN ISLAND TECHNICAL HS - S.I.","485 CLAWSON STREET"
1,1,0,"05ba8b86-30f4-ea11-b882-24ee9a37d45c","P.S. 202 Ernest S. Jenkyns - K202 - K202 - 19K202 - 982 HEGEMAN AVENUE","f4b98b86-30f4-ea11-b882-24ee9a37d45c",-73876084,40665817,"P.S. 202 - BROOKLYN","982 HEGEMAN AVENUE"
1,0,1,"db11f898-32f4-ea11-b882-24ee9a37d45c","Robert F. Wagner, Jr. Secondary School for Arts and Technology - Q560 - Q891 - 24Q560 - 47-07 30th Place","d911f898-32f4-ea11-b882-24ee9a37d45c",-73936442,40742217,"R. F. WAGNER SEC SCL ARTS & TECH-Q","47-07 30th Place"
1,0,1,"b5edf392-32f4-ea11-b882-24ee9a37d45c","P.S. 054 Hillside - Q054 - Q864 - 28Q054 - 86-02 127 Street","b6edf392-32f4-ea11-b882-24ee9a37d45c",-73824629,40702656,"P.S. 54 MINISCHOOL - QUEENS","86-02 127 Street"
1,1,0,"fa201dab-30f4-ea11-b882-24ee9a37d45c","P.S. 282 Park Slope - K282 - K282 - 13K282 - 180 6 Avenue","f8201dab-30f4-ea11-b882-24ee9a37d45c",-73977983,40676649,"P.S. 282 - BROOKLYN","180 6 Avenue"
2,2,0,"44025a42-4afb-ea11-b883-24ee9a37d459","EAST HARLEM BLOCK NURSERY SITE 1 - MAPH - MAPH -  - 215 EAST 106 STREET","45025a42-4afb-ea11-b883-24ee9a37d459",-73943062,40791772,"EAST HARLEM BLOCK NURSERY SITE 1","215 EAST 106 STREET"
1,1,0,"46de5eb7-30f4-ea11-b882-24ee9a37d45c","Vista Academy - K661 - K302 - 19K661 - 350 LINWOOD STREET","42de5eb7-30f4-ea11-b882-24ee9a37d45c",-73884211,40677112,"I.S. 302 - BROOKLYN","350 LINWOOD STREET"
2,2,0,"8041e65b-31f4-ea11-b882-24ee9a37d45c","The Bilingual Bicultural School - M182 - M083 - 04M182 - 219 East 109 Street","8141e65b-31f4-ea11-b882-24ee9a37d45c",-73941955,40793363,"P.S. 83 - MANHATTAN","219 East 109 Street"
5,5,0,"18f32ce2-31f4-ea11-b882-24ee9a37d45c","P.S. 019 Marino Jeantet - Q019 - Q019 - 24Q019 - 98-02 ROOSEVELT AVENUE","19f32ce2-31f4-ea11-b882-24ee9a37d45c",-73866557,40748600,"P.S. 19 - QUEENS","98-02 ROOSEVELT AVENUE"
1,1,0,"91e657bd-30f4-ea11-b882-24ee9a37d45c","P.S. 506: The School of Journalism & Technology - K506 - K314 - 20K506 - 330 59 Street","8ee657bd-30f4-ea11-b882-24ee9a37d45c",-74019299,40641950,"P.S. 314 - BROOKLYN","330 59 Street"
6,3,3,"a02aa42b-33f4-ea11-b882-24ee9a37d45c","P.S. X140 The Eagle School - X140 - X140 - 08X140 - 916 EAGLE AVENUE","9f2aa42b-33f4-ea11-b882-24ee9a37d45c",-73907489,40823318,"P.S. 140 - BRONX","916 EAGLE AVENUE"
1,1,0,"369ebaee-32f4-ea11-b882-24ee9a37d45c","P.S. 018 John Peter Zenger - X018 - X018 - 07X018 - 502 MORRIS AVENUE","379ebaee-32f4-ea11-b882-24ee9a37d45c",-73922697,40816369,"P.S. 18 - BRONX","502 MORRIS AVENUE"
2,1,1,"bf315367-30f4-ea11-b882-24ee9a37d45c","P.S. 123 Suydam - K123 - K123 - 32K123 - 100 IRVING AVENUE","bb315367-30f4-ea11-b882-24ee9a37d45c",-73922388,40704076,"P.S. 123 - BROOKLYN","100 IRVING AVENUE"
1,1,0,"3aa10a44-32f4-ea11-b882-24ee9a37d45c","P.S. 254 - The Rosa Parks School - Q254 - Q254 - 27Q254 - 84-40 101 STREET","39a10a44-32f4-ea11-b882-24ee9a37d45c",-73847886,40697200,"P.S. 254 - QUEENS","84-40 101 STREET"
6,2,4,"36474313-33f4-ea11-b882-24ee9a37d45c","P.S. 094 Kings College School - X094 - X094 - 10X094 - 3530 KINGS COLLEGE PLACE","37474313-33f4-ea11-b882-24ee9a37d45c",-73875268,40880661,"P.S. 94 - BRONX","3530 KINGS COLLEGE PLACE"
1,1,0,"638946f4-31f4-ea11-b882-24ee9a37d45c","Village Academy - Q319 - Q053 - 27Q319 - 10-45 NAMEOKE STREET","648946f4-31f4-ea11-b882-24ee9a37d45c",-73749891,40604019,"I.S. 53 - QUEENS","10-45 NAMEOKE STREET"
1,1,0,"5707e99e-31f4-ea11-b882-24ee9a37d45c","Institute for Collaborative Education - M407 - M475 - 02M407 - 345 East 15th Street","5607e99e-31f4-ea11-b882-24ee9a37d45c",-73982590,40732665,"HEALTH PROFESSIONS HS (OL STY) - M","345 East 15th Street"
1,0,1,"db37fba4-31f4-ea11-b882-24ee9a37d45c","Cascades High School - M650 - M510 - 01M650 - 198 Forsyth Street","d737fba4-31f4-ea11-b882-24ee9a37d45c",-73990468,40722415,"FORSYTH HS (AUXSVC-OLD 91) - M","198 Forsyth Street"
1,0,1,"60507380-31f4-ea11-b882-24ee9a37d45c","P.S. 138 - M138 - M189 - 75M138 - 2580 AMSTERDAM AVENUE","5f507380-31f4-ea11-b882-24ee9a37d45c",-73928048,40853045,"P.S. 189 - MANHATTAN","2580 AMSTERDAM AVENUE"
1,1,0,"5d2f7d06-31f4-ea11-b882-24ee9a37d45c","El Puente Academy for Peace and Justice - K685 - K778 - 14K685 - 250 Hooper Street","5e2f7d06-31f4-ea11-b882-24ee9a37d45c",-73955741,40705540,"EL PUENTE HS - BROOKLYN","250 Hooper Street"
1,1,0,"d192e6d5-30f4-ea11-b882-24ee9a37d45c","The Urban Assembly School for Collaborative Healthcare - K764 - K420 - 19K764 - 999 JAMAICA AVENUE","c692e6d5-30f4-ea11-b882-24ee9a37d45c",-73869305,40693002,"FRANKLIN K. LANE HS - K","999 JAMAICA AVENUE"
1,1,0,"882aa42b-33f4-ea11-b882-24ee9a37d45c","P186X Walter J. Damrosch School - X186 - X136 - 75X186 - 750 Jennings Street","892aa42b-33f4-ea11-b882-24ee9a37d45c",-73897797,40831388,"P.S. 186 (OLD J136) - BRONX","750 Jennings Street"
1,0,1,"b079df48-30f4-ea11-b882-24ee9a37d45c","Whitelaw Reid Academy of Arts and Business - K057 - K057 - 16K057 - 125 STUYVESANT AVENUE","ae79df48-30f4-ea11-b882-24ee9a37d45c",-73932254,40691467,"J.H.S. 57 - BROOKLYN","125 STUYVESANT AVENUE"
1,1,0,"969c11e8-30f4-ea11-b882-24ee9a37d45c","Park Slope Collegiate - K464 - K460 - 15K464 - 237 7 AVENUE","929c11e8-30f4-ea11-b882-24ee9a37d45c",-73978580,40669255,"John Jay Educational Campus","237 7 AVENUE"
1,0,1,"de9319d7-ebf6-ea11-b883-24ee9a37d459","The Richmond Pre-K Center - R066 - R090 - 31R066 - 1535 RICHMOND AVENUE","f18521d0-32f4-ea11-b882-24ee9a37d45c",-74159152,40610497,"3K CENTER @ 1535 RICHMOND AVENUE - STATEN ISLAND","1535 RICHMOND AVENUE"
2,2,0,"5a9f4974-31f4-ea11-b882-24ee9a37d45c","P.S. 152 Dyckman Valley - M152 - M152 - 06M152 - 93 NAGLE AVENUE","5b9f4974-31f4-ea11-b882-24ee9a37d45c",-73927578,40859804,"P.S. 152 - MANHATTAN","93 NAGLE AVENUE"
2,2,0,"c7ba3c50-33f4-ea11-b882-24ee9a37d45c","P.S. 279 Captain Manuel Rivera, Jr. - X279 - X279 - 10X279 - 2100 WALTON AVENUE","c8ba3c50-33f4-ea11-b882-24ee9a37d45c",-73904958,40854666,"P.S. 279 - BRONX","2100 WALTON AVENUE"
2,2,0,"99d810ab-31f4-ea11-b882-24ee9a37d45c","Chelsea Career and Technical Education High School - M615 - M615 - 02M615 - 131 AVENUE OF THE AMERICAS","9ad810ab-31f4-ea11-b882-24ee9a37d45c",-74005058,40724630,"CHELSEA VOC HS - MANHATTAN","131 AVENUE OF THE AMERICAS"
5,1,4,"c6bfa431-33f4-ea11-b882-24ee9a37d45c","P.S./M.S. 031 The William Lloyd Garrison - X031 - X151 - 07X031 - 250 EAST 156 STREET","c1bfa431-33f4-ea11-b882-24ee9a37d45c",-73921140,40822574,"I.S. 151 - BRONX","250 EAST 156 STREET"
2,2,0,"2dc73b4a-32f4-ea11-b882-24ee9a37d45c","I.S. 230 - Q230 - Q297 - 30Q230 - 33-55 74TH STREET","2ec73b4a-32f4-ea11-b882-24ee9a37d45c",-73892623,40753829,"I.S. 230 ANNEX - QUEENS","33-55 74TH STREET"
1,1,0,"8f977d2b-32f4-ea11-b882-24ee9a37d45c","P.S. 196 Grand Central Parkway - Q196 - Q196 - 28Q196 - 71-25 113 STREET","90977d2b-32f4-ea11-b882-24ee9a37d45c",-73837379,40722792,"P.S. 196 - QUEENS","71-25 113 STREET"
3,3,0,"858d8486-31f4-ea11-b882-24ee9a37d45c","P.S. 199 Jessie Isador Straus - M199 - M199 - 03M199 - 270 WEST 70 STREET","868d8486-31f4-ea11-b882-24ee9a37d45c",-73984423,40777603,"P.S. 199 - MANHATTAN","270 WEST 70 STREET"
4,3,1,"06b7c337-32f4-ea11-b882-24ee9a37d45c","J.H.S. 217 Robert A. Van Wyck - Q217 - Q217 - 28Q217 - 85-05 144 STREET","fcb6c337-32f4-ea11-b882-24ee9a37d45c",-73811461,40710384,"I.S. 217 - QUEENS","85-05 144 STREET"
3,3,0,"0918b7f4-32f4-ea11-b882-24ee9a37d45c","P.S. 030 Wilton - X030 - X030 - 07X030 - 510 EAST 141 STREET","0118b7f4-32f4-ea11-b882-24ee9a37d45c",-73917417,40809023,"P.S. 30 - BRONX","510 EAST 141 STREET"
1,1,0,"c0fc24e8-31f4-ea11-b882-24ee9a37d45c","I.S. 025 Adrien Block - Q025 - Q025 - 25Q025 - 34-65 192 STREET","befc24e8-31f4-ea11-b882-24ee9a37d45c",-73789365,40764884,"J.H.S. 25 - QUEENS","34-65 192 STREET"
1,0,1,"c7e0838c-31f4-ea11-b882-24ee9a37d45c","Battery Park City School - M276 - M276 - 02M276 - 55 BATTERY PLACE","c6e0838c-31f4-ea11-b882-24ee9a37d45c",-74017456,40706384,"P.S./I.S. 276 - MANHATTAN","55 BATTERY PLACE"
1,1,0,"16ba8b86-30f4-ea11-b882-24ee9a37d45c","P.S. 207 Elizabeth G. Leary - K207 - K207 - 22K207 - 4011 FILLMORE AVENUE","17ba8b86-30f4-ea11-b882-24ee9a37d45c",-73930485,40613981,"P.S. 207 - BROOKLYN","4011 FILLMORE AVENUE"
1,1,0,"5ca5db98-30f4-ea11-b882-24ee9a37d45c","P.S. 236 Mill Basin - K236 - K236 - 22K236 - 6302 AVENUE U","5ba5db98-30f4-ea11-b882-24ee9a37d45c",-73912005,40615494,"P.S. 236 - BROOKLYN","6302 AVENUE U"
5,5,0,"b572c880-32f4-ea11-b882-24ee9a37d45c","P.S. Q016 The Nancy DeBenedittis School - Q016 - Q721 - 24Q016 - 41-15 104 STREET","b672c880-32f4-ea11-b882-24ee9a37d45c",-73860547,40748996,"P.S. 16 (OLD Q721 SPED) - QUEENS","41-15 104 STREET"
3,3,0,"445bc58c-30f4-ea11-b882-24ee9a37d45c","P.S. 212 Lady Deborah Moody - K212 - K212 - 21K212 - 87 BAY 49 STREET","455bc58c-30f4-ea11-b882-24ee9a37d45c",-73985368,40587612,"P.S. 212 - BROOKLYN","87 BAY 49 STREET"
5,4,1,"20eabc42-30f4-ea11-b882-24ee9a37d45c","J.H.S. 050 John D. Wells - K050 - K050 - 14K050 - 183 SOUTH 3 STREET","1feabc42-30f4-ea11-b882-24ee9a37d45c",-73960137,40711915,"J.H.S. 50 - BROOKLYN","183 SOUTH 3 STREET"
1,0,1,"35a10a44-32f4-ea11-b882-24ee9a37d45c","The Randolph Holder School for Social Justice - Q253 - Q253 - 27Q253 - 1307 CENTRAL AVENUE","30a10a44-32f4-ea11-b882-24ee9a37d45c",-73748799,40607247,"P.S. 253 -QUEENS","1307 CENTRAL AVENUE"
1,1,0,"8007e99e-31f4-ea11-b882-24ee9a37d45c","High School for Law, Advocacy and Community Justice - M492 - M490 - 03M492 - 122 AMSTERDAM AVENUE","7c07e99e-31f4-ea11-b882-24ee9a37d45c",-73985608,40774891,"MARTIN LUTHER KING, JR. HS - M","122 AMSTERDAM AVENUE"
1,1,0,"7441e65b-31f4-ea11-b882-24ee9a37d45c","P.S. 076 A. Philip Randolph - M076 - M076 - 03M076 - 220 WEST 121 STREET","7241e65b-31f4-ea11-b882-24ee9a37d45c",-73951451,40806534,"P.S. 76 - MANHATTAN","220 WEST 121 STREET"
1,1,0,"35ebaa73-30f4-ea11-b882-24ee9a37d45c","P.S. 164 Caesar Rodney - K164 - K164 - 20K164 - 4211 14 AVENUE","36ebaa73-30f4-ea11-b882-24ee9a37d45c",-73985739,40637101,"P.S. 164 - BROOKLYN","4211 14 AVENUE"
2,1,1,"3d3cbf01-ebf6-ea11-b883-24ee9a37d459","John F. Kennedy Jr. School - Q721 - Q722 - 75Q721 - 57-12 94 STREET","b172c880-32f4-ea11-b882-24ee9a37d45c",-73867882,40735613,"JOHN F. KENNEDY JR. SCHOOL - QUEENS","57-12 94 STREET"
1,1,0,"2803cefa-32f4-ea11-b882-24ee9a37d45c","P.S. 046 Edgar Allan Poe - X046 - X046 - 10X046 - 2760 BRIGGS AVENUE","2703cefa-32f4-ea11-b882-24ee9a37d45c",-73890402,40867169,"P.S. 46 - BRONX","279 EAST 196 STREET"
1,0,1,"e621d292-30f4-ea11-b882-24ee9a37d45c","P.S. K225 - The Eileen E. Zaglin - K225 - K225 - 21K225 - 1075 OCEAN VIEW AVENUE","e521d292-30f4-ea11-b882-24ee9a37d45c",-73955856,40580260,"P.S. 225 - BROOKLYN","1075 OCEAN VIEW AVENUE"
1,1,0,"da9b4c1f-32f4-ea11-b882-24ee9a37d45c","P.S. 151 Mary D. Carter - Q151 - Q151 - 30Q151 - 50-05 31 AVENUE","db9b4c1f-32f4-ea11-b882-24ee9a37d45c",-73908146,40758027,"P.S. 151 - QUEENS","50-05 31 AVENUE"
1,1,0,"89476368-32f4-ea11-b882-24ee9a37d45c","District 25 PRE-K Center - Q409 - Q454 - 25Q409 - 123-07 22nd Avenue","8a476368-32f4-ea11-b882-24ee9a37d45c",-73844811,40780363,"PRE-K CENTER @22ND AVENUE - QUEENS","123-07 22nd Avenue"
2,2,0,"8801ce37-33f4-ea11-b882-24ee9a37d45c","P.S. 157 Grove Hill - X157 - X157 - 07X157 - 757 CAULDWELL AVENUE","8901ce37-33f4-ea11-b882-24ee9a37d45c",-73908965,40819419,"P.S. 157 - BRONX","757 CAULDWELL AVENUE"
1,0,1,"b479df48-30f4-ea11-b882-24ee9a37d45c","Success Academy Charter School - Bed-Stuy 2 - K125 - K059 - 84K125 - 211 THROOP AVENUE","b579df48-30f4-ea11-b882-24ee9a37d45c",-73943279,40697619,"P.S. 59 - BROOKLYN","211 THROOP AVENUE"
1,1,0,"e7201dab-30f4-ea11-b882-24ee9a37d45c","J.H.S. 278 Marine Park - K278 - K278 - 22K278 - 1925 STUART STREET","e8201dab-30f4-ea11-b882-24ee9a37d45c",-73938721,40606745,"I.S. 278 - BROOKLYN","1925 STUART STREET"
1,1,0,"8783ff9e-30f4-ea11-b882-24ee9a37d45c","Success Academy Charter School - Crown Heights - K741 - K246 - 84K741 - 72 VERONICA PLACE","8483ff9e-30f4-ea11-b882-24ee9a37d45c",-73953480,40648352,"I.S. 246 - BROOKLYN","72 VERONICA PLACE"
1,1,0,"b7ab074a-33f4-ea11-b882-24ee9a37d45c","P.S./M.S. 194 - X194 - X194 - 11X194 - 2365 WATERBURY AVENUE","b6ab074a-33f4-ea11-b882-24ee9a37d45c",-73846594,40835410,"P.S./I.S. 194 - BRONX","2365 WATERBURY AVENUE"
5,5,0,"782f77fa-31f4-ea11-b882-24ee9a37d45c","P.S. 069 Jackson Heights - Q069 - Q069 - 30Q069 - 77-02 37 AVENUE","682f77fa-31f4-ea11-b882-24ee9a37d45c",-73888457,40748804,"P.S. 69 - QUEENS","77-02 37 AVENUE"
3,2,1,"fdb6c337-32f4-ea11-b882-24ee9a37d45c","P.S. 214 Cadwallader Colden - Q214 - Q214 - 25Q214 - 31-15 140 STREET","feb6c337-32f4-ea11-b882-24ee9a37d45c",-73827606,40770215,"P.S. 214 - QUEENS","31-15 140 STREET"
2,2,0,"92283fb1-30f4-ea11-b882-24ee9a37d45c","Success Academy Charter School - Cobble Hill - K129 - K293 - 84K129 - 284 Baltic Street","91283fb1-30f4-ea11-b882-24ee9a37d45c",-73993293,40685006,"J.H.S. 293 - BROOKLYN","284 Baltic Street"
1,0,1,"90dd3c21-e740-ec11-b8c3-24ee9a37d45c","Home Instruction - M501 - Q878 - 75M501 - 63-25 69 STREET","cbedf392-32f4-ea11-b882-24ee9a37d45c",-73887005,40715319,"P.S. 128 ANNEX - QUEENS","63-25 69 STREET"
2,2,0,"5f698396-6b01-ed11-b8db-24ee9a37d45c","The Mott Hall School - M223 - M164 - 06M223 - 401 WEST 164 STREET","2a005d7a-31f4-ea11-b882-24ee9a37d45c",-73937263,40836982,"I.S. 164 - MANHATTAN","401 WEST 164 STREET"
1,1,0,"210410ca-32f4-ea11-b882-24ee9a37d45c","P.S. 046 Albert V. Maniscalco - R046 - R046 - 31R046 - 41 REID AVENUE","220410ca-32f4-ea11-b882-24ee9a37d45c",-74080829,40594455,"P.S. 46 - STATEN ISLAND","41 REID AVENUE"
1,1,0,"179ebaee-32f4-ea11-b882-24ee9a37d45c","Milton Fein School - X007 - X007 - 10X007 - 3201 KINGSBRIDGE AVENUE","189ebaee-32f4-ea11-b882-24ee9a37d45c",-73905697,40881562,"P.S. 7 - BRONX","3201 KINGSBRIDGE AVENUE"
1,1,0,"66b50aa5-30f4-ea11-b882-24ee9a37d45c","P.S. 261 Zipporiah Mills - K261 - K261 - 15K261 - 314 PACIFIC STREET","5fb50aa5-30f4-ea11-b882-24ee9a37d45c",-73988667,40687218,"P.S. 261 - BROOKLYN","314 PACIFIC STREET"
1,0,1,"94dd3c21-e740-ec11-b8c3-24ee9a37d45c","Home Instruction - M501 - K776 - 75M501 - 1087 OCEAN AVENUE","582f7d06-31f4-ea11-b882-24ee9a37d45c",-73957794,40636106,"P.S. 152 ANNEX- BROOKLYN","1087 OCEAN AVENUE"
1,0,1,"5c042f6f-ebf6-ea11-b883-24ee9a37d459","Home Instruction - M501 - M641 - 75M501 - 250 West Houston Street","4d0c1bb1-31f4-ea11-b882-24ee9a37d45c",-74006155,40729052,"CITY-AS-SCHOOL(OLD 95) - MANHATTAN","16 Clarkson Street"
1,1,0,"81886843-31f4-ea11-b882-24ee9a37d45c","P.S. 003 Charrette School - M003 - M003 - 02M003 - 490 HUDSON STREET","82886843-31f4-ea11-b882-24ee9a37d45c",-74005949,40732603,"P.S. 3 - MANHATTAN","490 HUDSON STREET"
1,1,0,"43e4d766-4afb-ea11-b883-24ee9a37d459","Vanderbilt YMCA - MBMK - MBMK -  - 224 East 47 Street","44e4d766-4afb-ea11-b883-24ee9a37d459",-73971017,40753222,"Vanderbilt YMCA","224 East 47 Street"
5,0,5,"0b8bc007-ebf6-ea11-b883-24ee9a37d459","Home Instruction - Bronx - X999 - X953 - 75X502 - 3450 EAST TREMONT AVENUE","fa27b299-33f4-ea11-b882-24ee9a37d45c",-73827642,40831829,"AUXILIARY SERVICES HS - BRONX","3450 EAST TREMONT AVENUE"
1,1,0,"c8bfa431-33f4-ea11-b882-24ee9a37d45c","KIPP Academy Charter School - X704 - X151 - 84X704 - 250 EAST 156 STREET","c1bfa431-33f4-ea11-b882-24ee9a37d45c",-73921140,40822574,"I.S. 151 - BRONX","250 EAST 156 STREET"
1,1,0,"dcba3c50-33f4-ea11-b882-24ee9a37d45c","The STEAM Bridge School - X481 - X311 - 11X481 - 1684 WHITE PLAINS ROAD","daba3c50-33f4-ea11-b882-24ee9a37d45c",-73865498,40843531,"P.S. 311 - BRONX","1684 WHITE PLAINS ROAD"
1,0,1,"6b507380-31f4-ea11-b882-24ee9a37d45c","P.S. 192 Jacob H. Schiff - M192 - M192 - 06M192 - 500 WEST 138 STREET","64507380-31f4-ea11-b882-24ee9a37d45c",-73952023,40820510,"P.S. 192 - MANHATTAN","500 WEST 138 STREET"
1,1,0,"f0883319-32f4-ea11-b882-24ee9a37d45c","P.S. 148 Queens - Q148 - Q148 - 30Q148 - 89-02 32 AVENUE","ef883319-32f4-ea11-b882-24ee9a37d45c",-73878638,40757629,"P.S. 148 - QUEENS","89-02 32 AVENUE"
1,1,0,"71dfafe6-52e6-eb11-b8b1-24ee9a37d45c","New Visions Charter High School for the Humanities II - X208 - X650 - 84X208 - 900 TINTON AVENUE","91eb0e7b-33f4-ea11-b882-24ee9a37d45c",-73902892,40821723,"JANE ADDAMS HS - X","900 TINTON AVENUE"
4,4,0,"39474313-33f4-ea11-b882-24ee9a37d45c","P.S. 095 Sheila Mencher - X095 - X095 - 10X095 - 3961 HILLMAN AVENUE","34474313-33f4-ea11-b882-24ee9a37d45c",-73891664,40883049,"P.S. 95 - BRONX","3961 HILLMAN AVENUE"
1,0,1,"53275a30-4afb-ea11-b883-24ee9a37d459","TOMPKINS CHILDREN CENTER - KBLT - KBLT -  - 730 PARK AVENUE","54275a30-4afb-ea11-b883-24ee9a37d459",-73945148,40696958,"TOMPKINS CHILDREN CENTER","730 PARK AVENUE"
2,1,1,"83e03d56-33f4-ea11-b882-24ee9a37d45c","Morris Academy for Collaborative Studies - X297 - X400 - 09X297 - 1110 BOSTON ROAD","82e03d56-33f4-ea11-b882-24ee9a37d45c",-73903920,40827455,"MORRIS HS - X","1110 BOSTON ROAD"
2,0,2,"80c280bd-31f4-ea11-b882-24ee9a37d45c","Baruch College Campus High School - M411 - M874 - 02M411 - 55 EAST 25 STREET","81c280bd-31f4-ea11-b882-24ee9a37d45c",-73985723,40741888,"BARUCH COLLEGE CAMPUS HS - M","55 EAST 25 STREET"
1,1,0,"202ed53d-33f4-ea11-b882-24ee9a37d45c","P.S. 170 - X170 - X170 - 09X170 - 1598 TOWNSEND AVENUE","212ed53d-33f4-ea11-b882-24ee9a37d45c",-73913253,40844367,"P.S. 170 (ECC) - BRONX","1598 TOWNSEND AVENUE"
1,1,0,"6ee5bc26-6c0c-ed11-b091-088e901ef405","Gotham Tech High School - Q417 - Q450 - 30Q417 - 28-01 41 AVENUE","dab66262-32f4-ea11-b882-24ee9a37d45c",-73936592,40751838,"NEWCOMERS HIGH SCHOOL (OLD LIC)-Q","28-01 41 AVENUE"
1,1,0,"1e06003e-32f4-ea11-b882-24ee9a37d45c","East-West School of International Studies - Q281 - Q237 - 25Q281 - 46-21 COLDEN STREET","1b06003e-32f4-ea11-b882-24ee9a37d45c",-73821402,40749430,"J.H.S. 237 - QUEENS","46-21 COLDEN STREET"
1,1,0,"f08a0044-33f4-ea11-b882-24ee9a37d45c","P.S. 182 - X182 - X182 - 08X182 - 601 STICKBALL BOULEVARD","f18a0044-33f4-ea11-b882-24ee9a37d45c",-73856976,40818925,"P.S. 182 - BRONX","601 STICKBALL BOULEVARD"
1,0,1,"2b474313-33f4-ea11-b882-24ee9a37d45c","The Vida Bogart School for All Children - X352 - X092 - 75X352 - 700 EAST 179 STREET","27474313-33f4-ea11-b882-24ee9a37d45c",-73889602,40846205,"P.S. 92 - BRONX","700 EAST 179 STREET"
2,2,0,"22e2abc9-30f4-ea11-b882-24ee9a37d45c","P.S. /I.S. 384 Frances E. Carter - K384 - K384 - 32K384 - 242 COOPER STREET","21e2abc9-30f4-ea11-b882-24ee9a37d45c",-73904695,40689883,"P.S. 384 - BROOKLYN","242 COOPER STREET"
2,2,0,"84476368-32f4-ea11-b882-24ee9a37d45c","Long Island City High School - Q450 - Q452 - 30Q450 - 14-30 BROADWAY","81476368-32f4-ea11-b882-24ee9a37d45c",-73933907,40765881,"LONG ISLAND CITY HS(NEW)-Q","14-30 BROADWAY"
2,0,2,"740067b2-ebf6-ea11-b883-24ee9a37d459","Curious Young Learners Pre-K Center - Q336 - Q474 - 27Q336 - 101-20 105 STREET","2e02926e-32f4-ea11-b882-24ee9a37d45c",-73838321,40685662,"3K CENTER @ 104-06 101 AVENUE - QUEENS","101-20 105 STREET"
1,0,1,"c50347b2-33f4-ea11-b882-24ee9a37d45c","Hospital Schools - Bronx - XHOS - XAQN - 75X402 - 1400 PELHAM PARKWAY SOUTH","c30347b2-33f4-ea11-b882-24ee9a37d45c",-73846713,40854346,"JACOBI MEDICAL CENTER","1400 PELHAM PARKWAY SOUTH"
1,0,1,"45416e00-31f4-ea11-b882-24ee9a37d45c","District 20 Pre-K Center - K768 - K678 - 20K768 - 1423 62ND STREET","46416e00-31f4-ea11-b882-24ee9a37d45c",-73996423,40625978,"PRE-K CENTER @62ND STREET - BROOKLYN","1423 62ND STREET"
3,2,1,"45474313-33f4-ea11-b882-24ee9a37d45c","Explorations Academy H.S. - X251 - X098 - 12X251 - 1619 BOSTON ROAD","3c474313-33f4-ea11-b882-24ee9a37d45c",-73890591,40836245,"I.S. 98 - BRONX","1619 BOSTON ROAD"
1,0,1,"6c41e65b-31f4-ea11-b882-24ee9a37d45c","The Lexington Academy - M072 - M072 - 04M072 - 131 EAST 104 STREET","6d41e65b-31f4-ea11-b882-24ee9a37d45c",-73947450,40791444,"P.S. 72 - MANHATTAN","131 EAST 104 STREET"
1,1,0,"a40e6e25-32f4-ea11-b882-24ee9a37d45c","Scholars' Academy - Q323 - Q180 - 27Q323 - 320 BEACH 104TH STREET","a50e6e25-32f4-ea11-b882-24ee9a37d45c",-73825162,40584543,"I.S. 323 (OLD IS 180) - QUEENS","320 BEACH 104TH STREET"
3,2,1,"11e85c61-30f4-ea11-b882-24ee9a37d45c","P.S. 108 Sal Abbracciamento - K108 - K108 - 19K108 - 200 LINWOOD STREET","12e85c61-30f4-ea11-b882-24ee9a37d45c",-73884348,40681295,"P.S. 108 - BROOKLYN","200 LINWOOD STREET"
2,2,0,"68ffcc6e-33f4-ea11-b882-24ee9a37d45c","Millennium Art Academy - X312 - X450 - 08X312 - 1980 LAFAYETTE AVENUE","62ffcc6e-33f4-ea11-b882-24ee9a37d45c",-73855930,40821218,"Adlai E. Stevenson Educational Campus","1980 LAFAYETTE AVENUE"
2,2,0,"3268ee1e-31f4-ea11-b882-24ee9a37d45c","School of Math, Science, and Healthy Living - K971 - K971 - 20K971 - 6214 4TH AVENUE","3368ee1e-31f4-ea11-b882-24ee9a37d45c",-74020343,40639518,"P.S. 971 - BROOKLYN","6214 4TH AVENUE"
1,1,0,"0dcf496e-31f4-ea11-b882-24ee9a37d45c","Emma Lazarus High School - M394 - M131 - 02M394 - 100 HESTER STREET","03cf496e-31f4-ea11-b882-24ee9a37d45c",-73993607,40716231,"I.S. 131 - MANHATTAN","100 HESTER STREET"
1,1,0,"c82ff20c-32f4-ea11-b882-24ee9a37d45c","P.S./M.S. 114 Belle Harbor - Q114 - Q114 - 27Q114 - 134-01 CRONSTON AVENUE","c12ff20c-32f4-ea11-b882-24ee9a37d45c",-73854364,40577552,"P.S. 114 - QUEENS","134-01 CRONSTON AVENUE"
1,0,1,"520b210d-33f4-ea11-b882-24ee9a37d45c","P.S. 085 Great Expectations - X085 - X085 - 10X085 - 2400 MARION AVENUE","530b210d-33f4-ea11-b882-24ee9a37d45c",-73894682,40858689,"P.S. 85 - BRONX","2400 MARION AVENUE"
1,0,1,"6429a44a-ebf6-ea11-b883-24ee9a37d459","Passages Academy - X695 - K993 - 79X695 - 17 BRISTOL STREET","b0120b25-31f4-ea11-b882-24ee9a37d45c",-73912398,40670717,"PASSAGES ACADEMY(CROSSROADS) - K","17 BRISTOL STREET"
1,1,0,"e89b4c1f-32f4-ea11-b882-24ee9a37d45c","P.S. 155 - Q155 - Q155 - 27Q155 - 130-02 115 AVENUE","e99b4c1f-32f4-ea11-b882-24ee9a37d45c",-73810067,40679105,"P.S. 155 - QUEENS","130-02 115 AVENUE"
1,1,0,"4d3cbf01-ebf6-ea11-b883-24ee9a37d459","P.S. R373 - R373 - R040 - 75R373 - 91 HENDERSON AVENUE","97a9d9c3-32f4-ea11-b882-24ee9a37d45c",-74095454,40641180,"P.S. 373 (OLD P40) - STATEN ISLAND","91 HENDERSON AVENUE"
2,1,1,"9353dd74-33f4-ea11-b882-24ee9a37d45c","Mott Haven Village Preparatory High School - X473 - X470 - 07X473 - 701 ST. ANNS AVENUE","9253dd74-33f4-ea11-b882-24ee9a37d45c",-73911633,40818041,"SOUTH BRONX EDUCATIONAL CAMPUS (OLD 38) - X","701 ST. ANNS AVENUE"
1,1,0,"fbf22ce2-31f4-ea11-b882-24ee9a37d45c","I.S. 010 Horace Greeley - Q010 - Q010 - 30Q010 - 45-11 31st Ave","fcf22ce2-31f4-ea11-b882-24ee9a37d45c",-73911962,40760122,"I.S. 10 - QUEENS","45-11 31st Ave"
3,3,0,"6636d900-33f4-ea11-b882-24ee9a37d45c","P.S./I.S. 54 - X054 - X054 - 10X054 - 2703 WEBSTER AVENUE","6736d900-33f4-ea11-b882-24ee9a37d45c",-73887940,40864872,"P.S. 54 - BRONX","2703 WEBSTER AVENUE"
1,1,0,"33474313-33f4-ea11-b882-24ee9a37d45c","Ampark Neighborhood - X344 - X095 - 10X344 - 3961 HILLMAN AVENUE","34474313-33f4-ea11-b882-24ee9a37d45c",-73891664,40883049,"P.S. 95 - BRONX","3961 HILLMAN AVENUE"
1,1,0,"9f6b4ae9-ea40-ec11-b8c3-24ee9a37d45c","KIPP Bronx II Charter School - X616 - XCHO - 84X616 - 501 Gerard Avenue","a06b4ae9-ea40-ec11-b8c3-24ee9a37d45c",-73929502,40818347,"501 Gerard Avenue","501 Gerard Avenue"
2,2,0,"c9315367-30f4-ea11-b882-24ee9a37d45c","Northside Charter High School - K693 - K126 - 84K693 - 424 LEONARD STREET","c3315367-30f4-ea11-b882-24ee9a37d45c",-73947932,40719818,"J.H.S. 126 - BROOKLYN","424 LEONARD STREET"
1,1,0,"bc315367-30f4-ea11-b882-24ee9a37d45c","P.S. 121 Nelson A. Rockefeller - K121 - K121 - 21K121 - 5301 20 AVENUE","bd315367-30f4-ea11-b882-24ee9a37d45c",-73978472,40622671,"P.S. 121 - BROOKLYN","5301 20 AVENUE"
1,0,1,"d8e13320-ebf6-ea11-b883-24ee9a37d459","P.S. K077 - K077 - K164 - 75K077 - 4211 14 AVENUE","36ebaa73-30f4-ea11-b882-24ee9a37d45c",-73985739,40637101,"P.S. 164 - BROOKLYN","4211 14 AVENUE"
1,0,1,"9f476368-32f4-ea11-b882-24ee9a37d45c","Flushing High School - Q460 - Q460 - 25Q460 - 35-01 UNION STREET","97476368-32f4-ea11-b882-24ee9a37d45c",-73826811,40764892,"FLUSHING HS - Q","35-01 UNION STREET"
4,4,0,"2d0d6d19-33f4-ea11-b882-24ee9a37d45c","Bronx Little School - X691 - X102 - 12X691 - 1827 ARCHER STREET","290d6d19-33f4-ea11-b882-24ee9a37d45c",-73866038,40838151,"P.S. 102 - BRONX","1827 ARCHER STREET"
1,1,0,"c70d3c5b-30f4-ea11-b882-24ee9a37d45c","Success Academy Charter School - Bensonhurst - New York 3 - K772 - K096 - 84K772 - 99 AVENUE P","c10d3c5b-30f4-ea11-b882-24ee9a37d45c",-73984985,40608135,"I.S. 96 - BROOKLYN","99 AVENUE P"
1,0,1,"4b6e70b7-31f4-ea11-b882-24ee9a37d45c","High School for Mathematics, Science and Engineering at City College - M692 - M812 - 05M692 - 240 CONVENT AVE","4c6e70b7-31f4-ea11-b882-24ee9a37d45c",-73950354,40820208,"HS FOR MATH, SCI & ENGINEERING-M","240 CONVENT AVE"
1,1,0,"7707e99e-31f4-ea11-b882-24ee9a37d45c","P.S. 059 Beekman Hill International - M059 - M488 - 02M059 - 231-249 EAST 56 STREET","6d07e99e-31f4-ea11-b882-24ee9a37d45c",-73967204,40759248,"MIDTOWN EAST CAMPUS - MANHATTAN","231-249 EAST 56 STREET"
1,1,0,"96d810ab-31f4-ea11-b882-24ee9a37d45c","The High School of Fashion Industries - M600 - M600 - 02M600 - 225 WEST 24 STREET","94d810ab-31f4-ea11-b882-24ee9a37d45c",-73996354,40745677,"FASHION INDUSTRIES VOC HS - M","225 WEST 24 STREET"
1,1,0,"bc689025-33f4-ea11-b882-24ee9a37d45c","Linden Tree Elementary School - X567 - X127 - 11X567 - 1560 PURDY STREET","b9689025-33f4-ea11-b882-24ee9a37d45c",-73853203,40838759,"I.S. 127 - BRONX","1560 PURDY STREET"
1,1,0,"3e02fdd0-ebf6-ea11-b883-24ee9a37d459","The Michael J. Petrides School - R080 - R010 - 31R080 - 715 OCEAN TERRACE","4bfdc1bd-32f4-ea11-b882-24ee9a37d45c",-74105883,40607637,"P.S. 80 (PETRIDES COMPLEX) AF - STATEN ISLAND","715 OCEAN TERRACE"
1,0,1,"ad8fd48d-ebf6-ea11-b883-24ee9a37d459","Robert E. Peary School - Q075 - Q048 - 75Q075 - 155-02 108 AVENUE","598946f4-31f4-ea11-b882-24ee9a37d45c",-73796358,40693736,"P.S. 48 - QUEENS","155-02 108 AVENUE"
2,0,2,"9f32c3fb-eaf6-ea11-b883-24ee9a37d459","Robert E. Peary School - Q075 - Q075 - 75Q075 - 16-66 HANCOCK STREET","cae8ce00-32f4-ea11-b882-24ee9a37d45c",-73904888,40698699,"P.S. 75 (R PERRY SCHOOL)-QUEENS","16-66 HANCOCK STREET"
2,0,2,"2730f69f-ebf6-ea11-b883-24ee9a37d459","Robert E. Peary School - Q075 - Q239 - 75Q075 - 17-15 WEIRFIELD STREET","2606003e-32f4-ea11-b882-24ee9a37d45c",-73903838,40699431,"P.S. 239 - QUEENS","17-15 WEIRFIELD STREET"
1,1,0,"4e9d7c62-33f4-ea11-b882-24ee9a37d45c","Pelham Preparatory Academy - X542 - X415 - 11X542 - 925 ASTOR AVENUE","439d7c62-33f4-ea11-b882-24ee9a37d45c",-73860729,40860443,"CHRISTOPHER COLUMBUS HS - X","925 ASTOR AVENUE"
1,1,0,"64bc9674-32f4-ea11-b882-24ee9a37d45c","Richmond Hill High School - Q475 - Q475 - 27Q475 - 89-30 114 Street","3002926e-32f4-ea11-b882-24ee9a37d45c",-73833815,40695171,"RICHMOND HILL HS - Q","89-30 114 Street"
2,0,2,"5e4accc4-ebf6-ea11-b883-24ee9a37d459","Robert E. Peary School - Q075 - Q876 - 75Q075 - 869 Cypress Avenue","c7edf392-32f4-ea11-b882-24ee9a37d45c",-73904999,40699682,"P.S. 88 ANNEX - QUEENS","869 Cypress Avenue"
1,1,0,"37a6ba98-31f4-ea11-b882-24ee9a37d45c","Innovation Diploma Plus - M404 - M470 - 03M404 - 145 WEST 84 STREET","33a6ba98-31f4-ea11-b882-24ee9a37d45c",-73974483,40786134,"LOUIS D. BRANDEIS HS - MANHATTAN","145 WEST 84 STREET"
3,1,2,"8ea6bd0b-e8fe-eb11-b8b2-24ee9a37d45c","JULIA'S GROUP FAMILY DAY CARE - 2 - KDYX - KDSX -  - 69 Norwood Avenue","8fa6bd0b-e8fe-eb11-b8b2-24ee9a37d45c",-73879806,40684450,"69 NORWOOD AVENUE","69 Norwood Avenue"
2,2,0,"e6b98b86-30f4-ea11-b882-24ee9a37d45c","P.S. 193 Gil Hodges - K193 - K193 - 22K193 - 2515 AVENUE L","e5b98b86-30f4-ea11-b882-24ee9a37d45c",-73950321,40622080,"P.S. 193 - BROOKLYN","2515 AVENUE L"
8,8,0,"635b4cd6-32f4-ea11-b882-24ee9a37d45c","Tottenville High School - R455 - R455 - 31R455 - 100 LUTEN AVENUE","605b4cd6-32f4-ea11-b882-24ee9a37d45c",-74193431,40528152,"TOTTENVILLE HS - S. I.","100 LUTEN AVENUE"
1,1,0,"1202926e-32f4-ea11-b882-24ee9a37d45c","Queens High School for Information, Research, and Technology - Q302 - Q465 - 27Q302 - 8-21 BAY 25 STREET","0b02926e-32f4-ea11-b882-24ee9a37d45c",-73763995,40601537,"FAR ROCKAWAY HS - Q","8-21 BAY 25 STREET"
1,1,0,"c52ff20c-32f4-ea11-b882-24ee9a37d45c","P.S./I.S. 113 Anthony J. Pranzo - Q113 - Q113 - 24Q113 - 78-23 87TH STREET","c62ff20c-32f4-ea11-b882-24ee9a37d45c",-73861493,40705476,"P.S./I.S. 113 - QUEENS","78-23 87TH STREET"
1,0,1,"2ca6ba98-31f4-ea11-b882-24ee9a37d45c","High School for Law and Public Service - M467 - M465 - 06M467 - 549 AUDUBON AVENUE","25a6ba98-31f4-ea11-b882-24ee9a37d45c",-73926060,40856532,"G. WASHINGTON HS EDUC. CAMPUS - M","549 AUDUBON AVENUE"
1,0,1,"c7d27c6d-30f4-ea11-b882-24ee9a37d45c","Success Academy Charter School - Prospect Heights - K756 - K138 - 84K756 - 760 PROSPECT PLACE","e4315367-30f4-ea11-b882-24ee9a37d45c",-73951559,40673943,"P.S. 138 - BROOKLYN","760 PROSPECT PLACE"
1,0,1,"60fdc1bd-32f4-ea11-b882-24ee9a37d45c","P.S. 019 The Curtis School - R019 - R019 - 31R019 - 780 Post Avenue","61fdc1bd-32f4-ea11-b882-24ee9a37d45c",-74126851,40630563,"P.S. 19 - STATEN ISLAND","780 Post Avenue"
1,0,1,"e5ce496e-31f4-ea11-b882-24ee9a37d45c","P.S. 123 Mahalia Jackson - M123 - M123 - 05M123 - 301 WEST 140 STREET","e3ce496e-31f4-ea11-b882-24ee9a37d45c",-73944551,40820216,"P.S. 123 - MANHATTAN","301 WEST 140 STREET"
2,2,0,"1a68ee1e-31f4-ea11-b882-24ee9a37d45c","Benjamin Banneker Academy - K670 - K914 - 13K670 - 71-77 Clinton Avenue","1b68ee1e-31f4-ea11-b882-24ee9a37d45c",-73968759,40695389,"BENJAMIN BANNEKER ACADEMY-BROOKLYN","71-77 Clinton Avenue"
1,0,1,"b8315367-30f4-ea11-b882-24ee9a37d45c","P.S. 368 - K368 - K120 - 75K368 - 18 Beaver Street","b2315367-30f4-ea11-b882-24ee9a37d45c",-73937888,40700819,"P.S. 120 - BROOKLYN","18 Beaver Street"
1,1,0,"2bb4977a-32f4-ea11-b882-24ee9a37d45c","Queens High School of Teaching, Liberal Arts and the Sciences - Q566 - Q566 - 26Q566 - 74-20 COMMONWEALTH BLVD","27b4977a-32f4-ea11-b882-24ee9a37d45c",-73728834,40744197,"QNS HS OF TEACH., LIB. ARTS&SCI-Q","74-20 COMMONWEALTH BLVD"
1,0,1,"6ee03d56-33f4-ea11-b882-24ee9a37d45c","Academy for Scholarship and Entrepreneurship: A College Board School - X270 - X362 - 11X270 - 921 EAST 228TH STREET","6ce03d56-33f4-ea11-b882-24ee9a37d45c",-73852714,40888242,"I.S./H.S. 362 - BRONX","921 EAST 228TH STREET"
1,1,0,"568946f4-31f4-ea11-b882-24ee9a37d45c","P.S. 043 - Q043 - Q043 - 27Q043 - 160 BEACH 29 STREET","ee8442ee-31f4-ea11-b882-24ee9a37d45c",-73761086,40593480,"P.S. 43 - QUEENS","160 BEACH 29 STREET"
1,1,0,"1fa198c3-30f4-ea11-b882-24ee9a37d45c","Sunset Park Avenues Elementary School - K516 - K333 - 15K516 - 4222 4th Avenue","20a198c3-30f4-ea11-b882-24ee9a37d45c",-74008106,40650793,"P.S. 516 SUNSET PARK AVENUES ELEMENTARY SCHOOL - B","4222 4th Avenue"
1,1,0,"17af0313-32f4-ea11-b882-24ee9a37d45c","P.S. 134 Hollis - Q134 - Q134 - 29Q134 - 203-02 109 Avenue","10af0313-32f4-ea11-b882-24ee9a37d45c",-73754747,40707535,"P.S. 134 - QUEENS","203-02 109 Avenue"
1,1,0,"07f32ce2-31f4-ea11-b882-24ee9a37d45c","P.S. 014 Fairview - Q014 - Q014 - 24Q014 - 107-01 OTIS AVENUE","faf22ce2-31f4-ea11-b882-24ee9a37d45c",-73854570,40741020,"P.S. 14 - QUEENS","107-01 OTIS AVENUE"
3,3,0,"a7886843-31f4-ea11-b882-24ee9a37d45c","P.S. 015 Roberto Clemente - M015 - M015 - 01M015 - 333 EAST 4 STREET","a5886843-31f4-ea11-b882-24ee9a37d45c",-73978747,40722075,"P.S. 15 - MANHATTAN","333 EAST 4 STREET"
