"TotalCases","StudentCases","EmployeeCases","nycsr_locationsiteid","nycsr_sitename","nycsr_building.nycsr_buildingid","nycsr_building.nycsr_longitude","nycsr_building.nycsr_latitude","nycsr_building.nycsr_buildingname","nycsr_building.nycsr_address"
3,3,0,"d1d27c6d-30f4-ea11-b882-24ee9a37d45c","The Brooklyn New School, P.S. 146 - K146 - K142 - 15K146 - 610 HENRY STREET","cfd27c6d-30f4-ea11-b882-24ee9a37d45c",-74002022,40679462,"J.H.S. 142 - BROOKLYN","610 HENRY STREET"
2,1,1,"c837fba4-31f4-ea11-b882-24ee9a37d45c","Park East High School - M495 - M495 - 04M495 - 230 EAST 105 STREET","c737fba4-31f4-ea11-b882-24ee9a37d45c",-73944092,40790191,"PARK EAST HS - MANHATTAN","230 EAST 105 STREET"
2,0,2,"0db7c337-32f4-ea11-b882-24ee9a37d45c","P.S. 220 Edward Mandel - Q220 - Q220 - 28Q220 - 62-10 108 STREET","0eb7c337-32f4-ea11-b882-24ee9a37d45c",-73852621,40736314,"P.S. 220 - QUEENS","62-10 108 STREET"
1,1,0,"cdfab455-31f4-ea11-b882-24ee9a37d45c","Neighborhood School - M363 - M063 - 01M363 - 121 EAST  3 STREET","cefab455-31f4-ea11-b882-24ee9a37d45c",-73986214,40724440,"P.S. 63 - MANHATTAN","121 EAST  3 STREET"
5,0,5,"68f4a0ef-eaf6-ea11-b883-24ee9a37d459","P.S. K811 Connie Lekas School - K811 - K286 - 75K811 - 2525 HARING STREET","6e283fb1-30f4-ea11-b882-24ee9a37d45c",-73938610,40591132,"P.S. 811 (OLD P286) - BROOKLYN","2525 HARING STREET"
4,3,1,"04e2abc9-30f4-ea11-b882-24ee9a37d45c","I.S. 364 Gateway - K364 - K364 - 19K364 - 1426 FREEPORT LOOP","05e2abc9-30f4-ea11-b882-24ee9a37d45c",-73881115,40646211,"I.S. 364 - BROOKLYN","1426 FREEPORT LOOP"
10,10,0,"8f0e6e25-32f4-ea11-b882-24ee9a37d45c","P.S. 173 Fresh Meadows - Q173 - Q173 - 26Q173 - 174-10 67 AVENUE","900e6e25-32f4-ea11-b882-24ee9a37d45c",-73795651,40734097,"P.S. 173 - QUEENS","174-10 67 AVENUE"
2,1,1,"983c646f-e21e-eb11-b885-24ee9a37d45c","The David Marquis School of the Arts - R037 - R089 - 75R037 - 15a Fairfield Street","993c646f-e21e-eb11-b885-24ee9a37d45c",-74151375,40564093,"D75 REPLACEMENT @ 15 FAIRFIELD STREET - S.I.","15a Fairfield Street"
1,0,1,"167eed06-32f4-ea11-b882-24ee9a37d45c","P.S. 088 Seneca - Q088 - Q088 - 24Q088 - 60-85 CATALPA AVENUE","177eed06-32f4-ea11-b882-24ee9a37d45c",-73896437,40704105,"P.S. 88 - QUEENS","60-85 CATALPA AVENUE"
1,1,0,"7e5e6435-25e6-eb11-b8b1-24ee9a37d45c","Achievement First Aspire Charter School - K680 - KAIO - 84K680 - 600 CENTRAL AVENUE","7f5e6435-25e6-eb11-b8b1-24ee9a37d45c",-73909305,40688641,"PILGRIM CHRISTIAN ACADEMY","600 CENTRAL AVENUE"
2,1,1,"00af1f69-ebf6-ea11-b883-24ee9a37d459","Manhattan School for Career Development - M751 - M323 - 75M751 - 75 MORTON STREET","d8e0838c-31f4-ea11-b882-24ee9a37d45c",-74007192,40731006,"75 Morton Campus","75 MORTON STREET"
3,1,2,"8801ce37-33f4-ea11-b882-24ee9a37d45c","P.S. 157 Grove Hill - X157 - X157 - 07X157 - 757 CAULDWELL AVENUE","8901ce37-33f4-ea11-b882-24ee9a37d45c",-73908965,40819419,"P.S. 157 - BRONX","757 CAULDWELL AVENUE"
3,1,2,"973aa668-33f4-ea11-b882-24ee9a37d45c","Bronx Academy of Health Careers - X290 - X425 - 11X290 - 800 EAST GUN HILL ROAD","699d7c62-33f4-ea11-b882-24ee9a37d45c",-73861649,40875172,"EVANDER CHILDS HS - X","800 EAST GUN HILL ROAD"
3,1,2,"3a0410ca-32f4-ea11-b882-24ee9a37d45c","P.S. 055 Henry M. Boehm - R055 - R055 - 31R055 - 54 OSBORNE STREET","3b0410ca-32f4-ea11-b882-24ee9a37d45c",-74163037,40536625,"P.S. 55 - STATEN ISLAND","54 OSBORNE STREET"
4,1,3,"60b50aa5-30f4-ea11-b882-24ee9a37d45c","J.H.S. 259 William McKinley - K259 - K259 - 20K259 - 7305 Ft Hamilton Parkway","61b50aa5-30f4-ea11-b882-24ee9a37d45c",-74014633,40626089,"I.S. 259 - BROOKLYN","7305 Ft Hamilton Parkway"
5,3,2,"538dbfcf-30f4-ea11-b882-24ee9a37d45c","Abraham Lincoln High School - K410 - K410 - 21K410 - 2800 OCEAN PARKWAY","518dbfcf-30f4-ea11-b882-24ee9a37d45c",-73968733,40582627,"ABRAHAM LINCOLN HS - K","2800 OCEAN PARKWAY"
3,2,1,"8c886843-31f4-ea11-b882-24ee9a37d45c","P.S. 006 Lillie D. Blake - M006 - M006 - 02M006 - 45 EAST  81 STREET","8d886843-31f4-ea11-b882-24ee9a37d45c",-73960427,40777737,"P.S. 6 - MANHATTAN","45 EAST  81 STREET"
4,4,0,"bd69c231-32f4-ea11-b882-24ee9a37d45c","P.S. 212 - Q212 - Q212 - 30Q212 - 34-25 82 STREET","b969c231-32f4-ea11-b882-24ee9a37d45c",-73884458,40753035,"P.S. 212 - QUEENS","34-25 82 STREET"
3,2,1,"1fa198c3-30f4-ea11-b882-24ee9a37d45c","Sunset Park Avenues Elementary School - K516 - K333 - 15K516 - 4222 4th Avenue","20a198c3-30f4-ea11-b882-24ee9a37d45c",-74008106,40650793,"P.S. 516 SUNSET PARK AVENUES ELEMENTARY SCHOOL - B","4222 4th Avenue"
2,0,2,"0678931f-33f4-ea11-b882-24ee9a37d45c","I.S. 117 Joseph H. Wade - X117 - X117 - 09X117 - 1865 MORRIS AVENUE","0578931f-33f4-ea11-b882-24ee9a37d45c",-73909022,40848552,"I.S. 117 - BRONX","1865 MORRIS AVENUE"
2,1,1,"197eed06-32f4-ea11-b882-24ee9a37d45c","P.S. 089 Elmhurst - Q089 - Q089 - 24Q089 - 85-28 BRITTON AVENUE","1a7eed06-32f4-ea11-b882-24ee9a37d45c",-73879641,40745963,"P.S. 89 - QUEENS","85-28 BRITTON AVENUE"
4,4,0,"c548b1f5-eaf6-ea11-b883-24ee9a37d459","Urban Assembly New York Harbor School - M551 - M877 - 02M551 - 10 South Street, Slip 7","86c280bd-31f4-ea11-b882-24ee9a37d45c",-74018941,40689493,"NEW YORK HARBOR SCHOOL - MANHATTAN","10 South Street, Slip 7"
10,10,0,"e8ed94c3-31f4-ea11-b882-24ee9a37d45c","Beacon High School - M479 - M912 - 03M479 - 522 WEST 44TH STREET","e7ed94c3-31f4-ea11-b882-24ee9a37d45c",-73996262,40760858,"BEACON HIGH SCHOOL - MANHATTAN","522 WEST 44TH STREET"
1,0,1,"84b50aa5-30f4-ea11-b882-24ee9a37d45c","P.S. 361 East Flatbush Early Childhood School - K361 - K269 - 22K361 - 1957 NOSTRAND AVENUE","80b50aa5-30f4-ea11-b882-24ee9a37d45c",-73947672,40637625,"P.S. 269 - BROOKLYN","1957 NOSTRAND AVENUE"
1,1,0,"dd3159fa-30f4-ea11-b882-24ee9a37d45c","Bridges: A School for Exploration and Equity - K915 - K580 - 13K915 - 105 TECH PLACE","d33159fa-30f4-ea11-b882-24ee9a37d45c",-73986105,40695444,"GEORGE WESTINGHOUSE VOC HS - K","105 TECH PLACE"
6,2,4,"8fdc32dc-31f4-ea11-b882-24ee9a37d45c","The Academy for Excellence through the Arts - Q303 - Q003 - 28Q303 - 68-60 110 Street","90dc32dc-31f4-ea11-b882-24ee9a37d45c",-73844032,40725787,"P.S. 303 - QUEENS","68-60 110 Street"
1,0,1,"b148b1f5-eaf6-ea11-b883-24ee9a37d459","P.S. 149 Sojourner Truth - M149 - M207 - 03M149 - 41 West 117 Street","8b8d8486-31f4-ea11-b882-24ee9a37d45c",-73948088,40802649,"P.S. 207 (TANDEM M149)","41 West 117 Street"
1,0,1,"c985f462-ebf6-ea11-b883-24ee9a37d459","P.S. 149 Sojourner Truth - M149 - M149 - 03M149 - 34 West 118 Street","539f4974-31f4-ea11-b882-24ee9a37d45c",-73948088,40802649,"P.S. 149 (TANDEM M207) - MANHATTAN","34 West 118 Street"
1,1,0,"b548b1f5-eaf6-ea11-b883-24ee9a37d459","District 2 Pre-K Center - M391 - M391 - 02M391 - 2-26 WASHINGTON STREET","7034aa92-31f4-ea11-b882-24ee9a37d45c",-74015929,40704892,"PRE-K @ 2-26 WASHINGTON ST - MANHATTAN","2-26 WASHINGTON STREET"
4,2,2,"78977d2b-32f4-ea11-b882-24ee9a37d45c","J.H.S. 190 Russell Sage - Q190 - Q190 - 28Q190 - 68-17 AUSTIN STREET","75977d2b-32f4-ea11-b882-24ee9a37d45c",-73851700,40723478,"J.H.S. 190 - QUEENS","68-17 AUSTIN STREET"
1,0,1,"bf8fd48d-ebf6-ea11-b883-24ee9a37d459","P.S. Q993 - Q993 - Q072 - 75Q993 - 133-25 GUY R BREWER BOULEVARD","852f77fa-31f4-ea11-b882-24ee9a37d45c",-73775643,40675014,"J.H.S. 72 - QUEENS","133-25 GUY R BREWER BOULEVARD"
4,2,2,"8207e99e-31f4-ea11-b882-24ee9a37d45c","High School of Arts and Technology - M494 - M490 - 03M494 - 122 AMSTERDAM AVENUE","7c07e99e-31f4-ea11-b882-24ee9a37d45c",-73985608,40774891,"MARTIN LUTHER KING, JR. HS - M","122 AMSTERDAM AVENUE"
1,1,0,"58f4a0ef-eaf6-ea11-b883-24ee9a37d459","Explore Excel Charter School - K379 - K114 - 84K379 - 1077 REMSEN AVENUE","29e85c61-30f4-ea11-b882-24ee9a37d45c",-73907880,40642684,"P.S. 114 - BROOKLYN","1077 REMSEN AVENUE"
7,5,2,"58767649-31f4-ea11-b882-24ee9a37d45c","Urban Assembly School for the Performing Arts - M369 - M043 - 05M369 - 509 WEST 129 STREET","59767649-31f4-ea11-b882-24ee9a37d45c",-73955520,40815747,"I.S. 172 (OLD 43) - MANHATTAN","509 WEST 129 STREET"
3,2,1,"75d92255-30f4-ea11-b882-24ee9a37d45c","J.H.S. 088 Peter Rouget - K088 - K088 - 15K088 - 544 7TH AVENUE","76d92255-30f4-ea11-b882-24ee9a37d45c",-73988743,40660805,"I.S. 88 - BROOKLYN","544 7TH AVENUE"
26,24,2,"bdb66262-32f4-ea11-b882-24ee9a37d45c","Francis Lewis High School - Q430 - Q430 - 26Q430 - 58-20 UTOPIA PARKWAY","bcb66262-32f4-ea11-b882-24ee9a37d45c",-73795049,40740875,"FRANCIS LEWIS HS - Q","58-20 UTOPIA PARKWAY"
1,1,0,"8453dd74-33f4-ea11-b882-24ee9a37d45c","Bronx Health Sciences High School - X249 - X455 - 11X249 - 750 BAYCHESTER AVENUE","8253dd74-33f4-ea11-b882-24ee9a37d45c",-73831669,40874035,"HARRY S. TRUMAN HS - X","750 BAYCHESTER AVENUE"
1,0,1,"d1f57030-30f4-ea11-b882-24ee9a37d45c","P.S. 007 Abraham Lincoln - K007 - K007 - 19K007 - 858 JAMAICA AVENUE","fcc1392a-30f4-ea11-b882-24ee9a37d45c",-73872983,40689213,"P.S. 7 - BROOKLYN","858 JAMAICA AVENUE"
3,2,1,"539d7c62-33f4-ea11-b882-24ee9a37d45c","Pan American International High School at Monroe - X388 - X420 - 12X388 - 1300 BOYNTON AVENUE","519d7c62-33f4-ea11-b882-24ee9a37d45c",-73878191,40832508,"JAMES MONROE EDUCATIONAL CAMPUS - X","1300 BOYNTON AVENUE"
2,0,2,"46b4977a-32f4-ea11-b882-24ee9a37d45c","Aviation Career & Technical Education High School - Q610 - Q610 - 24Q610 - 45-30 36 STREET","44b4977a-32f4-ea11-b882-24ee9a37d45c",-73929577,40743309,"AVIATION HS - Q","45-30 36 STREET"
3,3,0,"722f77fa-31f4-ea11-b882-24ee9a37d45c","J.H.S. 067 Louis Pasteur - Q067 - Q067 - 26Q067 - 51-60 MARATHON PARKWAY","732f77fa-31f4-ea11-b882-24ee9a37d45c",-73734832,40762241,"J.H.S. 67 - QUEENS","51-60 MARATHON PARKWAY"
1,1,0,"4ede5eb7-30f4-ea11-b882-24ee9a37d45c","I.S. 303 Herbert S. Eisenberg - K303 - K303 - 21K303 - 501 WEST AVENUE","4cde5eb7-30f4-ea11-b882-24ee9a37d45c",-73972009,40582518,"I.S. 303 - BROOKLYN","521 WEST AVENUE"
10,8,2,"75bc9674-32f4-ea11-b882-24ee9a37d45c","Grover Cleveland High School - Q485 - Q485 - 24Q485 - 21-27 HIMROD STREET","74bc9674-32f4-ea11-b882-24ee9a37d45c",-73909202,40711881,"GROVER CLEVELAND HS - Q","21-27 HIMROD STREET"
2,1,1,"1ee2abc9-30f4-ea11-b882-24ee9a37d45c","J.H.S. 383 Philippa Schuyler - K383 - K383 - 32K383 - 1300 GREENE AVENUE","1de2abc9-30f4-ea11-b882-24ee9a37d45c",-73919088,40697898,"I.S. 383 - BROOKLYN","1300 GREENE AVENUE"
9,6,3,"13ba8b86-30f4-ea11-b882-24ee9a37d45c","P.S. 206 Joseph F Lamb - K206 - K206 - 22K206 - 2200 GRAVESEND NECK ROAD","14ba8b86-30f4-ea11-b882-24ee9a37d45c",-73948453,40596876,"P.S. 206 - BROOKLYN","2200 GRAVESEND NECK ROAD"
4,3,1,"df2ece86-32f4-ea11-b882-24ee9a37d45c","Bard High School Early College Queens - Q299 - Q735 - 24Q299 - 30-20 THOMSON AVENUE","db2ece86-32f4-ea11-b882-24ee9a37d45c",-73937004,40744175,"QUEENS HIGH SCHOOL COMPLEX - Q","30-20 THOMSON AVENUE"
4,4,0,"4e767649-31f4-ea11-b882-24ee9a37d45c","P.S. 040 Augustus Saint-Gaudens - M040 - M040 - 02M040 - 320 EAST 20TH STREET","46767649-31f4-ea11-b882-24ee9a37d45c",-73981536,40735328,"P.S. 40 - MANHATTAN","320 EAST 20TH STREET"
8,2,6,"c348b1f5-eaf6-ea11-b883-24ee9a37d459","P.S. M811 - Mickey Mantle School - M811 - M841 - 75M811 - 466 West End Avenue","676e70b7-31f4-ea11-b882-24ee9a37d45c",-73979217,40786330,"P.S. 811 (OLD P148/LIVINGS HS) - M","466 West End Avenue"
14,14,0,"4c8dbfcf-30f4-ea11-b882-24ee9a37d45c","Midwood High School - K405 - K405 - 22K405 - 2839 BEDFORD AVENUE","4d8dbfcf-30f4-ea11-b882-24ee9a37d45c",-73952356,40632829,"MIDWOOD HS - K","2839 BEDFORD AVENUE"
3,3,0,"1c6e3d68-31f4-ea11-b882-24ee9a37d45c","P.S. 116 Mary Lindley Murray - M116 - M116 - 02M116 - 210 East  33 Street","1d6e3d68-31f4-ea11-b882-24ee9a37d45c",-73977906,40744511,"P.S. 116 - MANHATTAN","210 East  33 Street"
2,0,2,"af2ff20c-32f4-ea11-b882-24ee9a37d45c","P.S. 105 The Bay School - Q105 - Q105 - 27Q105 - 420 BEACH  51 STREET","b02ff20c-32f4-ea11-b882-24ee9a37d45c",-73780961,40595911,"P.S. 105 - QUEENS","420 BEACH  51 STREET"
2,2,0,"f8454b50-32f4-ea11-b882-24ee9a37d45c","P.S. 377 - Q377 - Q335 - 27Q377 - 150-15 RALEIGH STREET","f4454b50-32f4-ea11-b882-24ee9a37d45c",-73836850,40668083,"Centreville Educational Building","150-15 RALEIGH STREET"
4,3,1,"10ba8b86-30f4-ea11-b882-24ee9a37d45c","P.S. 205 Clarion - K205 - K205 - 20K205 - 6701 20 AVENUE","11ba8b86-30f4-ea11-b882-24ee9a37d45c",-73986792,40614737,"P.S. 205 - BROOKLYN","6701 20 AVENUE"
2,0,2,"a5dab801-ecf6-ea11-b883-24ee9a37d459","Rose Hill Pre-K Center - X535 - X432 - 10X535 - 2490-2500 WEBSTER AVENUE","ae3aa668-33f4-ea11-b882-24ee9a37d45c",-73891838,40860601,"PRE-K CENTER @WEBSTER AVENUE - BRONX","2490-2500 WEBSTER AVENUE"
2,1,1,"10b7c337-32f4-ea11-b882-24ee9a37d45c","P.S. 221 The North Hills School - Q221 - Q221 - 26Q221 - 57-40 MARATHON PARKWAY","11b7c337-32f4-ea11-b882-24ee9a37d45c",-73731518,40758808,"P.S. 221 - QUEENS","57-40 MARATHON PARKWAY"
2,1,1,"ecce496e-31f4-ea11-b882-24ee9a37d45c","Columbia Secondary School - M362 - M125 - 05M362 - 425 WEST 123 STREET","edce496e-31f4-ea11-b882-24ee9a37d45c",-73955722,40810793,"P.S. 125 - MANHATTAN","425 WEST 123 STREET"
6,5,1,"692f77fa-31f4-ea11-b882-24ee9a37d45c","P.S. 063 Old South - Q063 - Q063 - 27Q063 - 90-15 SUTTER AVENUE","6a2f77fa-31f4-ea11-b882-24ee9a37d45c",-73846796,40676978,"P.S. 63 - QUEENS","90-15 SUTTER AVENUE"
1,0,1,"216e3d68-31f4-ea11-b882-24ee9a37d45c","Esperanza Preparatory Academy - M372 - M117 - 04M372 - 240 EAST 109 STREET","1b6e3d68-31f4-ea11-b882-24ee9a37d45c",-73942285,40792556,"J.H.S. 117 - MANHATTAN","240 EAST 109 STREET"
1,1,0,"c7ba3c50-33f4-ea11-b882-24ee9a37d45c","P.S. 279 Captain Manuel Rivera, Jr. - X279 - X279 - 10X279 - 2100 WALTON AVENUE","c8ba3c50-33f4-ea11-b882-24ee9a37d45c",-73904958,40854666,"P.S. 279 - BRONX","2100 WALTON AVENUE"
12,10,2,"e292e6d5-30f4-ea11-b882-24ee9a37d45c","James Madison High School - K425 - K425 - 22K425 - 3787 BEDFORD AVENUE","e092e6d5-30f4-ea11-b882-24ee9a37d45c",-73947661,40610499,"JAMES MADISON HS - K","3787 BEDFORD AVENUE"
6,6,0,"9ee657bd-30f4-ea11-b882-24ee9a37d45c","I.S. 318 Eugenio Maria De Hostos - K318 - K318 - 14K318 - 101 WALTON STREET","9de657bd-30f4-ea11-b882-24ee9a37d45c",-73948771,40703034,"I.S. 318 - BROOKLYN","101 WALTON STREET"
2,2,0,"44ff3d8d-33f4-ea11-b882-24ee9a37d45c","High School of American Studies at Lehman College - X696 - X905 - 10X696 - 2925 Goulden Avenue","45ff3d8d-33f4-ea11-b882-24ee9a37d45c",-73895543,40874725,"HS OF AMERICAN STUDIES - BRONX","2925 Goulden Avenue"
7,6,1,"b03fce93-7c88-ec11-b8d0-24ee9a37d45c","Academy of American Studies - Q575 - Q575 - 30Q575 - 40-11 28th Street","b13fce93-7c88-ec11-b8d0-24ee9a37d45c",-73936596,40751839,"ACADEMY OF AMERICAN STUDIES - QUEENS","40-11 28th Street"
2,1,1,"1a9ebaee-32f4-ea11-b882-24ee9a37d45c","P.S. 008 Isaac Varian - X008 - X008 - 10X008 - 3010 BRIGGS AVENUE","1b9ebaee-32f4-ea11-b882-24ee9a37d45c",-73883339,40872259,"P.S. 8 - BRONX","3010 BRIGGS AVENUE"
10,9,1,"9672c880-32f4-ea11-b882-24ee9a37d45c","High School for Construction Trades, Engineering and Architecture - Q650 - Q650 - 27Q650 - 94-06 104TH STREET","8f72c880-32f4-ea11-b882-24ee9a37d45c",-73841475,40689177,"HS FOR CONST.TRADES,ENGG.,& ARCH-Q","94-06 104TH STREET"
4,2,2,"43767649-31f4-ea11-b882-24ee9a37d45c","P.S. 033 Chelsea Prep - M033 - M033 - 02M033 - 281 9 AVENUE","42767649-31f4-ea11-b882-24ee9a37d45c",-74000238,40749014,"P.S. 33 - MANHATTAN","281 9 AVENUE"
3,1,2,"cee0838c-31f4-ea11-b882-24ee9a37d45c","The River School - M281 - M281 - 02M281 - 425 East 35 Street","cde0838c-31f4-ea11-b882-24ee9a37d45c",-73972592,40744288,"P.S. 281 - MANHATTAN","425 East 35 Street"
1,1,0,"aeedf392-32f4-ea11-b882-24ee9a37d45c","P.S. 188 Kingsbury - Q188 - Q858 - 26Q188 - 216-15 Peck Avenue","afedf392-32f4-ea11-b882-24ee9a37d45c",-73754390,40734924,"PS 188 Annex","216-15 Peck Avenue"
1,1,0,"26af0313-32f4-ea11-b882-24ee9a37d45c","P.S./M.S. 138 Sunrise - Q138 - Q138 - 29Q138 - 251-11 WELLER AVENUE","1aaf0313-32f4-ea11-b882-24ee9a37d45c",-73734342,40659876,"P.S. 138 - QUEENS","251-11 WELLER AVENUE"
2,0,2,"f2d27c6d-30f4-ea11-b882-24ee9a37d45c","P.S. K315 - K315 - K152 - 22K315 - 2310 GLENWOOD ROAD","efd27c6d-30f4-ea11-b882-24ee9a37d45c",-73954269,40632619,"P.S. 152 - BROOKLYN","725 EAST  23 STREET"
3,2,1,"c2fc24e8-31f4-ea11-b882-24ee9a37d45c","World Journalism Preparatory: A College Board School - Q285 - Q025 - 25Q285 - 34-65 192 STREET","befc24e8-31f4-ea11-b882-24ee9a37d45c",-73789365,40764884,"J.H.S. 25 - QUEENS","34-65 192 STREET"
2,0,2,"6cbc9674-32f4-ea11-b882-24ee9a37d45c","John Adams High School - Q480 - Q480 - 27Q480 - 101-01 ROCKAWAY BOULEVARD","6abc9674-32f4-ea11-b882-24ee9a37d45c",-73838616,40680065,"JOHN ADAMS HS - QUEENS","101-01 ROCKAWAY BOULEVARD"
2,2,0,"76b50aa5-30f4-ea11-b882-24ee9a37d45c","P.S. 264 Bay Ridge Elementary School For The Arts - K264 - K264 - 20K264 - 371 89th Street","74b50aa5-30f4-ea11-b882-24ee9a37d45c",-74029444,40621025,"PS 264 BAY RIDGE ELEM SCL FOR THE ARTS - BROOKLYN","371 89th Street"
1,1,0,"8436d900-33f4-ea11-b882-24ee9a37d45c","P.S. 062 Inocensio Casanova - X062 - X062 - 08X062 - 660 FOX STREET","8336d900-33f4-ea11-b882-24ee9a37d45c",-73900161,40813736,"P.S. 62 - BRONX","660 FOX STREET"
3,3,0,"ba9c11e8-30f4-ea11-b882-24ee9a37d45c","The Academy of Urban Planning and Engineering - K552 - K480 - 32K552 - 400 IRVING AVENUE","b39c11e8-30f4-ea11-b882-24ee9a37d45c",-73911751,40696457,"BUSHWICK EDUCATIONAL CAMPUS - K","400 IRVING AVENUE"
4,3,1,"347c21b7-32f4-ea11-b882-24ee9a37d45c","P.S. 003 The Margaret Gioiosa School - R003 - R003 - 31R003 - 80 SOUTH GOFF AVENUE","357c21b7-32f4-ea11-b882-24ee9a37d45c",-74211850,40520812,"P.S. 3 - STATEN ISLAND","80 SOUTH GOFF AVENUE"
1,1,0,"989c11e8-30f4-ea11-b882-24ee9a37d45c","Millennium Brooklyn HS - K684 - K460 - 15K684 - 237 7 AVENUE","929c11e8-30f4-ea11-b882-24ee9a37d45c",-73978580,40669255,"John Jay Educational Campus","237 7 AVENUE"
2,1,1,"d78a0044-33f4-ea11-b882-24ee9a37d45c","Archimedes Academy for Math, Science and Technology Applications - X367 - X174 - 08X367 - 456 WHITE PLAINS ROAD","2a2ed53d-33f4-ea11-b882-24ee9a37d45c",-73856070,40815043,"I.S. 174 - BRONX","456 WHITE PLAINS ROAD"
1,0,1,"75611579-4afb-ea11-b883-24ee9a37d459","BLANCHE 2 - QAVC - QAVC -  - 44-02 BEACH CHANNEL DRIVE","76611579-4afb-ea11-b883-24ee9a37d459",-73776338,40595841,"BLANCHE 2","44-02 BEACH CHANNEL DRIVE"
4,3,1,"95886843-31f4-ea11-b882-24ee9a37d45c","P.S. 009 Sarah Anderson - M009 - M009 - 03M009 - 100 WEST  84 STREET","87886843-31f4-ea11-b882-24ee9a37d45c",-73974256,40785234,"P.S. 9 - MANHATTAN","100 WEST  84 STREET"
4,2,2,"fcae0313-32f4-ea11-b882-24ee9a37d45c","I.S. 125 Thom J. McCann Woodside - Q125 - Q125 - 24Q125 - 46-02 47 AVENUE","fdae0313-32f4-ea11-b882-24ee9a37d45c",-73918762,40740452,"I.S. 125 - QUEENS","46-02 47 AVENUE"
2,1,1,"1c7eed06-32f4-ea11-b882-24ee9a37d45c","P.S. 090 Horace Mann - Q090 - Q090 - 27Q090 - 86-50 109 STREET","1d7eed06-32f4-ea11-b882-24ee9a37d45c",-73839517,40696653,"P.S. 90 - QUEENS","86-50 109 STREET"
2,2,0,"66b50aa5-30f4-ea11-b882-24ee9a37d45c","P.S. 261 Philip Livingston - K261 - K261 - 15K261 - 314 PACIFIC STREET","5fb50aa5-30f4-ea11-b882-24ee9a37d45c",-73988667,40687218,"P.S. 261 - BROOKLYN","314 PACIFIC STREET"
7,3,4,"5b5b4cd6-32f4-ea11-b882-24ee9a37d45c","Curtis High School - R450 - R450 - 31R450 - 105 HAMILTON AVENUE","5a5b4cd6-32f4-ea11-b882-24ee9a37d45c",-74082149,40645436,"CURTIS HS - S. I.","105 HAMILTON AVENUE"
1,1,0,"fcb98b86-30f4-ea11-b882-24ee9a37d45c","P.S. 199 Frederick Wachtel - K199 - K199 - 21K199 - 1100 ELM AVENUE","fdb98b86-30f4-ea11-b882-24ee9a37d45c",-73963026,40616310,"P.S. 199 - BROOKLYN","1100 ELM AVENUE"
3,1,2,"480b210d-33f4-ea11-b882-24ee9a37d45c","P.S. X811 - X811 - X084 - 75X811 - 1434 Longfellow Avenue","490b210d-33f4-ea11-b882-24ee9a37d45c",-73886798,40830552,"P.S. 811 (OLD I84) - BRONX","1434 Longfellow Avenue"
5,3,2,"ebb98b86-30f4-ea11-b882-24ee9a37d45c","P.S. 194 Raoul Wallenberg - K194 - K194 - 22K194 - 3117 AVENUE W","ecb98b86-30f4-ea11-b882-24ee9a37d45c",-73934163,40598069,"P.S. 194 - BROOKLYN","3117 AVENUE W"
1,0,1,"3802fdd0-ebf6-ea11-b883-24ee9a37d459","The David Marquis School of the Arts - R037 - R002 - 75R037 - 333 Midland Avenue","2b7c21b7-32f4-ea11-b882-24ee9a37d45c",-74099685,40576728,"I.S. 2 - STATEN ISLAND","333 Midland Avenue"
2,2,0,"0dd1de79-30f4-ea11-b882-24ee9a37d45c","P.S. 177 The Marlboro - K177 - K177 - 21K177 - 346 AVENUE P","0ed1de79-30f4-ea11-b882-24ee9a37d45c",-73974425,40608169,"P.S. 177 - BROOKLYN","346 AVENUE P"
1,1,0,"24ba8b86-30f4-ea11-b882-24ee9a37d45c","I.S. 211 John Wilson - K211 - K211 - 18K211 - 1001 EAST 100 STREET","22ba8b86-30f4-ea11-b882-24ee9a37d45c",-73895224,40642931,"I.S. 211 - BROOKLYN","1001 EAST 100 STREET"
3,3,0,"810e6e25-32f4-ea11-b882-24ee9a37d45c","BELL Academy - Q294 - Q169 - 25Q294 - 18-25 212 STREET","820e6e25-32f4-ea11-b882-24ee9a37d45c",-73778430,40782331,"P.S. 169 - QUEENS","18-25 212 STREET"
4,1,3,"6a5bc58c-30f4-ea11-b882-24ee9a37d45c","J.H.S. 220 John J. Pershing - K220 - K220 - 20K220 - 4812 9TH AVENUE","695bc58c-30f4-ea11-b882-24ee9a37d45c",-74001250,40640997,"I.S. 220 - BROOKLYN","4812 9TH AVENUE"
1,0,1,"1baf0313-32f4-ea11-b882-24ee9a37d45c","The Bellaire School - Q135 - Q135 - 29Q135 - 207-11 89 AVENUE","1caf0313-32f4-ea11-b882-24ee9a37d45c",-73757591,40720864,"P.S. 135 - QUEENS","207-11 89 AVENUE"
3,2,1,"18474313-33f4-ea11-b882-24ee9a37d45c","P.S. 086 Kingsbridge Heights - X086 - X086 - 10X086 - 2756 RESERVOIR AVENUE","19474313-33f4-ea11-b882-24ee9a37d45c",-73897066,40869061,"P.S. 86 - BRONX","2756 RESERVOIR AVENUE"
3,0,3,"8034aa92-31f4-ea11-b882-24ee9a37d45c","Hudson High School of Learning Technologies - M437 - M440 - 02M437 - 351 WEST  18 STREET","7834aa92-31f4-ea11-b882-24ee9a37d45c",-74002540,40743407,"BAYARD RUSTIN EDUCATIONAL COMP-M","351 WEST  18 STREET"
4,2,2,"172ed53d-33f4-ea11-b882-24ee9a37d45c","P.S. 214 - X214 - X167 - 12X214 - 1970 WEST FARMS ROAD","152ed53d-33f4-ea11-b882-24ee9a37d45c",-73879931,40839297,"P.S. 214 - BRONX","1970 WEST FARMS ROAD"
7,6,1,"e68521d0-32f4-ea11-b882-24ee9a37d45c","I.S. 075 Frank D. Paulo - R075 - R075 - 31R075 - 455 HUGUENOT AVENUE","e28521d0-32f4-ea11-b882-24ee9a37d45c",-74197033,40544535,"I.S. 75 - STATEN ISLAND","455 HUGUENOT AVENUE"
2,1,1,"7f283fb1-30f4-ea11-b882-24ee9a37d45c","P.S. 290 Juan Morel Campos - K290 - K290 - 19K290 - 135 Schenck Avenue","7e283fb1-30f4-ea11-b882-24ee9a37d45c",-73889375,40678182,"P.S. 290 - BROOKLYN","135 Schenck Avenue"
2,0,2,"b89c11e8-30f4-ea11-b882-24ee9a37d45c","The Brooklyn School for Social Justice - K549 - K480 - 32K549 - 400 IRVING AVENUE","b39c11e8-30f4-ea11-b882-24ee9a37d45c",-73911751,40696457,"BUSHWICK EDUCATIONAL CAMPUS - K","400 IRVING AVENUE"
1,1,0,"136e3d68-31f4-ea11-b882-24ee9a37d45c","East Side Middle School - M114 - M114 - 02M114 - 331 EAST 91ST STREET","126e3d68-31f4-ea11-b882-24ee9a37d45c",-73947379,40780452,"EAST SIDE MIDDLE SCHOOL - MANHATTAN","331 EAST 91ST STREET"
1,0,1,"38eabc42-30f4-ea11-b882-24ee9a37d45c","The Urban Assembly Unison School - K351 - K056 - 13K351 - 170 GATES AVENUE","39eabc42-30f4-ea11-b882-24ee9a37d45c",-73960536,40684286,"P.S. 56 - BROOKLYN","170 GATES AVENUE"
6,2,4,"89886843-31f4-ea11-b882-24ee9a37d45c","P.S. 005 Ellen Lurie - M005 - M005 - 06M005 - 3703 TENTH AVENUE","8a886843-31f4-ea11-b882-24ee9a37d45c",-73922277,40857633,"P.S. 5 - MANHATTAN","3703 TENTH AVENUE"
1,0,1,"ac2aa42b-33f4-ea11-b882-24ee9a37d45c","The New School for Leadership and Journalism - X244 - X143 - 10X244 - 120 WEST 231 STREET","ad2aa42b-33f4-ea11-b882-24ee9a37d45c",-73901565,40875636,"I.S. 143 - BRONX","120 WEST 231 STREET"
4,2,2,"d4c88e4f-31f4-ea11-b882-24ee9a37d45c","The 47 American Sign Language & English Lower School - M347 - M047 - 02M347 - 223 EAST 23 STREET","d0c88e4f-31f4-ea11-b882-24ee9a37d45c",-73981329,40738374,"J.H.S. 47 (SCH FOR THE DEAF) - M","223 EAST 23 STREET"
45,44,1,"5d07e99e-31f4-ea11-b882-24ee9a37d45c","Stuyvesant High School - M475 - M477 - 02M475 - 345 CHAMBERS STREET","5c07e99e-31f4-ea11-b882-24ee9a37d45c",-74013921,40718025,"STUYVESANT HS (NEW) - MANHATTAN","345 CHAMBERS STREET"
6,4,2,"dfa2f813-ebf6-ea11-b883-24ee9a37d459","P.S. K369 - Coy L. Cox School - K369 - K067 - 75K369 - 51 SAINT EDWARDS STREET","d179df48-30f4-ea11-b882-24ee9a37d45c",-73977674,40695339,"P.S. 67 - BROOKLYN","51 SAINT EDWARDS STREET"
1,0,1,"269ebaee-32f4-ea11-b882-24ee9a37d45c","P.S. X012 Lewis and Clark School - X012 - X012 - 75X012 - 2555 TRATMAN AVENUE","279ebaee-32f4-ea11-b882-24ee9a37d45c",-73844685,40840625,"P.S. 12 - BRONX","2555 TRATMAN AVENUE"
2,2,0,"7e8d8486-31f4-ea11-b882-24ee9a37d45c","P.S. 198 Isador E. Ida Straus - M198 - M198 - 02M198 - 1700 3 AVENUE","7f8d8486-31f4-ea11-b882-24ee9a37d45c",-73950420,40785018,"P.S. 198 - MANHATTAN","1700 3 AVENUE"
2,2,0,"cbd27c6d-30f4-ea11-b882-24ee9a37d45c","P.S. 139 Alexine A. Fenty - K139 - K139 - 22K139 - 330 RUGBY ROAD","cad27c6d-30f4-ea11-b882-24ee9a37d45c",-73965862,40641340,"P.S. 139 - BROOKLYN","330 RUGBY ROAD"
9,4,5,"8fa9d9c3-32f4-ea11-b882-24ee9a37d45c","P.S. 036 J. C. Drumgoole - R036 - R036 - 31R036 - 255 IONIA AVENUE","8ba9d9c3-32f4-ea11-b882-24ee9a37d45c",-74182548,40543433,"P.S. 36 - STATEN ISLAND","255 IONIA AVENUE"
4,1,3,"f8d0de79-30f4-ea11-b882-24ee9a37d45c","Highland Park Community School - K760 - K171 - 19K760 - 528 RIDGEWOOD AVENUE","53ebaa73-30f4-ea11-b882-24ee9a37d45c",-73869434,40685852,"I.S. 171 - BROOKLYN","528 RIDGEWOOD AVENUE"
1,0,1,"5f60bdcd-83ef-eb11-b8b1-24ee9a37d45c","P.S. 009 - Q009 - Q238 - 75Q009 - 88-15 182 Street","2106003e-32f4-ea11-b882-24ee9a37d45c",-73779653,40712743,"I.S. 238 - QUEENS","88-15 182 Street"
2,2,0,"fa1aad3c-30f4-ea11-b882-24ee9a37d45c","P.S. 034 Oliver H. Perry - K034 - K034 - 14K034 - 131 NORMAN AVENUE","f91aad3c-30f4-ea11-b882-24ee9a37d45c",-73949756,40726378,"P.S. 34 - BROOKLYN","131 NORMAN AVENUE"
5,5,0,"e7f22ce2-31f4-ea11-b882-24ee9a37d45c","I.S. 5 - The Walter Crowley Intermediate School - Q005 - Q005 - 24Q005 - 50-40 JACOBUS STREET","9adc32dc-31f4-ea11-b882-24ee9a37d45c",-73888133,40737405,"I.S. 5 - QUEENS","50-40 JACOBUS STREET"
2,2,0,"b82ff20c-32f4-ea11-b882-24ee9a37d45c","P.S. 108 Captain Vincent G. Fowler - Q108 - Q108 - 27Q108 - 108-10 109 AVENUE","b92ff20c-32f4-ea11-b882-24ee9a37d45c",-73831025,40679083,"P.S. 108 - QUEENS","108-10 109 AVENUE"
1,0,1,"b6315367-30f4-ea11-b882-24ee9a37d45c","P.S. 120 Carlos Tapia - K120 - K120 - 14K120 - 18 Beaver Street","b2315367-30f4-ea11-b882-24ee9a37d45c",-73937888,40700819,"P.S. 120 - BROOKLYN","18 Beaver Street"
1,1,0,"52767649-31f4-ea11-b882-24ee9a37d45c","P.S. 041 Greenwich Village - M041 - M041 - 02M041 - 116 WEST  11 STREET","53767649-31f4-ea11-b882-24ee9a37d45c",-73999094,40735450,"P.S. 41 - MANHATTAN","116 WEST  11 STREET"
2,2,0,"f01aad3c-30f4-ea11-b882-24ee9a37d45c","P.S. 031 Samuel F. Dupont - K031 - K031 - 14K031 - 75 MESEROLE AVENUE","f11aad3c-30f4-ea11-b882-24ee9a37d45c",-73954139,40726970,"P.S. 31 (OLD 126) - K","75 MESEROLE AVENUE"
9,3,6,"8c0e6e25-32f4-ea11-b882-24ee9a37d45c","Irwin Altman Middle School 172 - Q172 - Q172 - 26Q172 - 81-14 257 Street","8d0e6e25-32f4-ea11-b882-24ee9a37d45c",-73713245,40741409,"J.H.S. 172 - QUEENS","81-14 257 Street"
12,11,1,"a472c880-32f4-ea11-b882-24ee9a37d45c","Metropolitan Expeditionary Learning School - Q167 - Q686 - 28Q167 - 91-30 METROPOLITAN AVENUE","a372c880-32f4-ea11-b882-24ee9a37d45c",-73855543,40708431,"METROPOLITAN AVENUE CAMPUS - QUEENS","91-30 METROPOLITAN AVENUE"
6,5,1,"daf57030-30f4-ea11-b882-24ee9a37d45c","Magnet School of Math, Science and Design Technology - K010 - K010 - 15K010 - 511 7 AVENUE","dbf57030-30f4-ea11-b882-24ee9a37d45c",-73985946,40660912,"P.S. 10 - BROOKLYN","511 7 AVENUE"
1,0,1,"038b0044-33f4-ea11-b882-24ee9a37d45c","Cornerstone Academy for Social Action - X189 - X189 - 11X189 - 3441 STEENWICK AVENUE","018b0044-33f4-ea11-b882-24ee9a37d45c",-73830616,40882778,"P.S./I.S. 189 - BRONX","3441 STEENWICK AVENUE"
1,1,0,"2502926e-32f4-ea11-b882-24ee9a37d45c","Jamaica Gateway to the Sciences - Q350 - Q470 - 28Q350 - 167-01 GOTHIC DRIVE","1f02926e-32f4-ea11-b882-24ee9a37d45c",-73798658,40714551,"JAMAICA HS - Q","167-01 GOTHIC DRIVE"
18,17,1,"03b7c337-32f4-ea11-b882-24ee9a37d45c","J.H.S. 216 George J. Ryan - Q216 - Q216 - 26Q216 - 64-20 175 Street","04b7c337-32f4-ea11-b882-24ee9a37d45c",-73794501,40737188,"J.H.S. 216 - QUEENS","64-20 175 Street"
1,0,1,"d211f898-32f4-ea11-b882-24ee9a37d45c","P.S. 65 - The Raymond York Elementary School - Q065 - Q884 - 27Q065 - 103-22 99 STREET","d111f898-32f4-ea11-b882-24ee9a37d45c",-73841675,40682293,"P.S. 65 - QUEENS","103-22 99 STREET"
5,4,1,"ef9b4c1f-32f4-ea11-b882-24ee9a37d45c","J.H.S. 157 Stephen A. Halsey - Q157 - Q157 - 28Q157 - 63-55 102ND STREET","f09b4c1f-32f4-ea11-b882-24ee9a37d45c",-73852879,40732348,"J.H.S. 157 - QUEENS","63-55 102ND STREET"
3,2,1,"8be657bd-30f4-ea11-b882-24ee9a37d45c","Urban Assembly Institute of Math and Science for Young Women - K527 - K313 - 13K527 - 283 ADAMS STREET","82e657bd-30f4-ea11-b882-24ee9a37d45c",-73988323,40694629,"ADAMS STREET EDUCATIONAL CAMPUS - K","283 ADAMS STREET"
1,0,1,"340b210d-33f4-ea11-b882-24ee9a37d45c","Creston Academy - X447 - X079 - 10X447 - 125 EAST 181 STREET","2c0b210d-33f4-ea11-b882-24ee9a37d45c",-73903139,40855337,"P.S. 79 - BRONX","125 EAST 181 STREET"
1,0,1,"09af1f69-ebf6-ea11-b883-24ee9a37d459","Manhattan School for Career Development - M751 - M440 - 75M751 - 351 WEST  18 STREET","7834aa92-31f4-ea11-b882-24ee9a37d45c",-74002540,40743407,"BAYARD RUSTIN EDUCATIONAL COMP-M","351 WEST  18 STREET"
1,0,1,"95c9a854-4afb-ea11-b883-24ee9a37d459","SOUTH JAMAICA CENTER FOR CHILDREN AND PARENTS 2 - QAYD - QAYD -  - 94-43 159th Street","96c9a854-4afb-ea11-b883-24ee9a37d459",-73797875,40701355,"SOUTH JAMAICA CENTER FOR CHILDREN AND PARENTS CENT","94-43 159th Street"
2,0,2,"de315367-30f4-ea11-b882-24ee9a37d45c","P.S. 135 Sheldon A. Brookner - K135 - K135 - 18K135 - 684 LINDEN BOULEVARD","df315367-30f4-ea11-b882-24ee9a37d45c",-73932949,40653093,"P.S. 135 - BROOKLYN","684 LINDEN BOULEVARD"
1,0,1,"45416e00-31f4-ea11-b882-24ee9a37d45c","District 20 Pre-K Center - K768 - K678 - 20K768 - 1423 62ND STREET","46416e00-31f4-ea11-b882-24ee9a37d45c",-73996423,40625978,"PRE-K CENTER @62ND STREET - BROOKLYN","1423 62ND STREET"
2,1,1,"c22ff20c-32f4-ea11-b882-24ee9a37d45c","P.S. 112 Dutch Kills - Q112 - Q112 - 30Q112 - 25-05 37 AVENUE","c32ff20c-32f4-ea11-b882-24ee9a37d45c",-73933562,40757293,"P.S. 112 - QUEENS","25-05 37 AVENUE"
2,1,1,"625bc58c-30f4-ea11-b882-24ee9a37d45c","P.S. 219 Kennedy-King - K219 - K219 - 18K219 - 1060 CLARKSON AVENUE","615bc58c-30f4-ea11-b882-24ee9a37d45c",-73922296,40658834,"P.S. 219 - BROOKLYN","1060 CLARKSON AVENUE"
1,0,1,"998d8486-31f4-ea11-b882-24ee9a37d45c","City College Academy of the Arts - M293 - M218 - 06M293 - 4600 BROADWAY","978d8486-31f4-ea11-b882-24ee9a37d45c",-73930082,40860951,"I.S. 218 - MANHATTAN","4600 BROADWAY"
9,6,3,"cee8ce00-32f4-ea11-b882-24ee9a37d45c","J.H.S. 074 Nathaniel Hawthorne - Q074 - Q074 - 26Q074 - 61-15 Oceania Street","cfe8ce00-32f4-ea11-b882-24ee9a37d45c",-73766653,40744743,"I.S. 74 - QUEENS","61-15 Oceania Street"
1,1,0,"056e3d68-31f4-ea11-b882-24ee9a37d45c","P.S. 111 Adolph S. Ochs - M111 - M111 - 02M111 - 440 WEST  53 STREET","006e3d68-31f4-ea11-b882-24ee9a37d45c",-73989776,40765880,"P.S. 111 - MANHATTAN","440 WEST  53 STREET"
3,2,1,"4fa10a44-32f4-ea11-b882-24ee9a37d45c","P.S./I.S. 268 - Q268 - Q268 - 29Q268 - 92-07 175 STREET","4ea10a44-32f4-ea11-b882-24ee9a37d45c",-73785210,40707648,"P.S. 268 - QUEENS","92-07 175 STREET"
8,7,1,"c0e0838c-31f4-ea11-b882-24ee9a37d45c","East Side Elementary School, PS 267 - M267 - M267 - 02M267 - 213 EAST 63RD STREET","c1e0838c-31f4-ea11-b882-24ee9a37d45c",-73963861,40763883,"P.S. 59 - (MEETH) -MANHATTAN","213 EAST 63RD STREET"
2,1,1,"993aa668-33f4-ea11-b882-24ee9a37d45c","High School for Contemporary Arts - X544 - X425 - 11X544 - 800 EAST GUN HILL ROAD","699d7c62-33f4-ea11-b882-24ee9a37d45c",-73861649,40875172,"EVANDER CHILDS HS - X","800 EAST GUN HILL ROAD"
2,1,1,"9548b1f5-eaf6-ea11-b883-24ee9a37d459","Brooklyn Navy Yard STEAM Center - K891 - K777 - 33K891 - 141 FLUSHING AVENUE","5a2f7d06-31f4-ea11-b882-24ee9a37d45c",-73972767,40702258,"H.S. STEAM CENTER@BUILDING 77 - BROOKLYN","141 FLUSHING AVENUE"
2,2,0,"cc0d3c5b-30f4-ea11-b882-24ee9a37d45c","P.S. 97 The Highlawn - K097 - K097 - 21K097 - 1855 Stillwell Avenue","cd0d3c5b-30f4-ea11-b882-24ee9a37d45c",-73985570,40601191,"P.S. 97 - BROOKLYN","1855 Stillwell Avenue"
13,8,5,"6ca9d9c3-32f4-ea11-b882-24ee9a37d45c","I.S. 024 Myra S. Barnes - R024 - R024 - 31R024 - 750 DURANT AVENUE","5bfdc1bd-32f4-ea11-b882-24ee9a37d45c",-74145558,40545490,"I.S. 24 - STATEN ISLAND","750 DURANT AVENUE"
1,0,1,"30c15a75-ebf6-ea11-b883-24ee9a37d459","Adult and Continuing Education - K755 - M827 - 79K755 - 500 8 AVENUE","576e70b7-31f4-ea11-b882-24ee9a37d45c",-73992405,40753038,"AUX. SERV-MAN. LEARNING CENTER - M","500 8 AVENUE"
9,7,2,"c3e0838c-31f4-ea11-b882-24ee9a37d45c","P.S./I.S. 217 Roosevelt Island - M217 - M271 - 02M217 - 645 MAIN STREET","b8e0838c-31f4-ea11-b882-24ee9a37d45c",-73956435,40753598,"P.S./I.S. 217 - MANHATTAN","645 MAIN STREET"
3,1,2,"417c21b7-32f4-ea11-b882-24ee9a37d45c","P.S. 6 Corporal Allan F. Kivlehan School - R006 - R006 - 31R006 - 555 PAGE AVENUE","3c7c21b7-32f4-ea11-b882-24ee9a37d45c",-74230118,40510207,"P.S. 6 - STATEN ISLAND","555 PAGE AVENUE"
2,1,1,"817e21a6-ebf6-ea11-b883-24ee9a37d459","P.S. 009 - Q009 - Q268 - 75Q009 - 92-07 175 STREET","4ea10a44-32f4-ea11-b882-24ee9a37d45c",-73785210,40707648,"P.S. 268 - QUEENS","92-07 175 STREET"
3,0,3,"9b48b1f5-eaf6-ea11-b883-24ee9a37d459","P.S. 36 - K036 - K857 - 75K036 - 2045 Linden Boulevard","21d8cf12-31f4-ea11-b882-24ee9a37d45c",-73887195,40660465,"P.S. 36 ANNEX - BROOKLYN","2045 Linden Boulevard"
1,0,1,"eca2f813-ebf6-ea11-b883-24ee9a37d459","P.S. K053 - K053 - K088 - 75K053 - 544 7TH AVENUE","76d92255-30f4-ea11-b882-24ee9a37d45c",-73988743,40660805,"I.S. 88 - BROOKLYN","544 7TH AVENUE"
2,1,1,"3b88e6db-30f4-ea11-b882-24ee9a37d45c","Performing Arts and Technology High School - K507 - K435 - 19K507 - 400 PENNSYLVANIA AVENUE","3688e6db-30f4-ea11-b882-24ee9a37d45c",-73895122,40666868,"THOMAS JEFFERSON HS - K","400 PENNSYLVANIA AVENUE"
2,2,0,"c50d3c5b-30f4-ea11-b882-24ee9a37d45c","I.S. 096 Seth Low - K096 - K096 - 21K096 - 99 AVENUE P","c10d3c5b-30f4-ea11-b882-24ee9a37d45c",-73984985,40608135,"I.S. 96 - BROOKLYN","99 AVENUE P"
1,0,1,"23025a42-4afb-ea11-b883-24ee9a37d459","CIRCLE ACADEMY ( NORTH SIDE SCHOOL - JAMAICA ) - QASJ - QANJ -  - 84-60 PARSONS BLVD","24025a42-4afb-ea11-b883-24ee9a37d459",-73806863,40712498,"PARSONS PRESCHOOL FOR CHILDREN","84-60 PARSONS BLVD"
1,0,1,"5ede5eb7-30f4-ea11-b882-24ee9a37d45c","P.S. 307 Daniel Hale Williams - K307 - K307 - 13K307 - 209 YORK STREET","5fde5eb7-30f4-ea11-b882-24ee9a37d45c",-73981599,40701789,"P.S. 307 - BROOKLYN","209 YORK STREET"
2,2,0,"6e6e70b7-31f4-ea11-b882-24ee9a37d45c","P.S. 150 - M150 - M840 - 02M150 - 334 GREENWICH STREET","6f6e70b7-31f4-ea11-b882-24ee9a37d45c",-74010880,40719530,"P.S. 150 - MANHATTAN","334 GREENWICH STREET"
1,0,1,"da9b4c1f-32f4-ea11-b882-24ee9a37d45c","P.S. 151 Mary D. Carter - Q151 - Q151 - 30Q151 - 50-05 31 AVENUE","db9b4c1f-32f4-ea11-b882-24ee9a37d45c",-73908146,40758027,"P.S. 151 - QUEENS","50-05 31 AVENUE"
2,1,1,"bebfa431-33f4-ea11-b882-24ee9a37d45c","South Bronx Preparatory: A College Board School - X221 - X149 - 07X221 - 360 EAST 145 STREET","bcbfa431-33f4-ea11-b882-24ee9a37d45c",-73920851,40813612,"J.H.S. 149 - BRONX","360 EAST 145 STREET"
2,0,2,"add810ab-31f4-ea11-b882-24ee9a37d45c","Business Of Sports School - M393 - M625 - 02M393 - 439 WEST 49TH STREET","a9d810ab-31f4-ea11-b882-24ee9a37d45c",-73990318,40763655,"HS OF GRAPHIC COMMUNICATION ARTS-M","439 WEST 49TH STREET"
5,5,0,"1eb4977a-32f4-ea11-b882-24ee9a37d45c","Townsend Harris High School - Q525 - Q515 - 25Q525 - 149-11 MELBOURNE AVENUE","1db4977a-32f4-ea11-b882-24ee9a37d45c",-73821532,40737038,"TOWNSEND HARRIS HS - Q","149-11 MELBOURNE AVENUE"
2,1,1,"a88fd48d-ebf6-ea11-b883-24ee9a37d459","P.S. Q224 - Q224 - Q026 - 75Q224 - 195-02 69 AVENUE","c5fc24e8-31f4-ea11-b882-24ee9a37d45c",-73777607,40735935,"P.S. 26 - QUEENS","195-02 69 AVENUE"
2,2,0,"5f6e70b7-31f4-ea11-b882-24ee9a37d45c","High School of Economics and Finance - M489 - M833 - 02M489 - 100 TRINITY PLACE","606e70b7-31f4-ea11-b882-24ee9a37d45c",-74012328,40709270,"HS FOR ECONOMICS & FINANCE - M","100 TRINITY PLACE"
1,1,0,"d0fab455-31f4-ea11-b882-24ee9a37d45c","The STAR Academy - P.S.63 - M063 - M063 - 01M063 - 121 EAST  3 STREET","cefab455-31f4-ea11-b882-24ee9a37d45c",-73986214,40724440,"P.S. 63 - MANHATTAN","121 EAST  3 STREET"
12,9,3,"6ce2635c-32f4-ea11-b882-24ee9a37d45c","Bayside High School - Q495 - Q405 - 26Q495 - 32-24 CORPORAL KENNEDY STREET","6be2635c-32f4-ea11-b882-24ee9a37d45c",-73781041,40771398,"BAYSIDE HS - Q","32-24 CORPORAL KENNEDY STREET"
4,3,1,"2c06003e-32f4-ea11-b882-24ee9a37d45c","P.S. 242 Leonard P. Stavisky Early Childhood School - Q242 - Q242 - 25Q242 - 29-66 137 STREET","2d06003e-32f4-ea11-b882-24ee9a37d45c",-73832005,40769752,"P.S. 242 - (ECC) - QUEENS","29-66 137 STREET"
4,3,1,"64395a2c-ebf6-ea11-b883-24ee9a37d459","Achievement First Apollo Charter School - K774 - K292 - 84K774 - 301 VERMONT STREET","8a283fb1-30f4-ea11-b882-24ee9a37d45c",-73893319,40671601,"I.S. 292 - BROOKLYN","301 VERMONT STREET"
1,1,0,"626e70b7-31f4-ea11-b882-24ee9a37d45c","High School for Environmental Studies - M400 - M834 - 02M400 - 444 WEST 56 STREET","5d6e70b7-31f4-ea11-b882-24ee9a37d45c",-73988610,40767848,"HS FOR ENVIRONMENTAL STUDIES - M","444 WEST 56 STREET"
2,1,1,"1e0b210d-33f4-ea11-b882-24ee9a37d45c","The Vida Bogart School for All Children - X352 - X075 - 75X352 - 984 FAILE STREET","1f0b210d-33f4-ea11-b882-24ee9a37d45c",-73888948,40822314,"P.S. 75 - BRONX","984 FAILE STREET"
2,2,0,"362f7d06-31f4-ea11-b882-24ee9a37d45c","Brooklyn Studio Secondary School - K690 - K721 - 21K690 - 8310 21ST AVENUE","56416e00-31f4-ea11-b882-24ee9a37d45c",-73995084,40604980,"BROOKLYN STUDIO  (TANDEM K128) - K","8310 21ST AVENUE"
1,1,0,"f43159fa-30f4-ea11-b882-24ee9a37d45c","District 20 Pre-K Center - K768 - K613 - 20K768 - 369 93RD STREET","f53159fa-30f4-ea11-b882-24ee9a37d45c",-74031046,40618135,"PRE-K CENTER @93RD STREET - BROOKLYN","369 93RD STREET"
1,1,0,"b7b36d80-30f4-ea11-b882-24ee9a37d45c","P.S. K231 - K231 - K180 - 75K231 - 5601 16 AVENUE","b8b36d80-30f4-ea11-b882-24ee9a37d45c",-73989250,40626454,"P.S. 180 - BROOKLYN","5601 16 AVENUE"
1,1,0,"d82ff20c-32f4-ea11-b882-24ee9a37d45c","P.S./I.S. 119 The Glendale - Q119 - Q119 - 24Q119 - 74-01 78 AVENUE","d92ff20c-32f4-ea11-b882-24ee9a37d45c",-73875073,40705187,"I.S. 119 - QUEENS","74-01 78 AVENUE"
3,2,1,"26c73b4a-32f4-ea11-b882-24ee9a37d45c","A.C.E. Academy for Scholars at the Geraldine Ferraro Campus - Q290 - Q290 - 24Q290 - 55-20 METROPOLITAN AVENUE","24c73b4a-32f4-ea11-b882-24ee9a37d45c",-73908307,40713030,"THE GERALDINE FERRARO CAMPUS - QUEENS","55-20 METROPOLITAN AVENUE"
1,0,1,"f8d10307-33f4-ea11-b882-24ee9a37d45c","The Vida Bogart School for All Children - X352 - X074 - 75X352 - 730 BRYANT AVENUE","f9d10307-33f4-ea11-b882-24ee9a37d45c",-73885284,40815827,"I.S. 201 - BRONX","730 BRYANT AVENUE"
2,2,0,"7fe657bd-30f4-ea11-b882-24ee9a37d45c","P.S. 309 The George E. Wibecan Preparatory Academy - K309 - K309 - 16K309 - 794 MONROE STREET","7ee657bd-30f4-ea11-b882-24ee9a37d45c",-73924422,40688100,"P.S. 309 - BROOKLYN","794 MONROE STREET"
2,0,2,"10e2abc9-30f4-ea11-b882-24ee9a37d45c","Achievement First North Brooklyn Prep Charter School - K784 - K377 - 84K784 - 200 WOODBINE STREET","11e2abc9-30f4-ea11-b882-24ee9a37d45c",-73915159,40693542,"P.S. 377 - BROOKLYN","200 WOODBINE STREET"
1,0,1,"5a5bc58c-30f4-ea11-b882-24ee9a37d45c","School for Classics High School - K683 - K218 - 19K683 - 370 FOUNTAIN AVENUE","5b5bc58c-30f4-ea11-b882-24ee9a37d45c",-73874537,40670020,"I.S. 218 - BROOKLYN","370 FOUNTAIN AVENUE"
4,3,1,"bab36d80-30f4-ea11-b882-24ee9a37d45c","The SEEALL Academy - K180 - K180 - 20K180 - 5601 16 AVENUE","b8b36d80-30f4-ea11-b882-24ee9a37d45c",-73989250,40626454,"P.S. 180 - BROOKLYN","5601 16 AVENUE"
3,1,2,"52507380-31f4-ea11-b882-24ee9a37d45c","P.S. 183 Robert L. Stevenson - M183 - M183 - 02M183 - 419 East  66 Street","53507380-31f4-ea11-b882-24ee9a37d45c",-73957731,40763804,"P.S. 183 - MANHATTAN","419 East  66 Street"
4,3,1,"d60d3c5b-30f4-ea11-b882-24ee9a37d45c","P.S. 101 The Verrazano - K101 - K101 - 21K101 - 8696 24 Avenue","d70d3c5b-30f4-ea11-b882-24ee9a37d45c",-73991962,40597379,"P.S. 101 - BROOKLYN","8696 24 Avenue"
3,2,1,"6f41e65b-31f4-ea11-b882-24ee9a37d45c","P.S. 075 Emily Dickinson - M075 - M075 - 03M075 - 735 WEST END AVENUE","6a41e65b-31f4-ea11-b882-24ee9a37d45c",-73973996,40795109,"P.S. 75 - MANHATTAN","735 WEST END AVENUE"
1,1,0,"f4201dab-30f4-ea11-b882-24ee9a37d45c","I.S. 281 Joseph B Cavallaro - K281 - K281 - 21K281 - 8787 24 AVENUE","f2201dab-30f4-ea11-b882-24ee9a37d45c",-73993565,40594648,"I.S. 281 - BROOKLYN","8787 24 AVENUE"
3,1,2,"1ceabc42-30f4-ea11-b882-24ee9a37d45c","Lyons Community School - K586 - K049 - 14K586 - 223 GRAHAM AVENUE","14eabc42-30f4-ea11-b882-24ee9a37d45c",-73944463,40709765,"I.S. 49 - BROOKLYN","223 GRAHAM AVENUE"
1,1,0,"4c953aac-ebf6-ea11-b883-24ee9a37d459","P.S. Q255 - Q255 - Q397 - 75Q255 - 32-52 37th Street","a4eb6056-32f4-ea11-b882-24ee9a37d45c",-73920948,40759308,"PRE-K CENTER @37TH STREET - QUEENS","32-52 37th Street"
1,1,0,"337eed06-32f4-ea11-b882-24ee9a37d45c","P.S. 098 The Douglaston School - Q098 - Q098 - 26Q098 - 40-20 235 STREET","347eed06-32f4-ea11-b882-24ee9a37d45c",-73749998,40768906,"P.S. 98 - QUEENS","40-20 235 STREET"
4,4,0,"58507380-31f4-ea11-b882-24ee9a37d45c","P.S./I.S. 187 Hudson Cliffs - M187 - M187 - 06M187 - 349 CABRINI BOULEVARD","59507380-31f4-ea11-b882-24ee9a37d45c",-73936840,40856239,"P.S./I.S. 187 - MANHATTAN","349 CABRINI BOULEVARD"
1,1,0,"20a6ba98-31f4-ea11-b882-24ee9a37d45c","Academy for Software Engineering - M546 - M460 - 02M546 - 40 IRVING PLACE","16a6ba98-31f4-ea11-b882-24ee9a37d45c",-73987064,40735361,"WASHINGTON IRVING HS - MANHATTAN","40 IRVING PLACE"
1,0,1,"6f8946f4-31f4-ea11-b882-24ee9a37d45c","P.S. 052 Queens - Q052 - Q052 - 29Q052 - 178-37 146 TERRACE","708946f4-31f4-ea11-b882-24ee9a37d45c",-73767161,40661427,"P.S. 52 - QUEENS","178-37 146 TERRACE"
7,6,1,"692b3eee-30f4-ea11-b882-24ee9a37d45c","Franklin Delano Roosevelt High School - K505 - K505 - 20K505 - 5800 20 AVENUE","682b3eee-30f4-ea11-b882-24ee9a37d45c",-73982583,40621299,"FRANKLIN D. ROOSEVELT HS - K","5800 20 AVENUE"
4,4,0,"307c21b7-32f4-ea11-b882-24ee9a37d45c","I.S. R002 George L. Egbert - R002 - R002 - 31R002 - 333 Midland Avenue","2b7c21b7-32f4-ea11-b882-24ee9a37d45c",-74099685,40576728,"I.S. 2 - STATEN ISLAND","333 Midland Avenue"
3,3,0,"14af0313-32f4-ea11-b882-24ee9a37d45c","P.S. 133 Queens - Q133 - Q133 - 26Q133 - 248-05 86 AVENUE","15af0313-32f4-ea11-b882-24ee9a37d45c",-73717819,40732458,"P.S. 133 - QUEENS","248-05 86 AVENUE"
2,1,1,"530d6d19-33f4-ea11-b882-24ee9a37d45c","P.S. 112 Bronxwood - X112 - X112 - 11X112 - 1925 SCHIEFFELIN AVENUE","540d6d19-33f4-ea11-b882-24ee9a37d45c",-73843977,40884940,"P.S. 112 - BRONX","1925 SCHIEFFELIN AVENUE"
5,2,3,"6241e65b-31f4-ea11-b882-24ee9a37d45c","Yorkville Community School - M151 - M066 - 02M151 - 421 East  88 Street","6341e65b-31f4-ea11-b882-24ee9a37d45c",-73947287,40777948,"RICHARD R GREEN HS OF TEACHING - M","421 East  88 Street"
2,1,1,"1c1bad3c-30f4-ea11-b882-24ee9a37d45c","P.S./I.S. 045 Horace E. Greene - K045 - K045 - 32K045 - 84 SCHAEFER STREET","1d1bad3c-30f4-ea11-b882-24ee9a37d45c",-73910430,40686424,"P.S. 45 - BROOKLYN","84 SCHAEFER STREET"
6,4,2,"277eed06-32f4-ea11-b882-24ee9a37d45c","P.S. 094 David D. Porter - Q094 - Q094 - 26Q094 - 41-77 Little Neck Parkway","287eed06-32f4-ea11-b882-24ee9a37d45c",-73738703,40771258,"P.S. 94 - QUEENS","41-77 Little Neck Parkway"
2,1,1,"ab3aa668-33f4-ea11-b882-24ee9a37d45c","Discovery High School - X549 - X430 - 10X549 - 2780 RESERVOIR AVENUE","a13aa668-33f4-ea11-b882-24ee9a37d45c",-73897066,40869061,"WALTON HS - X","2780 RESERVOIR AVENUE"
4,2,2,"ceb36d80-30f4-ea11-b882-24ee9a37d45c","P.S. 185 Walter Kassenbrock - K185 - K185 - 20K185 - 8601 RIDGE BOULEVARD","cfb36d80-30f4-ea11-b882-24ee9a37d45c",-74033429,40623598,"P.S. 185 - BROOKLYN","8601 RIDGE BOULEVARD"
3,1,2,"8128a20c-31f4-ea11-b882-24ee9a37d45c","Achievement First Endeavor Charter School - K508 - K784 - 84K508 - 510 WAVERLY AVENUE","8228a20c-31f4-ea11-b882-24ee9a37d45c",-73965928,40682422,"ACHIEVEMENT FIRST ENDEAVOR CHARTER SCHOOL - K","510 WAVERLY AVENUE"
2,1,1,"de21d292-30f4-ea11-b882-24ee9a37d45c","J.H.S. 223 The Montauk - K223 - K223 - 20K223 - 4200 16 AVENUE","735bc58c-30f4-ea11-b882-24ee9a37d45c",-73982424,40635100,"I.S. 223 - BROOKLYN","4200 16 AVENUE"
1,1,0,"b22ff20c-32f4-ea11-b882-24ee9a37d45c","Lighthouse Elementary School - Q106 - Q106 - 27Q106 - 180 BEACH  35 STREET","b32ff20c-32f4-ea11-b882-24ee9a37d45c",-73766846,40594738,"P.S. 106 - QUEENS","180 BEACH  35 STREET"
2,2,0,"422f7d06-31f4-ea11-b882-24ee9a37d45c","P.S. 245 - K245 - K735 - 22K245 - 249 EAST 17TH STREET","432f7d06-31f4-ea11-b882-24ee9a37d45c",-73962743,40644927,"P.S. 245 - BROOKLYN","249 EAST 17TH STREET"
1,0,1,"b856635c-33f4-ea11-b882-24ee9a37d45c","Renaissance High School for Musical Theater and the Arts - X293 - X405 - 08X293 - 3000 EAST TREMONT AVENUE","b556635c-33f4-ea11-b882-24ee9a37d45c",-73839583,40839775,"HERBERT H. LEHMAN HS - X","3000 EAST TREMONT AVENUE"
7,1,6,"f38ac007-ebf6-ea11-b883-24ee9a37d459","P.S. X176 - X176 - X455 - 75X176 - 750 BAYCHESTER AVENUE","8253dd74-33f4-ea11-b882-24ee9a37d45c",-73831669,40874035,"HARRY S. TRUMAN HS - X","750 BAYCHESTER AVENUE"
1,1,0,"1606003e-32f4-ea11-b882-24ee9a37d45c","P.S. 234 - Q234 - Q234 - 30Q234 - 30-15 29 STREET","1506003e-32f4-ea11-b882-24ee9a37d45c",-73923044,40766898,"P.S. 234 - QUEENS","30-14 30 STREET"
1,0,1,"a2886843-31f4-ea11-b882-24ee9a37d45c","Central Park East High School - M555 - M013 - 04M555 - 1573 MADISON AVENUE","98886843-31f4-ea11-b882-24ee9a37d45c",-73948488,40793649,"I.S. 13 - MANHATTAN","1573 MADISON AVENUE"
3,2,1,"a183ff9e-30f4-ea11-b882-24ee9a37d45c","P.S. 253 - K253 - K253 - 21K253 - 601 OCEANVIEW AVENUE","a283ff9e-30f4-ea11-b882-24ee9a37d45c",-73961962,40580237,"P.S. 253 - BROOKLYN","601 OCEANVIEW AVENUE"
3,3,0,"340410ca-32f4-ea11-b882-24ee9a37d45c","The Barbara Esselborn School - R053 - R053 - 31R053 - 330 DURANT AVENUE","350410ca-32f4-ea11-b882-24ee9a37d45c",-74136640,40551926,"P.S. 53 - STATEN ISLAND","330 DURANT AVENUE"
4,1,3,"1206003e-32f4-ea11-b882-24ee9a37d45c","P.S. 232 Lindenwood - Q232 - Q232 - 27Q232 - 153-23 83 STREET","1106003e-32f4-ea11-b882-24ee9a37d45c",-73850622,40665408,"P.S. 232 - QUEENS","153-23 83 STREET"
2,0,2,"1402926e-32f4-ea11-b882-24ee9a37d45c","Academy of Medical Technology: A College Board School - Q309 - Q465 - 27Q309 - 8-21 BAY 25 STREET","0b02926e-32f4-ea11-b882-24ee9a37d45c",-73763995,40601537,"FAR ROCKAWAY HS - Q","8-21 BAY 25 STREET"
1,1,0,"9034aa92-31f4-ea11-b882-24ee9a37d45c","High School for Dual Language and Asian Studies - M545 - M445 - 02M545 - 350 GRAND STREET","8834aa92-31f4-ea11-b882-24ee9a37d45c",-73989329,40717329,"SEWARD PARK HS - MANHATTAN","350 GRAND STREET"
5,5,0,"6c2f77fa-31f4-ea11-b882-24ee9a37d45c","P.S. 064 Joseph P. Addabbo - Q064 - Q064 - 27Q064 - 82-01 101 AVENUE","6d2f77fa-31f4-ea11-b882-24ee9a37d45c",-73856956,40681901,"P.S. 64 - QUEENS","82-01 101 AVENUE"
1,0,1,"d2883319-32f4-ea11-b882-24ee9a37d45c","Queens Transition Center - Q752 - Q142 - 75Q752 - 142-10 LINDEN BOULEVARD","2eaf0313-32f4-ea11-b882-24ee9a37d45c",-73800875,40683473,"P.S. 752 (OLD J142) - QUEENS","142-10 LINDEN BOULEVARD"
1,0,1,"377c21b7-32f4-ea11-b882-24ee9a37d45c","P.S. 004 Maurice Wollin - R004 - R004 - 31R004 - 200 NEDRA LANE","337c21b7-32f4-ea11-b882-24ee9a37d45c",-74195281,40552059,"P.S. 4 - STATEN ISLAND","200 NEDRA LANE"
2,2,0,"87611579-4afb-ea11-b883-24ee9a37d459","Immanuel Genius - QBHM - QBHM -  - 253-01","88611579-4afb-ea11-b883-24ee9a37d459",-73735409,40770787,"Immanuel Genius","253-01"
4,4,0,"d9d27c6d-30f4-ea11-b882-24ee9a37d45c","P.S. 147 Isaac Remsen - K147 - K147 - 14K147 - 325 BUSHWICK AVENUE","d4d27c6d-30f4-ea11-b882-24ee9a37d45c",-73938790,40705005,"P.S. 147 - BROOKLYN","325 BUSHWICK AVENUE"
3,1,2,"db92e6d5-30f4-ea11-b882-24ee9a37d45c","Academy for Young Writers - K404 - K422 - 19K404 - 1065 ELTON STREET","da92e6d5-30f4-ea11-b882-24ee9a37d45c",-73874064,40657266,"SPRING CREEK EDUCATIONAL CAMPUS - BROOKLYN","1065 ELTON STREET"
3,2,1,"725bc58c-30f4-ea11-b882-24ee9a37d45c","Urban Assembly School for Leadership and Empowerment - K609 - K223 - 20K609 - 4200 16 AVENUE","735bc58c-30f4-ea11-b882-24ee9a37d45c",-73982424,40635100,"I.S. 223 - BROOKLYN","4200 16 AVENUE"
2,0,2,"1cba8b86-30f4-ea11-b882-24ee9a37d45c","P.S. 209 Margaret Mead - K209 - K209 - 21K209 - 2609 EAST  7 STREET","1dba8b86-30f4-ea11-b882-24ee9a37d45c",-73961191,40586800,"P.S. 209 - BROOKLYN","2609 EAST  7 STREET"
4,1,3,"f017b7f4-32f4-ea11-b882-24ee9a37d45c","P.S. 025 Bilingual School - X025 - X025 - 07X025 - 811 EAST 149 STREET","f117b7f4-32f4-ea11-b882-24ee9a37d45c",-73905751,40812895,"P.S. 25 - BRONX","811 EAST 149 STREET"
1,1,0,"5af4a0ef-eaf6-ea11-b883-24ee9a37d459","P.S. K771 - K771 - K225 - 75K771 - 1075 OCEAN VIEW AVENUE","e521d292-30f4-ea11-b882-24ee9a37d45c",-73955856,40580260,"P.S. 225 - BROOKLYN","1075 OCEAN VIEW AVENUE"
2,2,0,"6c977d2b-32f4-ea11-b882-24ee9a37d45c","P.S. 188 Kingsbury - Q188 - Q188 - 26Q188 - 218-12 HARTLAND AVENUE","6d977d2b-32f4-ea11-b882-24ee9a37d45c",-73753985,40736063,"P.S. 188 - QUEENS","218-12 HARTLAND AVENUE"
4,2,2,"ec09e2e1-30f4-ea11-b882-24ee9a37d45c","East Williamsburg Scholars Academy - K477 - K450 - 14K477 - 850 GRAND STREET","e909e2e1-30f4-ea11-b882-24ee9a37d45c",-73938921,40711134,"GRAND STREET CAMPUS (OLD E.D.HS)- K","850 GRAND STREET"
1,0,1,"e62d6c32-ebf6-ea11-b883-24ee9a37d459","P.S. K771 - K771 - K329 - 75K771 - 2929 WEST  30 STREET","11a198c3-30f4-ea11-b882-24ee9a37d45c",-73995770,40574666,"P.S. 329 - BROOKLYN","2929 WEST  30 STREET"
1,1,0,"15a6ba98-31f4-ea11-b882-24ee9a37d45c","Gramercy Arts High School - M374 - M460 - 02M374 - 40 IRVING PLACE","16a6ba98-31f4-ea11-b882-24ee9a37d45c",-73987064,40735361,"WASHINGTON IRVING HS - MANHATTAN","40 IRVING PLACE"
6,5,1,"df883319-32f4-ea11-b882-24ee9a37d45c","P.S. 144 Col Jeromus Remsen - Q144 - Q144 - 28Q144 - 69-20 JUNO STREET","e0883319-32f4-ea11-b882-24ee9a37d45c",-73852398,40714890,"P.S. 144 - QUEENS","69-20 JUNO STREET"
1,0,1,"c95d028a-e9fe-eb11-b8b2-24ee9a37d45c","SUNSHINE SCHOOL, LLC. - QAWU - QAWU -  - 91-10 146TH STREET","ca5d028a-e9fe-eb11-b8b2-24ee9a37d45c",-73809140,40700683,"SUNSHINE SCHOOL LLC","91-10 146TH STREET"
2,2,0,"8407e99e-31f4-ea11-b882-24ee9a37d45c","Manhattan / Hunter Science High School - M541 - M490 - 03M541 - 122 AMSTERDAM AVENUE","7c07e99e-31f4-ea11-b882-24ee9a37d45c",-73985608,40774891,"MARTIN LUTHER KING, JR. HS - M","122 AMSTERDAM AVENUE"
1,1,0,"24e85c61-30f4-ea11-b882-24ee9a37d45c","M.S. 113 Ronald Edmonds Learning Center - K113 - K113 - 13K113 - 300 ADELPHI STREET","1fe85c61-30f4-ea11-b882-24ee9a37d45c",-73971474,40688769,"I.S. 113 - BROOKLYN","300 ADELPHI STREET"
1,1,0,"a483ff9e-30f4-ea11-b882-24ee9a37d45c","P.S. 254 Dag Hammarskjold - K254 - K254 - 22K254 - 2469 East 18 Street","a583ff9e-30f4-ea11-b882-24ee9a37d45c",-73951550,40591103,"P.S. 254 - BROOKLYN","2469 East 18 Street"
1,0,1,"bf17d796-e21e-eb11-b885-24ee9a37d45c","Curtis High School - R450 - R814 - 31R450 - 105 HAMILTON AVENUE","c017d796-e21e-eb11-b885-24ee9a37d45c",-74081224,40644743,"CURTIS HS TRANSPORTABLE-R","105 HAMILTON AVENUE"
3,3,0,"aaab074a-33f4-ea11-b882-24ee9a37d45c","Urban Institute of Mathematics - X371 - X192 - 08X371 - 650 HOLLYWOOD AVENUE","078b0044-33f4-ea11-b882-24ee9a37d45c",-73818083,40826794,"I.S. 192 - BRONX","650 HOLLYWOOD AVENUE"
1,0,1,"8b11b2e2-32f4-ea11-b882-24ee9a37d45c","Staten Island School of Civic Leadership - R861 - R861 - 31R861 - 280 REGIS DRIVE","8a11b2e2-32f4-ea11-b882-24ee9a37d45c",-74164427,40620310,"ELIZABETH A. CONNELLY CAMPUS - S.I.","280 REGIS DRIVE"
2,0,2,"78f4a0ef-eaf6-ea11-b883-24ee9a37d459","Sid Miller Academy - K396 - K396 - 75K396 - 110 CHESTER STREET","2d8dbfcf-30f4-ea11-b882-24ee9a37d45c",-73911788,40668232,"P.S. 396 (TANDEM K327-D23)-K","110 CHESTER STREET"
1,1,0,"e4201dab-30f4-ea11-b882-24ee9a37d45c","P.S. 277 Gerritsen Beach - K277 - K277 - 22K277 - 2529 GERRITSEN AVENUE","e5201dab-30f4-ea11-b882-24ee9a37d45c",-73927850,40595798,"P.S. 277 - BROOKLYN","2529 GERRITSEN AVENUE"
2,2,0,"0404d718-31f4-ea11-b882-24ee9a37d45c","I.S. 364 Gateway - K364 - K872 - 19K364 - 1461 Geneva Loop","0504d718-31f4-ea11-b882-24ee9a37d45c",-73878956,40646275,"I.S. 364 ANNEX - BROOKLYN","1461 Geneva Loop"
3,3,0,"5de61462-31f4-ea11-b882-24ee9a37d45c","J.H.S. 104 Simon Baruch - M104 - M104 - 02M104 - 330 EAST  21 STREET","5ee61462-31f4-ea11-b882-24ee9a37d45c",-73981034,40735879,"I.S. 104 - MANHATTAN","330 EAST  21 STREET"
1,1,0,"95eb6056-32f4-ea11-b882-24ee9a37d45c","District 29 Pre-K Center - Q381 - Q381 - 29Q381 - 168-42 JAMAICA AVENUE","96eb6056-32f4-ea11-b882-24ee9a37d45c",-73791304,40706724,"PRE-K CENTER @168-42 JAMAICA AVENUE - QUEENS","168-42 JAMAICA AVENUE"
6,6,0,"7303194f-30f4-ea11-b882-24ee9a37d45c","P.S. 69 Vincent D. Grippo School - K069 - K069 - 20K069 - 6302 9TH AVENUE","7203194f-30f4-ea11-b882-24ee9a37d45c",-74009752,40632392,"P.S. 69 - BROOKLYN","6302 9TH AVENUE"
1,1,0,"429f4974-31f4-ea11-b882-24ee9a37d45c","Washington Heights Expeditionary Learning School - M348 - M143 - 06M348 - 511 WEST 182ND STREET","3f9f4974-31f4-ea11-b882-24ee9a37d45c",-73930991,40849311,"I.S. 143 - MANHATTAN","511 WEST 182ND STREET"
8,7,1,"f59b4c1f-32f4-ea11-b882-24ee9a37d45c","P.S. 159 - Q159 - Q159 - 26Q159 - 205-01 33 AVENUE","f69b4c1f-32f4-ea11-b882-24ee9a37d45c",-73783973,40770108,"P.S. 159 - QUEENS","205-01 33 AVENUE"
6,6,0,"920e6e25-32f4-ea11-b882-24ee9a37d45c","P.S. 174 William Sidney Mount - Q174 - Q174 - 28Q174 - 65-10 DIETERLE CRESCENT","930e6e25-32f4-ea11-b882-24ee9a37d45c",-73861462,40720583,"P.S. 174 - QUEENS","65-10 DIETERLE CRESCENT"
1,1,0,"56f4a0ef-eaf6-ea11-b883-24ee9a37d459","Achievement First Voyager Charter School - K876 - K092 - 84K876 - 601 PARKSIDE AVENUE","86d92255-30f4-ea11-b882-24ee9a37d45c",-73953810,40656276,"P.S. 92 - BROOKLYN","601 PARKSIDE AVENUE"
1,1,0,"7aa9d9c3-32f4-ea11-b882-24ee9a37d45c","P.S. 029 Bardwell - R029 - R029 - 31R029 - 1581 VICTORY BOULEVARD","7ba9d9c3-32f4-ea11-b882-24ee9a37d45c",-74116197,40614039,"P.S. 29 - STATEN ISLAND","1581 VICTORY BOULEVARD"
1,1,0,"94283fb1-30f4-ea11-b882-24ee9a37d45c","Digital Arts and Cinema Technology High School - K429 - K293 - 15K429 - 284 Baltic Street","91283fb1-30f4-ea11-b882-24ee9a37d45c",-73993293,40685006,"J.H.S. 293 - BROOKLYN","284 Baltic Street"
1,1,0,"5cf4a0ef-eaf6-ea11-b883-24ee9a37d459","Kings Collegiate Charter School - K608 - K252 - 84K608 - 1084 Lenox Road","9a83ff9e-30f4-ea11-b882-24ee9a37d45c",-73919818,40657712,"I.S. 252 - BROOKLYN","1084 Lenox Road"
1,0,1,"2c474313-33f4-ea11-b882-24ee9a37d45c","P.S. 595 - X595 - X092 - 12X595 - 700 EAST 179 STREET","27474313-33f4-ea11-b882-24ee9a37d45c",-73889602,40846205,"P.S. 92 - BRONX","700 EAST 179 STREET"
1,0,1,"43fdc1bd-32f4-ea11-b882-24ee9a37d45c","I.S. 007 Elias Bernstein - R007 - R007 - 31R007 - 1270 Huguenot Avenue","447c21b7-32f4-ea11-b882-24ee9a37d45c",-74186096,40522971,"I.S. 7 - STATEN ISLAND","1270 Huguenot Avenue"
2,1,1,"310410ca-32f4-ea11-b882-24ee9a37d45c","P.S. 052 John C. Thompson - R052 - R052 - 31R052 - 450 BUEL AVENUE","320410ca-32f4-ea11-b882-24ee9a37d45c",-74089012,40582550,"P.S. 52 - STATEN ISLAND","450 BUEL AVENUE"
1,1,0,"1002926e-32f4-ea11-b882-24ee9a37d45c","Knowledge and Power Preparatory Academy VI - Q282 - Q465 - 27Q282 - 8-21 BAY 25 STREET","0b02926e-32f4-ea11-b882-24ee9a37d45c",-73763995,40601537,"FAR ROCKAWAY HS - Q","8-21 BAY 25 STREET"
1,1,0,"698946f4-31f4-ea11-b882-24ee9a37d45c","P.S. 050 Talfourd Lawn Elementary School - Q050 - Q050 - 28Q050 - 143-26 101 AVENUE","6a8946f4-31f4-ea11-b882-24ee9a37d45c",-73806842,40694868,"P.S. 50 - QUEENS","143-26 101 AVENUE"
3,3,0,"2eebaa73-30f4-ea11-b882-24ee9a37d45c","P.S. 160 William T. Sampson - K160 - K160 - 20K160 - 5105 Fort Hamilton Parkway","27ebaa73-30f4-ea11-b882-24ee9a37d45c",-73999045,40636932,"P.S. 160 - BROOKLYN","5105 Fort Hamilton Parkway"
4,4,0,"29a198c3-30f4-ea11-b882-24ee9a37d45c","P.S. 889 - K889 - K338 - 22K889 - 21 HINCKLEY PLACE","27a198c3-30f4-ea11-b882-24ee9a37d45c",-73971010,40644861,"P.S. 338 - Brooklyn","21 HINCKLEY PLACE"
6,2,4,"dd92e6d5-30f4-ea11-b882-24ee9a37d45c","Spring Creek Community School - K422 - K422 - 19K422 - 1065 ELTON STREET","da92e6d5-30f4-ea11-b882-24ee9a37d45c",-73874064,40657266,"SPRING CREEK EDUCATIONAL CAMPUS - BROOKLYN","1065 ELTON STREET"
1,0,1,"f917b7f4-32f4-ea11-b882-24ee9a37d45c","P.S. 396 - X396 - X026 - 10X396 - 1930 ANDREWS AVENUE","e917b7f4-32f4-ea11-b882-24ee9a37d45c",-73913016,40854335,"P.S. 396 - BRONX","1930 ANDREWS AVENUE"
2,2,0,"f4fb3df4-30f4-ea11-b882-24ee9a37d45c","P.S. 160 William T. Sampson - K160 - K521 - 20K160 - 1057 52ND STREET","f5fb3df4-30f4-ea11-b882-24ee9a37d45c",-73999057,40636501,"P.S. 160 ANNEX - BROOKLYN","1057 52ND STREET"
2,2,0,"8fe657bd-30f4-ea11-b882-24ee9a37d45c","P.S. 503: The School of Discovery - K503 - K314 - 20K503 - 330 59 Street","8ee657bd-30f4-ea11-b882-24ee9a37d45c",-74019299,40641950,"P.S. 314 - BROOKLYN","330 59 Street"
2,1,1,"db11f898-32f4-ea11-b882-24ee9a37d45c","Robert F. Wagner, Jr. Secondary School for Arts and Technology - Q560 - Q891 - 24Q560 - 47-07 30th Place","d911f898-32f4-ea11-b882-24ee9a37d45c",-73936442,40742217,"R. F. WAGNER SEC SCL ARTS & TECH-Q","47-07 30th Place"
1,1,0,"2d7c21b7-32f4-ea11-b882-24ee9a37d45c","P.S. 001 Tottenville - R001 - R001 - 31R001 - 58 SUMMIT STREET","2e7c21b7-32f4-ea11-b882-24ee9a37d45c",-74243950,40508638,"P.S. 1 - STATEN ISLAND","58 SUMMIT STREET"
3,1,2,"f29b4c1f-32f4-ea11-b882-24ee9a37d45c","M.S. 158 Marie Curie - Q158 - Q158 - 26Q158 - 46-35 Oceania Street","f39b4c1f-32f4-ea11-b882-24ee9a37d45c",-73771878,40756562,"J.H.S. 158 - QUEENS","46-35 Oceania Street"
1,1,0,"68464e91-4afb-ea11-b883-24ee9a37d459","Child Center of NY 2 - QASU - QASU -  - 34-10 108TH STREET","69464e91-4afb-ea11-b883-24ee9a37d459",-73860908,40755839,"BETTER CCOMMUNITY LIFE DAY CARE CENTER SITE","34-10 108TH STREET"
1,1,0,"0e06003e-32f4-ea11-b882-24ee9a37d45c","Collaborative Arts Middle School - Q355 - Q231 - 29Q355 - 145-00 SPRINGFIELD BOULEVARD","0c06003e-32f4-ea11-b882-24ee9a37d45c",-73759396,40664809,"I.S. 231 (TANDEM Q251) - QUEENS","145-00 SPRINGFIELD BOULEVARD"
1,1,0,"edc88e4f-31f4-ea11-b882-24ee9a37d45c","Inwood Early College for Health and Information Technologies - M211 - M052 - 06M211 - 650 ACADEMY STREET","e6c88e4f-31f4-ea11-b882-24ee9a37d45c",-73925464,40865556,"I.S. 52 - MANHATTAN","650 ACADEMY STREET"
1,1,0,"b3ab074a-33f4-ea11-b882-24ee9a37d45c","I.S. X318 Math, Science & Technology Through Arts - X318 - X193 - 12X318 - 1919 PROSPECT AVENUE","afab074a-33f4-ea11-b882-24ee9a37d45c",-73890145,40843705,"P.S. 211 - BRONX","1919 PROSPECT AVENUE"
5,2,3,"5ef4a0ef-eaf6-ea11-b883-24ee9a37d459","P.S. K140 - K140 - K258 - 75K140 - 141 MACON STREET","b183ff9e-30f4-ea11-b882-24ee9a37d45c",-73945600,40681920,"I.S. 258 - BROOKLYN","141 MACON STREET"
1,1,0,"0ea198c3-30f4-ea11-b882-24ee9a37d45c","P.S. 328 Phyllis Wheatley - K328 - K328 - 19K328 - 330 ALABAMA AVENUE","0ca198c3-30f4-ea11-b882-24ee9a37d45c",-73898249,40667985,"P.S. 328 - BROOKLYN","330 ALABAMA AVENUE"
1,1,0,"93e657bd-30f4-ea11-b882-24ee9a37d45c","Elijah Stroud Middle School - K353 - K316 - 17K353 - 750 CLASSON AVENUE","94e657bd-30f4-ea11-b882-24ee9a37d45c",-73961418,40674685,"P.S. 316 - BROOKLYN","750 CLASSON AVENUE"
1,0,1,"97886843-31f4-ea11-b882-24ee9a37d45c","Central Park East I - M497 - M013 - 04M497 - 1573 MADISON AVENUE","98886843-31f4-ea11-b882-24ee9a37d45c",-73948488,40793649,"I.S. 13 - MANHATTAN","1573 MADISON AVENUE"
12,6,6,"635b4cd6-32f4-ea11-b882-24ee9a37d45c","Tottenville High School - R455 - R455 - 31R455 - 100 LUTEN AVENUE","605b4cd6-32f4-ea11-b882-24ee9a37d45c",-74193431,40528152,"TOTTENVILLE HS - S. I.","100 LUTEN AVENUE"
8,8,0,"63ffcc6e-33f4-ea11-b882-24ee9a37d45c","The Bronx High School of Science - X445 - X445 - 10X445 - 75 WEST 205 STREET","64ffcc6e-33f4-ea11-b882-24ee9a37d45c",-73889011,40879958,"BRONX HS OF SCIENCE - X","75 WEST 205 STREET"
2,2,0,"652f77fa-31f4-ea11-b882-24ee9a37d45c","P. S. 62 - Chester Park School - Q062 - Q062 - 27Q062 - 97-25 108 STREET","642f77fa-31f4-ea11-b882-24ee9a37d45c",-73835567,40688359,"P.S. 62 - QUEENS","97-25 108 STREET"
1,1,0,"26e85c61-30f4-ea11-b882-24ee9a37d45c","Compass Charter School - K789 - K113 - 84K789 - 300 ADELPHI STREET","1fe85c61-30f4-ea11-b882-24ee9a37d45c",-73971474,40688769,"I.S. 113 - BROOKLYN","300 ADELPHI STREET"
1,1,0,"89e03d56-33f4-ea11-b882-24ee9a37d45c","High School for Violin and Dance - X543 - X400 - 09X543 - 1110 BOSTON ROAD","82e03d56-33f4-ea11-b882-24ee9a37d45c",-73903920,40827455,"MORRIS HS - X","1110 BOSTON ROAD"
3,3,0,"27e2abc9-30f4-ea11-b882-24ee9a37d45c","The School of Integrated Learning - K354 - K390 - 17K354 - 1224 PARK PLACE","25e2abc9-30f4-ea11-b882-24ee9a37d45c",-73937601,40672290,"I.S. 390 - BROOKLYN","1224 PARK PLACE"
2,1,1,"179ebaee-32f4-ea11-b882-24ee9a37d45c","Milton Fein School - X007 - X007 - 10X007 - 3201 KINGSBRIDGE AVENUE","189ebaee-32f4-ea11-b882-24ee9a37d45c",-73905697,40881562,"P.S. 7 - BRONX","3201 KINGSBRIDGE AVENUE"
4,4,0,"492b3eee-30f4-ea11-b882-24ee9a37d45c","High School of Telecommunication Arts and Technology - K485 - K485 - 20K485 - 350 67 STREET","bf9c11e8-30f4-ea11-b882-24ee9a37d45c",-74023419,40636721,"TELECOM. ARTS & TECH. - K","350 67 STREET"
6,6,0,"ace657bd-30f4-ea11-b882-24ee9a37d45c","P.S. 321 William Penn - K321 - K321 - 15K321 - 180 7 AVENUE","ade657bd-30f4-ea11-b882-24ee9a37d45c",-73978633,40671816,"P.S. 321 - BROOKLYN","180 7 AVENUE"
16,15,1,"a52aa42b-33f4-ea11-b882-24ee9a37d45c","Riverdale / Kingsbridge Academy (Middle School / High School 141) - X141 - X141 - 10X141 - 660 West 237 Street","a62aa42b-33f4-ea11-b882-24ee9a37d45c",-73914141,40887407,"M.S./H.S. 141 - BRONX","660 West 237 Street"
2,1,1,"2ce2abc9-30f4-ea11-b882-24ee9a37d45c","Achievement First Crown Heights Charter School - K356 - K391 - 84K356 - 790 EAST NEW YORK AVENUE","2ae2abc9-30f4-ea11-b882-24ee9a37d45c",-73936313,40662092,"I.S. 391 - BROOKLYN","790 EAST NEW YORK AVENUE"
8,4,4,"64977d2b-32f4-ea11-b882-24ee9a37d45c","J.H.S. 185 Edward Bleeker - Q185 - Q185 - 25Q185 - 147-26 25 DRIVE","ae0e6e25-32f4-ea11-b882-24ee9a37d45c",-73818607,40774906,"J.H.S. 185 - QUEENS","147-26 25 DRIVE"
2,0,2,"d59319d7-ebf6-ea11-b883-24ee9a37d459","P.S. R373 - R373 - R058 - 75R373 - 77 MARSH AVENUE","2a0410ca-32f4-ea11-b882-24ee9a37d45c",-74160867,40582791,"P.S. 58 - STATEN ISLAND","77 MARSH AVENUE"
1,0,1,"419587f5-ebf6-ea11-b883-24ee9a37d459","P.S. X596 - X596 - X153 - 75X596 - 650 BAYCHESTER AVENUE","6801ce37-33f4-ea11-b882-24ee9a37d45c",-73831669,40874035,"P.S. 153 - BRONX","650 BAYCHESTER AVENUE"
5,4,1,"54ebaa73-30f4-ea11-b882-24ee9a37d45c","P.S. 169 Sunset Park - K169 - K169 - 15K169 - 4305 7 AVENUE","55ebaa73-30f4-ea11-b882-24ee9a37d45c",-74001700,40645825,"P.S. 169 - BROOKLYN","4305 7 AVENUE"
2,1,1,"c20d3c5b-30f4-ea11-b882-24ee9a37d45c","P.S. 095 The Gravesend - K095 - K095 - 21K095 - 345 VAN SICKLEN STREET","c30d3c5b-30f4-ea11-b882-24ee9a37d45c",-73974664,40595996,"P.S. 95 - BROOKLYN","345 VAN SICKLEN STREET"
2,1,1,"0baf0313-32f4-ea11-b882-24ee9a37d45c","P.S. 130 - Q130 - Q130 - 25Q130 - 200-01 42 AVENUE","04af0313-32f4-ea11-b882-24ee9a37d45c",-73784009,40760219,"P.S. 130 - QUEENS","200-01 42 AVENUE"
8,6,2,"f2ae0313-32f4-ea11-b882-24ee9a37d45c","P.S. 122 Mamie Fay - Q122 - Q122 - 30Q122 - 21-21 DITMARS BOULEVARD","cb2ff20c-32f4-ea11-b882-24ee9a37d45c",-73915785,40780507,"P.S. 122 - QUEENS","21-21 DITMARS BOULEVARD"
2,1,1,"9641e65b-31f4-ea11-b882-24ee9a37d45c","I.S. 289 - M289 - M089 - 02M289 - 201 WARREN STREET","9741e65b-31f4-ea11-b882-24ee9a37d45c",-74013967,40717010,"P.S./I.S. 89 - MANHATTAN","201 WARREN STREET"
4,4,0,"4e2b3eee-30f4-ea11-b882-24ee9a37d45c","The Christa McAuliffe School\I.S. 187 - K187 - K486 - 20K187 - 1171 65 STREET","4f2b3eee-30f4-ea11-b882-24ee9a37d45c",-74003883,40627929,"I.S. 187 - BROOKLYN","1171 65 STREET"
3,1,2,"aefc24e8-31f4-ea11-b882-24ee9a37d45c","P.S. 021 Edward Hart - Q021 - Q021 - 25Q021 - 147-36 26 AVENUE","adfc24e8-31f4-ea11-b882-24ee9a37d45c",-73818581,40774134,"P.S. 21 - QUEENS","147-36 26 AVENUE"
1,1,0,"c6e8ce00-32f4-ea11-b882-24ee9a37d45c","Redwood Middle School - Q332 - Q072 - 28Q332 - 133-25 GUY R BREWER BOULEVARD","852f77fa-31f4-ea11-b882-24ee9a37d45c",-73775643,40675014,"J.H.S. 72 - QUEENS","133-25 GUY R BREWER BOULEVARD"
10,9,1,"27eabc42-30f4-ea11-b882-24ee9a37d45c","M.S. 51 William Alexander - K051 - K051 - 15K051 - 350 5 AVENUE","28eabc42-30f4-ea11-b882-24ee9a37d45c",-73985050,40672358,"I.S. 51 - BROOKLYN","350 5 AVENUE"
1,1,0,"9553dd74-33f4-ea11-b882-24ee9a37d45c","University Heights Secondary School - X495 - X470 - 07X495 - 701 ST. ANNS AVENUE","9253dd74-33f4-ea11-b882-24ee9a37d45c",-73911633,40818041,"SOUTH BRONX EDUCATIONAL CAMPUS (OLD 38) - X","701 ST. ANNS AVENUE"
2,0,2,"778d8486-31f4-ea11-b882-24ee9a37d45c","KIPP Infinity Charter School - M336 - M195 - 84M336 - 625 WEST 133 STREET","758d8486-31f4-ea11-b882-24ee9a37d45c",-73956814,40819793,"TERENCE D. TOLBERT EDUCATION COMPLEX - MANHATTAN","625 WEST 133 STREET"
8,8,0,"8f977d2b-32f4-ea11-b882-24ee9a37d45c","P.S. 196 Grand Central Parkway - Q196 - Q196 - 28Q196 - 71-25 113 STREET","90977d2b-32f4-ea11-b882-24ee9a37d45c",-73837379,40722792,"P.S. 196 - QUEENS","71-25 113 STREET"
3,3,0,"ed17b7f4-32f4-ea11-b882-24ee9a37d45c","P.S. 024 Spuyten Duyvil - X024 - X024 - 10X024 - 660 WEST 236 STREET","ee17b7f4-32f4-ea11-b882-24ee9a37d45c",-73915114,40886922,"P.S. 24 - BRONX","660 WEST 236 STREET"
1,0,1,"6fc280bd-31f4-ea11-b882-24ee9a37d45c","Washington Heights Expeditionary Learning School - M348 - M859 - 06M348 - 512 WEST 182 ST","70c280bd-31f4-ea11-b882-24ee9a37d45c",-73931100,40849000,"I.S. 143 MINISCHOOL - MANHATTAN","512 WEST 182 ST"
9,6,3,"d7f57030-30f4-ea11-b882-24ee9a37d45c","Public School 9 The Sarah Smith Garnet School - K009 - K009 - 13K009 - 80 UNDERHILL AVENUE","d8f57030-30f4-ea11-b882-24ee9a37d45c",-73966333,40678554,"P.S. 9 - BROOKLYN","80 UNDERHILL AVENUE"
3,3,0,"a69c11e8-30f4-ea11-b882-24ee9a37d45c","Science, Technology and Research Early College High School at Erasmus - K543 - K465 - 17K543 - 911 FLATBUSH AVENUE","9d9c11e8-30f4-ea11-b882-24ee9a37d45c",-73957173,40649602,"ERASMUS HALL CAMPUS - K","911 FLATBUSH AVENUE"
2,1,1,"400410ca-32f4-ea11-b882-24ee9a37d45c","P.S. 057 Hubert H. Humphrey - R057 - R057 - 31R057 - 140 PALMA DRIVE","410410ca-32f4-ea11-b882-24ee9a37d45c",-74083799,40611136,"P.S. 57 - STATEN ISLAND","140 PALMA DRIVE"
2,0,2,"4d3cbf01-ebf6-ea11-b883-24ee9a37d459","P.S. R373 - R373 - R040 - 75R373 - 91 HENDERSON AVENUE","97a9d9c3-32f4-ea11-b882-24ee9a37d45c",-74095454,40641180,"P.S. 373 (OLD P40) - STATEN ISLAND","91 HENDERSON AVENUE"
1,1,0,"8f11b2e2-32f4-ea11-b882-24ee9a37d45c","Bridge Preparatory Charter School - R076 - R880 - 84R076 - 715 OCEAN TERRACE","8e11b2e2-32f4-ea11-b882-24ee9a37d45c",-74105883,40607637,"P.S. 80 (PETR COMPL-BLDG B) - S.I.","715 OCEAN TERRACE"
2,2,0,"410b210d-33f4-ea11-b882-24ee9a37d45c","P.S. 081 Robert J. Christen - X081 - X081 - 10X081 - 5550 RIVERDALE AVENUE","420b210d-33f4-ea11-b882-24ee9a37d45c",-73904657,40903275,"P.S. 81 - BRONX","5550 RIVERDALE AVENUE"
3,3,0,"e42ece86-32f4-ea11-b882-24ee9a37d45c","Young Women's Leadership School, Astoria - Q286 - Q739 - 30Q286 - 23-15 Newtown Avenue","e52ece86-32f4-ea11-b882-24ee9a37d45c",-73923830,40770769,"YOUNG WOMEN'S LEADERSHIP ACADEMY- QUEENS","23-15 Newtown Avenue"
1,1,0,"d4e8ce00-32f4-ea11-b882-24ee9a37d45c","P.S. 076 William Hallet - Q076 - Q076 - 30Q076 - 36-36 10 Street","d2e8ce00-32f4-ea11-b882-24ee9a37d45c",-73941630,40760862,"P.S. 76 - QUEENS","36-36 10 Street"
1,1,0,"397eed06-32f4-ea11-b882-24ee9a37d45c","P.S. 100 Glen Morris - Q100 - Q100 - 27Q100 - 111-11 118 Street","267eed06-32f4-ea11-b882-24ee9a37d45c",-73821545,40679694,"P.S. 100 - QUEENS","111-11 118 Street"
1,1,0,"07f32ce2-31f4-ea11-b882-24ee9a37d45c","P.S. 014 Fairview - Q014 - Q014 - 24Q014 - 107-01 OTIS AVENUE","faf22ce2-31f4-ea11-b882-24ee9a37d45c",-73854570,40741020,"P.S. 14 - QUEENS","107-01 OTIS AVENUE"
2,0,2,"ddab074a-33f4-ea11-b882-24ee9a37d45c","P.S. 163 Arthur A. Schomburg - X163 - X236 - 09X163 - 499 EAST 175 STREET","deab074a-33f4-ea11-b882-24ee9a37d45c",-73898593,40844728,"P.S. 236 ANNEX - BRONX","499 EAST 175 STREET"
1,0,1,"fdce496e-31f4-ea11-b882-24ee9a37d45c","School of Earth Exploration and Discovery Harlem (SEED Harlem) - M371 - M129 - 05M371 - 425 WEST 130 STREET","fece496e-31f4-ea11-b882-24ee9a37d45c",-73952020,40814914,"P.S. 129 - MANHATTAN","425 WEST 130 STREET"
3,1,2,"d6689025-33f4-ea11-b882-24ee9a37d45c","P.S. 134 George F. Bristow - X134 - X134 - 12X134 - 1330 BRISTOW STREET","d7689025-33f4-ea11-b882-24ee9a37d45c",-73894241,40831613,"P.S. 134 - BRONX","1330 BRISTOW STREET"
10,8,2,"87e2635c-32f4-ea11-b882-24ee9a37d45c","Benjamin N. Cardozo High School - Q415 - Q415 - 26Q415 - 57-00 223RD STREET","86e2635c-32f4-ea11-b882-24ee9a37d45c",-73757271,40752343,"BENJAMIN N. CARDOZO HS - Q","57-00 223RD STREET"
3,1,2,"27005d7a-31f4-ea11-b882-24ee9a37d45c","P.S. 163 Alfred E. Smith - M163 - M163 - 03M163 - 163 West  97 Street","26005d7a-31f4-ea11-b882-24ee9a37d45c",-73968470,40795163,"P.S. 163 - MANHATTAN","163 West  97 Street"
1,1,0,"33767649-31f4-ea11-b882-24ee9a37d45c","School for Global Leaders - M378 - M025 - 01M378 - 145 Stanton Street","29767649-31f4-ea11-b882-24ee9a37d45c",-73986038,40720040,"J.H.S. 25 - MANHATTAN","145 Stanton Street"
1,0,1,"ff02cefa-32f4-ea11-b882-24ee9a37d45c","P.S. 036 Unionport - X036 - X036 - 08X036 - 1070 Castle Hill Avenue","0c18b7f4-32f4-ea11-b882-24ee9a37d45c",-73849791,40829480,"P.S. 36 - BRONX","1070 Castle Hill Avenue"
2,0,2,"4a0d6d19-33f4-ea11-b882-24ee9a37d45c","P.S. 110 Theodore Schoenfeld - X110 - X110 - 09X110 - 580 CROTONA PARK SOUTH","420d6d19-33f4-ea11-b882-24ee9a37d45c",-73900654,40834470,"P.S. 110 - BRONX","580 CROTONA PARK SOUTH"
2,1,1,"502f7d06-31f4-ea11-b882-24ee9a37d45c","The Maurice Sendak Community School - K118 - K763 - 15K118 - 211 8TH STREET","512f7d06-31f4-ea11-b882-24ee9a37d45c",-73987602,40671145,"P.S. 118 MAURICE SENDAK COMMUNITY SCHOOL- BROOKLYN","211 8TH STREET"
1,1,0,"3a0b210d-33f4-ea11-b882-24ee9a37d45c","P.S./M.S. 280 Mosholu Parkway - X280 - X080 - 10X280 - 3202 STEUBEN AVENUE","370b210d-33f4-ea11-b882-24ee9a37d45c",-73881245,40876819,"I.S. 80/P.S. 280 - BRONX","3202 STEUBEN AVENUE"
3,3,0,"1e06003e-32f4-ea11-b882-24ee9a37d45c","East-West School of International Studies - Q281 - Q237 - 25Q281 - 46-21 COLDEN STREET","1b06003e-32f4-ea11-b882-24ee9a37d45c",-73821402,40749430,"J.H.S. 237 - QUEENS","46-21 COLDEN STREET"
5,3,2,"8653dd74-33f4-ea11-b882-24ee9a37d45c","Harry S Truman High School - X455 - X455 - 11X455 - 750 BAYCHESTER AVENUE","8253dd74-33f4-ea11-b882-24ee9a37d45c",-73831669,40874035,"HARRY S. TRUMAN HS - X","750 BAYCHESTER AVENUE"
8,5,3,"848946f4-31f4-ea11-b882-24ee9a37d45c","P.S. 58 - The School of Heroes - Q058 - Q058 - 24Q058 - 72-24 GRAND AVENUE","808946f4-31f4-ea11-b882-24ee9a37d45c",-73890638,40728517,"P.S. 58 - QUEENS","72-24 GRAND AVENUE"
5,2,3,"068b0044-33f4-ea11-b882-24ee9a37d45c","Bronx Delta School - X392 - X192 - 08X392 - 650 HOLLYWOOD AVENUE","078b0044-33f4-ea11-b882-24ee9a37d45c",-73818083,40826794,"I.S. 192 - BRONX","650 HOLLYWOOD AVENUE"
1,0,1,"1b497593-33f4-ea11-b882-24ee9a37d45c","P.S. 163 Arthur A. Schomburg - X163 - X933 - 09X163 - 2075 Webster Avenue","1c497593-33f4-ea11-b882-24ee9a37d45c",-73899005,40851700,"P.S. 163 TRANSPORTABLE - X","2075 Webster Avenue"
2,2,0,"1878931f-33f4-ea11-b882-24ee9a37d45c","P.S. 310 Marble Hill - X310 - X122 - 10X310 - 260 W KINGSBRIDGE RD","1978931f-33f4-ea11-b882-24ee9a37d45c",-73905547,40872477,"P.S. 310 - BRONX","260 W KINGSBRIDGE RD"
5,5,0,"c0fc24e8-31f4-ea11-b882-24ee9a37d45c","I.S. 025 Adrien Block - Q025 - Q025 - 25Q025 - 34-65 192 STREET","befc24e8-31f4-ea11-b882-24ee9a37d45c",-73789365,40764884,"J.H.S. 25 - QUEENS","34-65 192 STREET"
1,1,0,"3bef7338-ebf6-ea11-b883-24ee9a37d459","P.S. K053 - K053 - K422 - 75K053 - 1065 ELTON STREET","da92e6d5-30f4-ea11-b882-24ee9a37d45c",-73874064,40657266,"SPRING CREEK EDUCATIONAL CAMPUS - BROOKLYN","1065 ELTON STREET"
2,1,1,"d9968d36-30f4-ea11-b882-24ee9a37d45c","P.S. 020 Clinton Hill - K020 - K020 - 13K020 - 225 ADELPHI STREET","d1968d36-30f4-ea11-b882-24ee9a37d45c",-73970896,40690742,"P.S. 20 - BROOKLYN","225 ADELPHI STREET"
4,3,1,"6707e99e-31f4-ea11-b882-24ee9a37d45c","Talent Unlimited High School - M519 - M480 - 02M519 - 317 EAST  67 STREET","6007e99e-31f4-ea11-b882-24ee9a37d45c",-73959777,40765638,"JULIA RICHMAN ED. COMPLEX - M","317 EAST  67 STREET"
1,0,1,"fc9b4c1f-32f4-ea11-b882-24ee9a37d45c","P.S. 161 Arthur Ashe School - Q161 - Q161 - 28Q161 - 101-33 124 STREET","fb9b4c1f-32f4-ea11-b882-24ee9a37d45c",-73821080,40690439,"P.S. 161 - QUEENS","101-33 124 STREET"
6,4,2,"668946f4-31f4-ea11-b882-24ee9a37d45c","P.S. 049 Dorothy Bonawit Kole - Q049 - Q049 - 24Q049 - 63-60 80th Street","678946f4-31f4-ea11-b882-24ee9a37d45c",-73875493,40719567,"P.S./I.S. 49 - QUEENS","63-60 80th Street"
3,2,1,"d9883319-32f4-ea11-b882-24ee9a37d45c","P.S. 143 Louis Armstrong - Q143 - Q143 - 24Q143 - 34-74 113 Street","d7883319-32f4-ea11-b882-24ee9a37d45c",-73855715,40755393,"P.S. 143 - QUEENS","34-74 113 Street"
2,2,0,"ca92e6d5-30f4-ea11-b882-24ee9a37d45c","Academy of Innovative Technology - K618 - K420 - 19K618 - 999 JAMAICA AVENUE","c692e6d5-30f4-ea11-b882-24ee9a37d45c",-73869305,40693002,"FRANKLIN K. LANE HS - K","999 JAMAICA AVENUE"
1,0,1,"cc8442ee-31f4-ea11-b882-24ee9a37d45c","P.S. 033 Edward M. Funk - Q033 - Q033 - 29Q033 - 91-37 222 STREET","cd8442ee-31f4-ea11-b882-24ee9a37d45c",-73734102,40727172,"P.S. 33 - QUEENS","91-37 222 STREET"
1,0,1,"c1ab074a-33f4-ea11-b882-24ee9a37d45c","P.S. 205 Fiorello LaGuardia - X205 - X205 - 10X205 - 2475 Southern Boulevard","c2ab074a-33f4-ea11-b882-24ee9a37d45c",-73881753,40855759,"P.S. 205A (ECF) - BRONX","2475 Southern Boulevard"
2,2,0,"378dbfcf-30f4-ea11-b882-24ee9a37d45c","P.S. 770 New American Academy - K770 - K398 - 17K770 - 60 EAST  94 STREET","308dbfcf-30f4-ea11-b882-24ee9a37d45c",-73927979,40663388,"P.S. 398 (UDC) - BROOKLYN","60 EAST  94 STREET"
5,2,3,"f1d10307-33f4-ea11-b882-24ee9a37d45c","P.S. 071 Rose E. Scala - X071 - X071 - 08X071 - 3040 ROBERTS AVENUE","e3d10307-33f4-ea11-b882-24ee9a37d45c",-73829562,40845379,"P.S. 71 - BRONX","3040 ROBERTS AVENUE"
2,0,2,"4f507380-31f4-ea11-b882-24ee9a37d45c","P.S. 180 Hugo Newman - M180 - M180 - 03M180 - 370 WEST 120TH STREET","50507380-31f4-ea11-b882-24ee9a37d45c",-73955861,40807570,"P.S. 180 - MANHATTAN","370 WEST 120TH STREET"
5,5,0,"c52ff20c-32f4-ea11-b882-24ee9a37d45c","P.S./I.S. 113 Anthony J. Pranzo - Q113 - Q113 - 24Q113 - 78-23 87TH STREET","c62ff20c-32f4-ea11-b882-24ee9a37d45c",-73861493,40705476,"P.S./I.S. 113 - QUEENS","78-23 87TH STREET"
2,2,0,"c9fab455-31f4-ea11-b882-24ee9a37d45c","The East Village Community School - M315 - M061 - 01M315 - 610 EAST  12 STREET","c8fab455-31f4-ea11-b882-24ee9a37d45c",-73978254,40727537,"P.S. 61 - MANHATTAN","610 EAST  12 STREET"
2,2,0,"bbba3c50-33f4-ea11-b882-24ee9a37d45c","Comprehensive Model School Project M.S. 327 - X327 - X240 - 09X327 - 1501 JEROME AVENUE","baba3c50-33f4-ea11-b882-24ee9a37d45c",-73916084,40842503,"DOE NEW SETTLEMENT COMMUNITY CAMPUS - X","1501 JEROME AVENUE"
5,1,4,"2da10a44-32f4-ea11-b882-24ee9a37d45c","P.S. 128 The Lorraine Tuzzo, Juniper Valley Elementary School - Q128 - Q247 - 24Q128 - 69-10 65th Drive","2ca10a44-32f4-ea11-b882-24ee9a37d45c",-73885974,40715005,"PS/IS 128","69-10 65th Drive"
6,6,0,"5588e6db-30f4-ea11-b882-24ee9a37d45c","New Utrecht High School - K445 - K445 - 20K445 - 1601 80 STREET","5488e6db-30f4-ea11-b882-24ee9a37d45c",-74002308,40613041,"NEW UTRECHT HS - K","1601 80 STREET"
2,1,1,"b48a894e-4afb-ea11-b883-24ee9a37d459","Little Lamb Preschool - RADB - RADB -  - 2 GRIDLEY AVENUE","b58a894e-4afb-ea11-b883-24ee9a37d459",-74159839,40631227,"LITTLE LAMB PRESCHOOL","2 GRIDLEY AVENUE"
1,0,1,"204f5ffd-e11e-eb11-b885-24ee9a37d45c","District 29 Pre-K Center - Q381 - Q363 - 29Q381 - 134-35 Springfield Boulevard","214f5ffd-e11e-eb11-b885-24ee9a37d45c",-73753270,40679089,"3K CENTER @ SPRINGFIELD BOULEVARD - QUEENS","134-35 Springfield Boulevard"
1,0,1,"e4b36d80-30f4-ea11-b882-24ee9a37d45c","P.S. 192 - The Magnet School for Math and Science Inquiry - K192 - K192 - 20K192 - 4715 18 AVENUE","e5b36d80-30f4-ea11-b882-24ee9a37d45c",-73979540,40628800,"P.S. 192 - BROOKLYN","4715 18 AVENUE"
2,2,0,"e7883319-32f4-ea11-b882-24ee9a37d45c","P.S. 146 Howard Beach - Q146 - Q146 - 27Q146 - 98-01 159 AVENUE","e8883319-32f4-ea11-b882-24ee9a37d45c",-73834896,40660531,"P.S. 146 - QUEENS","98-01 159 AVENUE"
2,1,1,"ea21d292-30f4-ea11-b882-24ee9a37d45c","P.S. 226 Alfred De B. Mason - K226 - K226 - 21K226 - 6006 23 AVENUE","eb21d292-30f4-ea11-b882-24ee9a37d45c",-73977099,40615405,"P.S. 226 - BROOKLYN","6006 23 AVENUE"
1,1,0,"08af0313-32f4-ea11-b882-24ee9a37d45c","P.S. 129 Patricia Larkin - Q129 - Q129 - 25Q129 - 128-02 7 Avenue","09af0313-32f4-ea11-b882-24ee9a37d45c",-73839505,40789926,"P.S. 129 - QUEENS","128-02 7 Avenue"
1,1,0,"9c2aa42b-33f4-ea11-b882-24ee9a37d45c","Academy of Applied Mathematics and Technology - X343 - X139 - 07X343 - 345 BROOK AVENUE","942aa42b-33f4-ea11-b882-24ee9a37d45c",-73918774,40810314,"J.H.S. 222 - BRONX","345 BROOK AVENUE"
1,0,1,"ef77bb9f-33f4-ea11-b882-24ee9a37d45c","East Bronx Academy for the Future - X271 - X973 - 12X271 - 1716 SOUTHERN BOULEVARD","ed77bb9f-33f4-ea11-b882-24ee9a37d45c",-73887688,40836821,"M.S./H.S. 270 - BRONX","1716 SOUTHERN BOULEVARD"
1,1,0,"a532c3fb-eaf6-ea11-b883-24ee9a37d459","P.S. Q255 - Q255 - Q168 - 75Q255 - 158-40 76 ROAD","099c4c1f-32f4-ea11-b882-24ee9a37d45c",-73809380,40724195,"J.H.S. 168 - QUEENS","158-40 76 ROAD"
1,0,1,"13ff3d8d-33f4-ea11-b882-24ee9a37d45c","P.S. 205 Fiorello LaGuardia - X205 - X864 - 10X205 - 2375 SOUTHERN BOULEVARD","14ff3d8d-33f4-ea11-b882-24ee9a37d45c",-73882372,40853238,"P.S. 205B (ECF) - BRONX","2375 SOUTHERN BOULEVARD"
11,11,0,"a5eb0e7b-33f4-ea11-b882-24ee9a37d45c","Bronx Academy for Software Engineering (BASE) - X264 - X660 - 10X264 - 2474 CROTONA AVENUE","a3eb0e7b-33f4-ea11-b882-24ee9a37d45c",-73882487,40855392,"GRACE H. DODGE VOC HS - X","2474 CROTONA AVENUE"
1,1,0,"08cf496e-31f4-ea11-b882-24ee9a37d45c","P.S. 130 Hernando De Soto - M130 - M130 - 02M130 - 143 BAXTER STREET","09cf496e-31f4-ea11-b882-24ee9a37d45c",-73998326,40718660,"P.S. 130 - MANHATTAN","143 BAXTER STREET"
1,0,1,"f7d27c6d-30f4-ea11-b882-24ee9a37d45c","P.S. 153 Homecrest - K153 - K153 - 21K153 - 1970 HOMECREST AVENUE","f8d27c6d-30f4-ea11-b882-24ee9a37d45c",-73960027,40601179,"P.S. 153 - BROOKLYN","1970 HOMECREST AVENUE"
4,2,2,"9969c231-32f4-ea11-b882-24ee9a37d45c","J.H.S. 202 Robert H. Goddard - Q202 - Q202 - 27Q202 - 138-30 LAFAYETTE STREET","9169c231-32f4-ea11-b882-24ee9a37d45c",-73845992,40670905,"I.S. 202 - QUEENS","138-30 LAFAYETTE STREET"
4,3,1,"d4f57030-30f4-ea11-b882-24ee9a37d45c","The Emily Warren Roebling School - K008 - K008 - 13K008 - 37 HICKS STREET","d5f57030-30f4-ea11-b882-24ee9a37d45c",-73992841,40700709,"P.S. 8 - BROOKLYN","37 HICKS STREET"
11,8,3,"07fc3df4-30f4-ea11-b882-24ee9a37d45c","John Dewey High School - K540 - K540 - 21K540 - 50 AVENUE X","05fc3df4-30f4-ea11-b882-24ee9a37d45c",-73981925,40588070,"JOHN DEWEY HS - K","50 AVENUE X"
1,0,1,"e79319d7-ebf6-ea11-b883-24ee9a37d459","The Richard H. Hungerford School - R721 - R435 - 75R721 - 465 NEW DORP LANE","fb8521d0-32f4-ea11-b882-24ee9a37d45c",-74105878,40570909,"NEW DORP HS (NEW) - S. I.","465 NEW DORP LANE"
4,4,0,"f4ae0313-32f4-ea11-b882-24ee9a37d45c","The 30th Avenue School (G&T Citywide) - Q300 - Q126 - 30Q300 - 31-51 21 STREET","f5ae0313-32f4-ea11-b882-24ee9a37d45c",-73929990,40766008,"I.S. 126 - QUEENS","31-51 21 STREET"
1,0,1,"8603194f-30f4-ea11-b882-24ee9a37d45c","Brooklyn Landmark Elementary School - K599 - K073 - 23K599 - 251 MAC DOUGAL STREET","8503194f-30f4-ea11-b882-24ee9a37d45c",-73910719,40680679,"P.S. 73 - BROOKLYN","251 MAC DOUGAL STREET"
1,1,0,"6541e65b-31f4-ea11-b882-24ee9a37d45c","New York City Lab Middle School for Collaborative Studies - M312 - M070 - 02M312 - 333 WEST  17 STREET","defab455-31f4-ea11-b882-24ee9a37d45c",-74002222,40742512,"I.S. 70 - MANHATTAN","333 WEST  17 STREET"
3,2,1,"e83159fa-30f4-ea11-b882-24ee9a37d45c","Clara Barton High School - K600 - K600 - 17K600 - 901 CLASSON AVENUE","e13159fa-30f4-ea11-b882-24ee9a37d45c",-73960689,40669805,"CLARA BARTON HS - K","901 CLASSON AVENUE"
2,2,0,"5907e99e-31f4-ea11-b882-24ee9a37d45c","High School for Health Professions and Human Services - M420 - M475 - 02M420 - 345 East  15th Street","5607e99e-31f4-ea11-b882-24ee9a37d45c",-73982590,40732665,"HEALTH PROFESSIONS HS (OL STY) - M","345 East  15th Street"
2,2,0,"8a41e65b-31f4-ea11-b882-24ee9a37d45c","P.S. 084 Lillian Weber - M084 - M084 - 03M084 - 32 West  92 Street","8b41e65b-31f4-ea11-b882-24ee9a37d45c",-73968419,40789479,"P.S. 84 - MANHATTAN","32 West  92 Street"
3,3,0,"b779df48-30f4-ea11-b882-24ee9a37d45c","P.S. 058 The Carroll - K058 - K058 - 15K058 - 330 SMITH STREET","b879df48-30f4-ea11-b882-24ee9a37d45c",-73995486,40680379,"P.S. 58 - BROOKLYN","330 SMITH STREET"
1,0,1,"c117d796-e21e-eb11-b885-24ee9a37d45c","The Richard H. Hungerford School - R721 - R843 - 75R721 - 110 Shafter Avenue","7d11b2e2-32f4-ea11-b882-24ee9a37d45c",-74148370,40554498,"GREAT KILLS HIGH SCHOOL","110 Shafter Avenue"
9,9,0,"45e61462-31f4-ea11-b882-24ee9a37d45c","Bard High School Early College - M696 - M097 - 01M696 - 525 EAST HOUSTON STREET","46e61462-31f4-ea11-b882-24ee9a37d45c",-73976093,40718276,"BARD COLLEGE HS (OLD M097) - M","525 EAST HOUSTON STREET"
1,1,0,"72e2635c-32f4-ea11-b882-24ee9a37d45c","District 25 PRE-K Center - Q409 - Q409 - 25Q409 - 14-45 143rd Street","73e2635c-32f4-ea11-b882-24ee9a37d45c",-73826154,40785787,"DDC UPK CENTER @143RD STREET - QUEENS","14-45 143rd Street"
1,1,0,"6741e65b-31f4-ea11-b882-24ee9a37d45c","N.Y.C. Museum School - M414 - M070 - 02M414 - 333 WEST  17 STREET","defab455-31f4-ea11-b882-24ee9a37d45c",-74002222,40742512,"I.S. 70 - MANHATTAN","333 WEST  17 STREET"
1,1,0,"d611f898-32f4-ea11-b882-24ee9a37d45c","Renaissance Charter School - Q705 - Q885 - 84Q705 - 35-59 81ST STREET","d511f898-32f4-ea11-b882-24ee9a37d45c",-73884817,40749934,"RENAISSANCE CHARTER SCHOOL - Q","35-59 81ST STREET"
3,1,2,"3bebaa73-30f4-ea11-b882-24ee9a37d45c","P.S. 748 Brooklyn School for Global Scholars - K748 - K163 - 20K748 - 1664 BENSON AVENUE","3cebaa73-30f4-ea11-b882-24ee9a37d45c",-74007469,40606739,"P.S. 163 - BROOKLYN","1664 BENSON AVENUE"
1,0,1,"1de85c61-30f4-ea11-b882-24ee9a37d45c","Achievement First East New York Charter School - K358 - K111 - 84K358 - 35 STARR STREET","18e85c61-30f4-ea11-b882-24ee9a37d45c",-73927938,40700810,"I.S. 111 - BROOKLYN","35 STARR STREET"
2,0,2,"d03159fa-30f4-ea11-b882-24ee9a37d45c","Sunset Park High School - K667 - K564 - 15K667 - 153 35TH STREET","18fc3df4-30f4-ea11-b882-24ee9a37d45c",-74004342,40655583,"SUNSET PARK HS - BROOKLYN","153 35TH STREET"
2,2,0,"7c8d8486-31f4-ea11-b882-24ee9a37d45c","P.S. 197 John B. Russwurm - M197 - M197 - 05M197 - 2230 5 AVENUE","7b8d8486-31f4-ea11-b882-24ee9a37d45c",-73938347,40813532,"P.S. 197 - MANHATTAN","2230 5 AVENUE"
2,1,1,"2b7becf3-49fb-ea11-b883-24ee9a37d459","GUILD PRESCHOOL - KBAI - KBAI -  - 1273 57TH STREET","2c7becf3-49fb-ea11-b883-24ee9a37d459",-73996847,40630871,"GUILD FOR EXCEPTIONAL CHILDREN","1273 57TH STREET"
3,3,0,"98a9d9c3-32f4-ea11-b882-24ee9a37d45c","P.S. 39 Francis J. Murphy Jr. - R039 - R039 - 31R039 - 99 Macfarland Avenue","99a9d9c3-32f4-ea11-b882-24ee9a37d45c",-74070610,40597824,"P.S. 39 - STATEN ISLAND","99 Macfarland Avenue"
2,2,0,"db315367-30f4-ea11-b882-24ee9a37d45c","P.S. 132 The Conselyea School - K132 - K132 - 14K132 - 320 MANHATTAN AVENUE","dc315367-30f4-ea11-b882-24ee9a37d45c",-73945663,40714772,"P.S. 132 - BROOKLYN","320 MANHATTAN AVENUE"
1,1,0,"1ae2abc9-30f4-ea11-b882-24ee9a37d45c","P.S. 380 John Wayne Elementary - K380 - K380 - 14K380 - 370 MARCY AVENUE","19e2abc9-30f4-ea11-b882-24ee9a37d45c",-73953702,40701790,"P.S. 380 - BROOKLYN","370 MARCY AVENUE"
2,0,2,"72f4a0ef-eaf6-ea11-b883-24ee9a37d459","P.S. K369 - Coy L. Cox School - K369 - K369 - 75K369 - 383 STATE STREET","03e2abc9-30f4-ea11-b882-24ee9a37d45c",-73983312,40687432,"P.S. 369 (COY COX SCHOOL)-K","383 STATE STREET"
3,1,2,"d8e13320-ebf6-ea11-b883-24ee9a37d459","P.S. K077 - K077 - K164 - 75K077 - 4211 14 AVENUE","36ebaa73-30f4-ea11-b882-24ee9a37d45c",-73985739,40637101,"P.S. 164 - BROOKLYN","4211 14 AVENUE"
1,0,1,"16a198c3-30f4-ea11-b882-24ee9a37d45c","P.S./I.S. 30 Mary White Ovington - K030 - K331 - 20K030 - 7002 4TH AVENUE","15a198c3-30f4-ea11-b882-24ee9a37d45c",-74023950,40633598,"P.S./I.S.30 MARY WHITE OVINGTON - BROOKLYN","7002 4TH AVENUE"
1,0,1,"0d8bc007-ebf6-ea11-b883-24ee9a37d459","Passages Academy - X695 - X991 - 79X695 - 560 BROOK AVENUE","0178bb9f-33f4-ea11-b882-24ee9a37d45c",-73913386,40814614,"PASSAGES ACADEMY(HORIZON) - BRONX","560 BROOK AVENUE"
2,2,0,"29e61462-31f4-ea11-b882-24ee9a37d45c","P.S. 89 - M089 - M089 - 02M089 - 201 WARREN STREET","9741e65b-31f4-ea11-b882-24ee9a37d45c",-74013967,40717010,"P.S./I.S. 89 - MANHATTAN","201 WARREN STREET"
3,2,1,"7107e99e-31f4-ea11-b882-24ee9a37d45c","Fiorello H. LaGuardia High School of Music & Art and Performing Arts - M485 - M485 - 03M485 - 100 Amsterdam Avenue","7207e99e-31f4-ea11-b882-24ee9a37d45c",-73985976,40774202,"FIORELLO LAGUARDIA HS - MANHATTAN","100 Amsterdam Avenue"
1,0,1,"18f32ce2-31f4-ea11-b882-24ee9a37d45c","P.S. 019 Marino Jeantet - Q019 - Q019 - 24Q019 - 98-02 ROOSEVELT AVENUE","19f32ce2-31f4-ea11-b882-24ee9a37d45c",-73866557,40748600,"P.S. 19 - QUEENS","98-02 ROOSEVELT AVENUE"
1,1,0,"0ff32ce2-31f4-ea11-b882-24ee9a37d45c","P.S. 017 Henry David Thoreau - Q017 - Q017 - 30Q017 - 28-37 29 STREET","0af32ce2-31f4-ea11-b882-24ee9a37d45c",-73922544,40768034,"P.S. 17 - QUEENS","28-37 29 STREET"
2,1,1,"6e36d900-33f4-ea11-b882-24ee9a37d45c","P.S. 056 Norwood Heights - X056 - X056 - 10X056 - 341 EAST 207 STREET","6f36d900-33f4-ea11-b882-24ee9a37d45c",-73874912,40875481,"P.S. 56 - BRONX","341 EAST 207 STREET"
7,1,6,"ded27c6d-30f4-ea11-b882-24ee9a37d45c","P.S. 373 - Brooklyn Transition Center - K373 - K148 - 75K373 - 185 ELLERY STREET","dcd27c6d-30f4-ea11-b882-24ee9a37d45c",-73945211,40699214,"P.S. 373 (OLD P148) - BROOKLYN","185 ELLERY STREET"
4,2,2,"585bc58c-30f4-ea11-b882-24ee9a37d45c","P.S. 217 Colonel David Marcus School - K217 - K217 - 22K217 - 1100 NEWKIRK AVENUE","545bc58c-30f4-ea11-b882-24ee9a37d45c",-73966442,40633482,"P.S. 217 - BROOKLYN","1100 NEWKIRK AVENUE"
19,17,2,"435b4cd6-32f4-ea11-b882-24ee9a37d45c","New Dorp High School - R440 - R435 - 31R440 - 465 NEW DORP LANE","fb8521d0-32f4-ea11-b882-24ee9a37d45c",-74105878,40570909,"NEW DORP HS (NEW) - S. I.","465 NEW DORP LANE"
1,1,0,"47fdc1bd-32f4-ea11-b882-24ee9a37d45c","P.S. 8 Shirlee Solomon - R008 - R008 - 31R008 - 112 LINDENWOOD ROAD","48fdc1bd-32f4-ea11-b882-24ee9a37d45c",-74152212,40547567,"P.S. 8 - STATEN ISLAND","112 LINDENWOOD ROAD"
1,1,0,"7dc280bd-31f4-ea11-b882-24ee9a37d45c","Manhattan Village Academy - M439 - M873 - 02M439 - 43 WEST  22 STREET","7ec280bd-31f4-ea11-b882-24ee9a37d45c",-73991966,40741963,"MANHATTAN VILLAGE ACADEMY - M","43 WEST  22 STREET"
3,1,2,"bc315367-30f4-ea11-b882-24ee9a37d45c","P.S. 121 Nelson A. Rockefeller - K121 - K121 - 21K121 - 5301 20 AVENUE","bd315367-30f4-ea11-b882-24ee9a37d45c",-73978472,40622671,"P.S. 121 - BROOKLYN","5301 20 AVENUE"
2,2,0,"7c0e6e25-32f4-ea11-b882-24ee9a37d45c","I.S. 250 The Robert F. Kennedy Community Middle School - Q250 - Q168 - 25Q250 - 158-40 76 ROAD","099c4c1f-32f4-ea11-b882-24ee9a37d45c",-73809380,40724195,"J.H.S. 168 - QUEENS","158-40 76 ROAD"
3,1,2,"9c28a20c-31f4-ea11-b882-24ee9a37d45c","Khalil Gibran International Academy - K592 - K806 - 15K592 - 362 SCHERMERHORN STREET","9d28a20c-31f4-ea11-b882-24ee9a37d45c",-73979829,40686147,"METROPOLITAN CORPORATE ACAD. - K","362 SCHERMERHORN STREET"
5,3,2,"e7201dab-30f4-ea11-b882-24ee9a37d45c","J.H.S. 278 Marine Park - K278 - K278 - 22K278 - 1925 STUART STREET","e8201dab-30f4-ea11-b882-24ee9a37d45c",-73938721,40606745,"I.S. 278 - BROOKLYN","1925 STUART STREET"
1,0,1,"21e85c61-30f4-ea11-b882-24ee9a37d45c","P.S. 112 Lefferts Park - K112 - K112 - 20K112 - 7115 15 AVENUE","22e85c61-30f4-ea11-b882-24ee9a37d45c",-74000565,40619417,"P.S. 112 - BROOKLYN","7115 15 AVENUE"
2,2,0,"e5ce496e-31f4-ea11-b882-24ee9a37d45c","P.S. 123 Mahalia Jackson - M123 - M123 - 05M123 - 301 WEST 140 STREET","e3ce496e-31f4-ea11-b882-24ee9a37d45c",-73944551,40820216,"P.S. 123 - MANHATTAN","301 WEST 140 STREET"
1,1,0,"ffe1abc9-30f4-ea11-b882-24ee9a37d45c","I.S. 392 - K392 - K356 - 23K392 - 104 SUTTER AVENUE","35a198c3-30f4-ea11-b882-24ee9a37d45c",-73917880,40665553,"P.S. 156 - BROOKLYN","104 SUTTER AVENUE"
1,0,1,"2abc749d-4afb-ea11-b883-24ee9a37d459","HARRIET TUBMAN SHELTERING ARM - XBBK - XBBK -  - 565 Morris Avenue","2bbc749d-4afb-ea11-b883-24ee9a37d459",-73923722,40818097,"HARRIET TUBMAN SHELTERING ARM","565 Morris Avenue"
3,2,1,"9669c231-32f4-ea11-b882-24ee9a37d45c","P.S. 201 The Discovery School for Inquiry and Research - Q201 - Q201 - 25Q201 - 65-11 155 STREET","9769c231-32f4-ea11-b882-24ee9a37d45c",-73813011,40736541,"P.S. 201 - QUEENS","65-11 155 STREET"
1,0,1,"c38442ee-31f4-ea11-b882-24ee9a37d45c","The Jermaine L. Green STEM Institute of Queens - Q354 - Q030 - 28Q354 - 126-10 BEDELL STREET","c48442ee-31f4-ea11-b882-24ee9a37d45c",-73774668,40679843,"P.S. 30 - QUEENS","126-10 BEDELL STREET"
1,1,0,"d58a0044-33f4-ea11-b882-24ee9a37d45c","Women's Academy of Excellence - X282 - X174 - 08X282 - 456 WHITE PLAINS ROAD","2a2ed53d-33f4-ea11-b882-24ee9a37d45c",-73856070,40815043,"I.S. 174 - BRONX","456 WHITE PLAINS ROAD"
3,3,0,"a672c880-32f4-ea11-b882-24ee9a37d45c","Queens Metropolitan High School - Q686 - Q686 - 28Q686 - 91-30 METROPOLITAN AVENUE","a372c880-32f4-ea11-b882-24ee9a37d45c",-73855543,40708431,"METROPOLITAN AVENUE CAMPUS - QUEENS","91-30 METROPOLITAN AVENUE"
1,0,1,"dd968d36-30f4-ea11-b882-24ee9a37d45c","P.S. 021 Crispus Attucks - K021 - K021 - 16K021 - 180 CHAUNCEY STREET","dc968d36-30f4-ea11-b882-24ee9a37d45c",-73926673,40680350,"P.S. 21 - BROOKLYN","180 CHAUNCEY STREET"
6,4,2,"a132c3fb-eaf6-ea11-b883-24ee9a37d459","P.S. 085 Judge Charles Vallone - Q085 - Q085 - 30Q085 - 23-70 31 STREET","0a7eed06-32f4-ea11-b882-24ee9a37d45c",-73915039,40773126,"P.S. 85 - QUEENS","23-70 31 STREET"
4,1,3,"e7968d36-30f4-ea11-b882-24ee9a37d45c","P.S. 023 Carter G. Woodson - K023 - K023 - 14K023 - 545 WILLOUGHBY AVENUE","e5968d36-30f4-ea11-b882-24ee9a37d45c",-73947256,40694470,"P.S. 23 - BROOKLYN","545 WILLOUGHBY AVENUE"
3,2,1,"2f06003e-32f4-ea11-b882-24ee9a37d45c","The Active Learning Elementary School - Q244 - Q244 - 25Q244 - 137-20 FRANKLIN AVENUE","2b06003e-32f4-ea11-b882-24ee9a37d45c",-73826192,40754483,"P.S. 244 ECC (@ FRANKLIN AVE) - Q","137-20 FRANKLIN AVENUE"
2,1,1,"1ca6ba98-31f4-ea11-b882-24ee9a37d45c","International High School at Union Square - M438 - M460 - 02M438 - 40 IRVING PLACE","16a6ba98-31f4-ea11-b882-24ee9a37d45c",-73987064,40735361,"WASHINGTON IRVING HS - MANHATTAN","40 IRVING PLACE"
1,1,0,"5c2f77fa-31f4-ea11-b882-24ee9a37d45c","P.S. 060 Woodhaven - Q060 - Q060 - 27Q060 - 91-02 88 AVENUE","8e8946f4-31f4-ea11-b882-24ee9a37d45c",-73852792,40691467,"P.S. 60 - QUEENS","91-02 88 AVENUE"
2,0,2,"84f4a0ef-eaf6-ea11-b883-24ee9a37d459","The Joan Snow Pre-K Center - K853 - K765 - 22K853 - 1139 Coney Island Avenue","4f2f7d06-31f4-ea11-b882-24ee9a37d45c",-73966208,40630109,"PRE-K CENTER @1139 CONEY ISLAND AVENUE - BROOKLYN","1139 Coney Island Avenue"
3,3,0,"d90d3c5b-30f4-ea11-b882-24ee9a37d45c","P.S. 102 The Bayview - K102 - K102 - 20K102 - 211 72 STREET","da0d3c5b-30f4-ea11-b882-24ee9a37d45c",-74028758,40634318,"P.S. 102 - BROOKLYN","211 72 STREET"
2,2,0,"907e21a6-ebf6-ea11-b883-24ee9a37d459","P.S./I.S. 78Q - Q078 - Q312 - 30Q078 - 46-08 5TH STREET","cf454b50-32f4-ea11-b882-24ee9a37d45c",-73955145,40747077,"P.S./.IS. 78 - QUEENS","46-08 5TH STREET"
1,1,0,"15fc3df4-30f4-ea11-b882-24ee9a37d45c","District 20 Pre-K Center - K768 - K560 - 20K768 - 550 59 Street","16fc3df4-30f4-ea11-b882-24ee9a37d45c",-74014450,40639394,"PRE-K CENTER @ 550 59 STREET - BROOKLYN","550 59 Street"
4,2,2,"bd0d3c5b-30f4-ea11-b882-24ee9a37d45c","P.S. 094 The Henry Longfellow - K094 - K094 - 15K094 - 5010 6 AVENUE","8fd92255-30f4-ea11-b882-24ee9a37d45c",-74008795,40643730,"P.S. 94 - BROOKLYN","5010 6 AVENUE"
2,1,1,"e221d292-30f4-ea11-b882-24ee9a37d45c","P.S. 224 Hale A. Woodruff - K224 - K224 - 19K224 - 757 WORTMAN AVENUE","e121d292-30f4-ea11-b882-24ee9a37d45c",-73866542,40664143,"P.S. 224 - BROOKLYN","757 WORTMAN AVENUE"
2,0,2,"cfc88e4f-31f4-ea11-b882-24ee9a37d45c","47 The American Sign Language and English Secondary School - M047 - M047 - 02M047 - 223 EAST 23 STREET","d0c88e4f-31f4-ea11-b882-24ee9a37d45c",-73981329,40738374,"J.H.S. 47 (SCH FOR THE DEAF) - M","223 EAST 23 STREET"
3,2,1,"d38521d0-32f4-ea11-b882-24ee9a37d45c","The Kathleen Grimm School for Leadership and Sustainability - R062 - R062 - 31R062 - 644 Bloomingdale Road","d48521d0-32f4-ea11-b882-24ee9a37d45c",-74217934,40541563,"K.GRIMM SCL FOR LDRSHP&SUSTAINABLTY@SANDY GR -S.I.","644 Bloomingdale Road"
1,1,0,"0fc73b4a-32f4-ea11-b882-24ee9a37d45c","P.S. 273 - Q273 - Q273 - 27Q273 - 88-07 102ND STREET","10c73b4a-32f4-ea11-b882-24ee9a37d45c",-73844335,40693613,"P.S. 273 - QUEENS","88-07 102ND STREET"
2,1,1,"e68a0044-33f4-ea11-b882-24ee9a37d45c","I.S. 181 Pablo Casals - X181 - X181 - 11X181 - 800 BAYCHESTER AVENUE","e78a0044-33f4-ea11-b882-24ee9a37d45c",-73831669,40874035,"I.S. 181 - BRONX","800 BAYCHESTER AVENUE"
2,2,0,"62a5db98-30f4-ea11-b882-24ee9a37d45c","Brooklyn School of Inquiry - K686 - K237 - 20K686 - 50 AVENUE P","5fa5db98-30f4-ea11-b882-24ee9a37d45c",-73986678,40606994,"LUCRETIA MARCIGLIANO CAMPUS - K","50 AVENUE P"
1,0,1,"b948b1f5-eaf6-ea11-b883-24ee9a37d459","P.S. M721 - Manhattan Occupational Training Center - M721 - M641 - 75M721 - 250 West Houston Street","4d0c1bb1-31f4-ea11-b882-24ee9a37d45c",-74006155,40729052,"CITY-AS-SCHOOL(OLD 95) - MANHATTAN","16 Clarkson Street"
3,3,0,"fc454b50-32f4-ea11-b882-24ee9a37d45c","College Point Collaborative - Q379 - Q336 - 25Q379 - 12406 14TH AVENUE","fd454b50-32f4-ea11-b882-24ee9a37d45c",-73843504,40785129,"The College Point Collaborative Educational Buildi","12406 14TH AVENUE"
1,0,1,"11f32ce2-31f4-ea11-b882-24ee9a37d45c","The 30th Avenue School (G&T Citywide) - Q300 - Q017 - 30Q300 - 28-37 29 STREET","0af32ce2-31f4-ea11-b882-24ee9a37d45c",-73922544,40768034,"P.S. 17 - QUEENS","28-37 29 STREET"
2,2,0,"f0f22ce2-31f4-ea11-b882-24ee9a37d45c","York Early College Academy - Q284 - Q008 - 28Q284 - 108-35 167 STREET","f1f22ce2-31f4-ea11-b882-24ee9a37d45c",-73786403,40696910,"J.H.S. 8 - QUEENS","108-35 167 STREET"
2,2,0,"370410ca-32f4-ea11-b882-24ee9a37d45c","P.S. 054 Charles W. Leng - R054 - R054 - 31R054 - 1060 WILLOWBROOK ROAD","380410ca-32f4-ea11-b882-24ee9a37d45c",-74137259,40602779,"P.S. 54 - STATEN ISLAND","1060 WILLOWBROOK ROAD"
1,0,1,"11eabc42-30f4-ea11-b882-24ee9a37d45c","P.S. 046 Edward C. Blum - K046 - K046 - 13K046 - 100 CLERMONT AVENUE","1a1bad3c-30f4-ea11-b882-24ee9a37d45c",-73971644,40694530,"P.S. 46 - BROOKLYN","100 CLERMONT AVENUE"
1,1,0,"409f4974-31f4-ea11-b882-24ee9a37d45c","J.H.S. 143 Eleanor Roosevelt - M143 - M143 - 06M143 - 511 WEST 182ND STREET","3f9f4974-31f4-ea11-b882-24ee9a37d45c",-73930991,40849311,"I.S. 143 - MANHATTAN","511 WEST 182ND STREET"
1,0,1,"26e0d393-ebf6-ea11-b883-24ee9a37d459","P.S. Q233 - Q233 - Q134 - 75Q233 - 203-02 109 Avenue","10af0313-32f4-ea11-b882-24ee9a37d45c",-73754747,40707535,"P.S. 134 - QUEENS","203-02 109 Avenue"
2,2,0,"91e657bd-30f4-ea11-b882-24ee9a37d45c","P.S. 506: The School of Journalism & Technology - K506 - K314 - 20K506 - 330 59 Street","8ee657bd-30f4-ea11-b882-24ee9a37d45c",-74019299,40641950,"P.S. 314 - BROOKLYN","330 59 Street"
7,0,7,"512b3eee-30f4-ea11-b882-24ee9a37d45c","Fort Hamilton High School - K490 - K490 - 20K490 - 8301 SHORE ROAD","522b3eee-30f4-ea11-b882-24ee9a37d45c",-74038103,40626827,"FORT HAMILTON HS - K","8301 SHORE ROAD"
3,3,0,"8ca9d9c3-32f4-ea11-b882-24ee9a37d45c","P.S. 35 The Clove Valley School - R035 - R035 - 31R035 - 60 FOOTE AVENUE","8da9d9c3-32f4-ea11-b882-24ee9a37d45c",-74098994,40613548,"P.S. 35 - STATEN ISLAND","60 FOOTE AVENUE"
1,1,0,"89977d2b-32f4-ea11-b882-24ee9a37d45c","J.H.S. 194 William Carr - Q194 - Q194 - 25Q194 - 154-60 17 AVENUE","8a977d2b-32f4-ea11-b882-24ee9a37d45c",-73806990,40783231,"J.H.S. 194 - QUEENS","154-60 17 AVENUE"
3,3,0,"e60d3c5b-30f4-ea11-b882-24ee9a37d45c","P.S. 107 John W. Kimball - K107 - K107 - 15K107 - 1301 8 AVENUE","e70d3c5b-30f4-ea11-b882-24ee9a37d45c",-73981181,40662945,"P.S. 107 - BROOKLYN","1301 8 AVENUE"
2,1,1,"35005d7a-31f4-ea11-b882-24ee9a37d45c","P.S. 166 The Richard Rodgers School of The Arts and Technology - M166 - M166 - 03M166 - 132 WEST  89 STREET","36005d7a-31f4-ea11-b882-24ee9a37d45c",-73972557,40788925,"P.S. 166 - MANHATTAN","132 WEST  89 STREET"
1,1,0,"69d92255-30f4-ea11-b882-24ee9a37d45c","P.S. 081 Thaddeus Stevens - K081 - K081 - 16K081 - 990 DEKALB AVENUE","9303194f-30f4-ea11-b882-24ee9a37d45c",-73935123,40692866,"P.S. 81 - BROOKLYN","990 DEKALB AVENUE"
1,0,1,"ddfab455-31f4-ea11-b882-24ee9a37d45c","N.Y.C. Lab School for Collaborative Studies - M412 - M070 - 02M412 - 333 WEST  17 STREET","defab455-31f4-ea11-b882-24ee9a37d45c",-74002222,40742512,"I.S. 70 - MANHATTAN","333 WEST  17 STREET"
3,2,1,"b669c231-32f4-ea11-b882-24ee9a37d45c","P.S. 209 Clearview Gardens - Q209 - Q209 - 25Q209 - 16-10 Utopia Parkway","b569c231-32f4-ea11-b882-24ee9a37d45c",-73795845,40783777,"P.S. 209 - QUEENS","16-10 Utopia Parkway"
1,0,1,"dbfab455-31f4-ea11-b882-24ee9a37d45c","Tompkins Square Middle School - M839 - M064 - 01M839 - 600 EAST  6 STREET","d3fab455-31f4-ea11-b882-24ee9a37d45c",-73981597,40723130,"P.S. 64 (OLD 71) - MANHATTAN","600 EAST  6 STREET"
2,1,1,"b9edf392-32f4-ea11-b882-24ee9a37d45c","P.S. 099 Kew Gardens - Q099 - Q866 - 28Q099 - 83-34 Kew Gardens Road","baedf392-32f4-ea11-b882-24ee9a37d45c",-73827276,40709492,"P.S. 99 ANNEX - QUEENS","83-34 Kew Gardens Road"
1,0,1,"f5f22ce2-31f4-ea11-b882-24ee9a37d45c","The Emerson School - Q287 - Q008 - 28Q287 - 108-35 167 STREET","f1f22ce2-31f4-ea11-b882-24ee9a37d45c",-73786403,40696910,"J.H.S. 8 - QUEENS","108-35 167 STREET"
3,3,0,"77a9d9c3-32f4-ea11-b882-24ee9a37d45c","I.S. 027 Anning S. Prall - R027 - R027 - 31R027 - 11 CLOVE LAKE PLACE","78a9d9c3-32f4-ea11-b882-24ee9a37d45c",-74117818,40628291,"I.S. 27 - STATEN ISLAND","11 CLOVE LAKE PLACE"
3,2,1,"469d7c62-33f4-ea11-b882-24ee9a37d45c","Collegiate Institute for Math and Science - X288 - X415 - 11X288 - 925 ASTOR AVENUE","439d7c62-33f4-ea11-b882-24ee9a37d45c",-73860729,40860443,"CHRISTOPHER COLUMBUS HS - X","925 ASTOR AVENUE"
3,2,1,"e8b98b86-30f4-ea11-b882-24ee9a37d45c","M.S. 582 - K582 - K196 - 14K582 - 207 BUSHWICK AVENUE","e9b98b86-30f4-ea11-b882-24ee9a37d45c",-73939385,40708804,"P.S. 196 - BROOKLYN","207 BUSHWICK AVENUE"
1,0,1,"88c1797b-ebf6-ea11-b883-24ee9a37d459","Restart Academy - M973 - MAKG -  - 411 WEST 114 STREET","8a3eb8c9-31f4-ea11-b882-24ee9a37d45c",-73960923,40805305,"CARES","411 WEST 114 STREET"
1,1,0,"1168ee1e-31f4-ea11-b882-24ee9a37d45c","P.S. 373 - Brooklyn Transition Center - K373 - K909 - 75K373 - 561 GRAND AVENUE","1268ee1e-31f4-ea11-b882-24ee9a37d45c",-73961636,40678591,"ACORN COMMUNITY HS - K","561 GRAND AVENUE"
1,0,1,"e621d292-30f4-ea11-b882-24ee9a37d45c","P.S. K225 - The Eileen E. Zaglin - K225 - K225 - 21K225 - 1075 OCEAN VIEW AVENUE","e521d292-30f4-ea11-b882-24ee9a37d45c",-73955856,40580260,"P.S. 225 - BROOKLYN","1075 OCEAN VIEW AVENUE"
3,1,2,"60a5db98-30f4-ea11-b882-24ee9a37d45c","The Academy of Talented Scholars - K682 - K237 - 20K682 - 50 AVENUE P","5fa5db98-30f4-ea11-b882-24ee9a37d45c",-73986678,40606994,"LUCRETIA MARCIGLIANO CAMPUS - K","50 AVENUE P"
2,2,0,"191bad3c-30f4-ea11-b882-24ee9a37d45c","Fort Greene Preparatory Academy - K691 - K046 - 13K691 - 100 CLERMONT AVENUE","1a1bad3c-30f4-ea11-b882-24ee9a37d45c",-73971644,40694530,"P.S. 46 - BROOKLYN","100 CLERMONT AVENUE"
10,6,4,"83e03d56-33f4-ea11-b882-24ee9a37d45c","Morris Academy for Collaborative Studies - X297 - X400 - 09X297 - 1110 BOSTON ROAD","82e03d56-33f4-ea11-b882-24ee9a37d45c",-73903920,40827455,"MORRIS HS - X","1110 BOSTON ROAD"
1,1,0,"76de261e-4afb-ea11-b883-24ee9a37d459","Little Meadow Early Childhood Center - QAKA - QAKA -  - 67-25 188TH STREET","77de261e-4afb-ea11-b883-24ee9a37d459",-73783039,40737697,"LITTLE MEADOW EARLY CHILDHOOD CENTER","67-25 188TH STREET"
10,9,1,"0dba8b86-30f4-ea11-b882-24ee9a37d45c","P.S. 204 Vince Lombardi - K204 - K204 - 20K204 - 8101 15 AVENUE","0eba8b86-30f4-ea11-b882-24ee9a37d45c",-74006137,40613535,"P.S. 204 - BROOKLYN","8101 15 AVENUE"
1,1,0,"dac88e4f-31f4-ea11-b882-24ee9a37d45c","P.S. 048 P.O. Michael J. Buczek - M048 - M048 - 06M048 - 4360-78 BROADWAY","d9c88e4f-31f4-ea11-b882-24ee9a37d45c",-73933629,40853193,"P.S. 48 - MANHATTAN","4360-78 BROADWAY"
2,0,2,"33fe227f-4afb-ea11-b883-24ee9a37d459","The Little Learning Center College Point - QBPN - QBPN -  - 13-21 COLLEGE POINT BOULEVARD","34fe227f-4afb-ea11-b883-24ee9a37d459",-73845440,40786125,"The Little Learning Center College Point","13-21 COLLEGE POINT BOULEVARD"
2,0,2,"81a5db98-30f4-ea11-b882-24ee9a37d45c","P.S. 244 Richard R. Green - K244 - K244 - 18K244 - 5404 TILDEN AVENUE","7fa5db98-30f4-ea11-b882-24ee9a37d45c",-73925592,40647851,"P.S. 244 - BROOKLYN","5404 TILDEN AVENUE"
4,3,1,"7da9d9c3-32f4-ea11-b882-24ee9a37d45c","P.S. 030 Westerleigh - R030 - R030 - 31R030 - 200 Wardwell Avenue","73a9d9c3-32f4-ea11-b882-24ee9a37d45c",-74133080,40618097,"P.S. 30 - STATEN ISLAND","200 Wardwell Avenue"
1,1,0,"ea77bb9f-33f4-ea11-b882-24ee9a37d45c","Bronx Arena High School - X537 - X972 - 08X537 - 1440 Story Avenue","e877bb9f-33f4-ea11-b882-24ee9a37d45c",-73881187,40820486,"SOUNDVIEW EDUCATIONAL CAMPUS - X","1440 Story Avenue"
3,2,1,"16ba8b86-30f4-ea11-b882-24ee9a37d45c","P.S. 207 Elizabeth G. Leary - K207 - K207 - 22K207 - 4011 FILLMORE AVENUE","17ba8b86-30f4-ea11-b882-24ee9a37d45c",-73930485,40613981,"P.S. 207 - BROOKLYN","4011 FILLMORE AVENUE"
2,1,1,"35a6ba98-31f4-ea11-b882-24ee9a37d45c","The Urban Assembly School for Green Careers - M402 - M470 - 03M402 - 145 WEST  84 STREET","33a6ba98-31f4-ea11-b882-24ee9a37d45c",-73974483,40786134,"LOUIS D. BRANDEIS HS - MANHATTAN","145 WEST  84 STREET"
1,1,0,"a2e657bd-30f4-ea11-b882-24ee9a37d45c","P.S. 319 - K319 - K319 - 14K319 - 360 KEAP STREET","a3e657bd-30f4-ea11-b882-24ee9a37d45c",-73953881,40709632,"P.S. 319 - BROOKLYN","360 KEAP STREET"
2,2,0,"579f4974-31f4-ea11-b882-24ee9a37d45c","The William Lynch School - M368 - M153 - 06M368 - 1750 AMSTERDAM AVENUE","589f4974-31f4-ea11-b882-24ee9a37d45c",-73947599,40826514,"P.S. 153 - MANHATTAN","1750 AMSTERDAM AVENUE"
1,1,0,"24a198c3-30f4-ea11-b882-24ee9a37d45c","The Brooklyn Green School - K898 - K335 - 16K898 - 130 Rochester Avenue","1ea198c3-30f4-ea11-b882-24ee9a37d45c",-73928673,40674491,"P.S. 335 - BROOKLYN","130 Rochester Avenue"
2,1,1,"1e0410ca-32f4-ea11-b882-24ee9a37d45c","P.S. 045 John Tyler - R045 - R045 - 31R045 - 58 LAWRENCE AVENUE","1f0410ca-32f4-ea11-b882-24ee9a37d45c",-74107537,40628419,"P.S. 45 - STATEN ISLAND","58 LAWRENCE AVENUE"
5,3,2,"9353dd74-33f4-ea11-b882-24ee9a37d45c","Mott Haven Village Preparatory High School - X473 - X470 - 07X473 - 701 ST. ANNS AVENUE","9253dd74-33f4-ea11-b882-24ee9a37d45c",-73911633,40818041,"SOUTH BRONX EDUCATIONAL CAMPUS (OLD 38) - X","701 ST. ANNS AVENUE"
1,0,1,"a5eb6056-32f4-ea11-b882-24ee9a37d45c","District 30 Pre-K Center - Q389 - Q397 - 30Q389 - 32-52 37th Street","a4eb6056-32f4-ea11-b882-24ee9a37d45c",-73920948,40759308,"PRE-K CENTER @37TH STREET - QUEENS","32-52 37th Street"
2,2,0,"a2eb0e7b-33f4-ea11-b882-24ee9a37d45c","Crotona International High School - X524 - X660 - 10X524 - 2474 CROTONA AVENUE","a3eb0e7b-33f4-ea11-b882-24ee9a37d45c",-73882487,40855392,"GRACE H. DODGE VOC HS - X","2474 CROTONA AVENUE"
3,2,1,"b6fab455-31f4-ea11-b882-24ee9a37d45c","University Neighborhood Middle School - M332 - M056 - 01M332 - 220 HENRY STREET","affab455-31f4-ea11-b882-24ee9a37d45c",-73986051,40713362,"J.H.S. 56 - MANHATTAN","220 HENRY STREET"
9,7,2,"eace496e-31f4-ea11-b882-24ee9a37d45c","P.S. 124 Yung Wing - M124 - M124 - 02M124 - 40 DIVISION STREET","e8ce496e-31f4-ea11-b882-24ee9a37d45c",-73996017,40715097,"P.S. 124 (ECF) - MANHATTAN","40 DIVISION STREET"
2,2,0,"19ba8b86-30f4-ea11-b882-24ee9a37d45c","P.S. 208 Elsa Ebeling - K208 - K208 - 18K208 - 4801 AVENUE D","1aba8b86-30f4-ea11-b882-24ee9a37d45c",-73930898,40642700,"P.S. 208 - BROOKLYN","4801 AVENUE D"
2,2,0,"68977d2b-32f4-ea11-b882-24ee9a37d45c","P.S. 186 Castlewood - Q186 - Q186 - 26Q186 - 252-12 72 AVENUE","67977d2b-32f4-ea11-b882-24ee9a37d45c",-73721594,40749556,"P.S. 186 - QUEENS","252-12 72 AVENUE"
9,8,1,"fbfb3df4-30f4-ea11-b882-24ee9a37d45c","Edward R. Murrow High School - K525 - K525 - 21K525 - 1600 AVENUE L","fafb3df4-30f4-ea11-b882-24ee9a37d45c",-73959141,40619671,"EDWARD R. MURROW HS - K","1600 AVENUE L"
9,3,6,"4ba10a44-32f4-ea11-b882-24ee9a37d45c","P.S./I.S. 266 - Q266 - Q266 - 26Q266 - 74-10 COMMONWEALTH BOULEVARD","4aa10a44-32f4-ea11-b882-24ee9a37d45c",-73728415,40746128,"P.S./I.S. 266 - QUEENS","74-10 COMMONWEALTH BOULEVARD"
3,2,1,"039ebaee-32f4-ea11-b882-24ee9a37d45c","P.S. 3 Raul Julia Micro Society - X003 - X003 - 10X003 - 2100 LAFONTAINE AVENUE","049ebaee-32f4-ea11-b882-24ee9a37d45c",-73891630,40850131,"P.S. 3 - BRONX","2100 LAFONTAINE AVENUE"
1,0,1,"1503cefa-32f4-ea11-b882-24ee9a37d45c","P.S. 042 Claremont - X042 - X042 - 09X042 - 1537 WASHINGTON AVENUE","1103cefa-32f4-ea11-b882-24ee9a37d45c",-73903243,40838636,"P.S. 42 - BRONX","1537 WASHINGTON AVENUE"
1,1,0,"7d36d900-33f4-ea11-b882-24ee9a37d45c","E.S.M.T- I.S. 190 - X190 - X061 - 12X190 - 1550 CROTONA PARK EAST","7e36d900-33f4-ea11-b882-24ee9a37d45c",-73892784,40836156,"P.S. 61 - BRONX","1550 CROTONA PARK EAST"
3,2,1,"fdd0de79-30f4-ea11-b882-24ee9a37d45c","P.S. 172 Beacon School of Excellence - K172 - K172 - 15K172 - 825 4 AVENUE","fed0de79-30f4-ea11-b882-24ee9a37d45c",-74000191,40657682,"P.S. 172 - BROOKLYN","825 4 AVENUE"
7,7,0,"dae0838c-31f4-ea11-b882-24ee9a37d45c","M.S. 297 - M297 - M323 - 02M297 - 75 MORTON STREET","d8e0838c-31f4-ea11-b882-24ee9a37d45c",-74007192,40731006,"75 Morton Campus","75 MORTON STREET"
2,2,0,"533cbf01-ebf6-ea11-b883-24ee9a37d459","South Richmond High School I.S./P.S. 25 - R025 - R825 - 75R025 - 6581 HYLAN BOULEVARD","77be7adc-32f4-ea11-b882-24ee9a37d45c",-74218688,40512019,"P.S. 25 (MOUNT LORETTO) - S.I.","6581 HYLAN BOULEVARD"
5,2,3,"f6ce496e-31f4-ea11-b882-24ee9a37d45c","P.S. 126 Jacob August Riis - M126 - M126 - 02M126 - 80 CATHERINE STREET","f4ce496e-31f4-ea11-b882-24ee9a37d45c",-73997420,40710651,"P.S. 126 - MANHATTAN","80 CATHERINE STREET"
1,1,0,"d79b4c1f-32f4-ea11-b882-24ee9a37d45c","P.S. 150 Queens - Q150 - Q150 - 30Q150 - 40-01 43 AVENUE","d89b4c1f-32f4-ea11-b882-24ee9a37d45c",-73923375,40745887,"P.S. 150 - QUEENS","40-01 43 AVENUE"
2,2,0,"ec201dab-30f4-ea11-b882-24ee9a37d45c","Pre-K Center at Bishop Ford School Site - K863 - K280 - 15K863 - 500 19 STREET","ed201dab-30f4-ea11-b882-24ee9a37d45c",-73983116,40656952,"PRE-K CENTER @ 500 19TH STREET - BROOKLYN","500 19 STREET"
3,3,0,"ffbdf08c-32f4-ea11-b882-24ee9a37d45c","Baccalaureate School for Global Education - Q580 - Q798 - 30Q580 - 34-12 36 AVENUE","00bef08c-32f4-ea11-b882-24ee9a37d45c",-73926977,40754975,"BACCALAUREATE SCL FOR GLOBAL ED-Q","34-12 36 AVENUE"
1,1,0,"42a10a44-32f4-ea11-b882-24ee9a37d45c","New York City Academy for Discovery - Q306 - Q262 - 27Q306 - 95-16 89TH AVENUE","43a10a44-32f4-ea11-b882-24ee9a37d45c",-73848577,40691482,"P.S. 262 - QUEENS","95-16 89TH AVENUE"
6,4,2,"29b7c337-32f4-ea11-b882-24ee9a37d45c","I.S. 227 Louis Armstrong - Q227 - Q227 - 30Q227 - 32-02 JUNCTION BOULEVARD","27b7c337-32f4-ea11-b882-24ee9a37d45c",-73874614,40757567,"I.S. 227 - QUEENS","32-02 JUNCTION BOULEVARD"
3,2,1,"a8d810ab-31f4-ea11-b882-24ee9a37d45c","Success Academy Charter School - Hell's Kitchen - M170 - M625 - 84M170 - 439 WEST 49TH STREET","a9d810ab-31f4-ea11-b882-24ee9a37d45c",-73990318,40763655,"HS OF GRAPHIC COMMUNICATION ARTS-M","439 WEST 49TH STREET"
3,2,1,"7534aa92-31f4-ea11-b882-24ee9a37d45c","Isaac Newton Middle School for Math & Science - M825 - M435 - 04M825 - 260 PLEASANT AVENUE","7234aa92-31f4-ea11-b882-24ee9a37d45c",-73932868,40794184,"MANHTN CT FOR MATH & SCI. HS - M","260 PLEASANT AVENUE"
1,0,1,"7841e65b-31f4-ea11-b882-24ee9a37d45c","P.S. M079 - Horan School - M079 - M079 - 75M079 - 55 East 120 Street","7741e65b-31f4-ea11-b882-24ee9a37d45c",-73942009,40802547,"P.S. 79 (MULT. HANDICAP) - M","55 East 120 Street"
1,1,0,"ba8a894e-4afb-ea11-b883-24ee9a37d459","SI YMCA NURSERY - SOUTH - RAGG - RAGG -  - 3939 RICHMOND AVENUE","bb8a894e-4afb-ea11-b883-24ee9a37d459",-74162666,40542316,"SI YMCA NURSERY - SOUTH","3939 RICHMOND AVENUE"
1,0,1,"57ebaa73-30f4-ea11-b882-24ee9a37d45c","Ralph A. Fabrizio School - K170 - K170 - 20K170 - 619 72ND STREET","58ebaa73-30f4-ea11-b882-24ee9a37d45c",-74018719,40630373,"P.S. 170 - BROOKLYN","619 72ND STREET"
1,1,0,"ab9c11e8-30f4-ea11-b882-24ee9a37d45c","School for Human Rights, The - K531 - K470 - 17K531 - 600 KINGSTON AVENUE","aa9c11e8-30f4-ea11-b882-24ee9a37d45c",-73943839,40658671,"GEORGE W. WINGATE HS - K","600 KINGSTON AVENUE"
1,1,0,"552f7d06-31f4-ea11-b882-24ee9a37d45c","P.S. 112 Lefferts Park - K112 - K768 - 20K112 - 7301 15th Avenue","562f7d06-31f4-ea11-b882-24ee9a37d45c",-74001900,40618726,"P.S. 768 - BROOKLYN","7301 15th Avenue"
1,1,0,"367eed06-32f4-ea11-b882-24ee9a37d45c","P.S. 099 Kew Gardens - Q099 - Q099 - 28Q099 - 82-37 KEW GARDENS ROAD","377eed06-32f4-ea11-b882-24ee9a37d45c",-73827722,40711502,"P.S. 99 - QUEENS","82-37 KEW GARDENS ROAD"
1,1,0,"1ca31781-33f4-ea11-b882-24ee9a37d45c","Walkabout Bronx High School - X625 - X790 - 07X625 - 730 CONCOURSE VILLAGE WEST","0ea31781-33f4-ea11-b882-24ee9a37d45c",-73922366,40821828,"MOTT HAVEN EDUCATIONAL CAMPUS - BRONX","730 CONCOURSE VILLAGE WEST"
2,0,2,"fd8ac007-ebf6-ea11-b883-24ee9a37d459","KIPP Freedom Charter School - X598 - X859 - 84X598 - 2246 JEROME AVENUE","a3593c87-33f4-ea11-b882-24ee9a37d45c",-73903764,40857932,"P.S. 315 - BRONX","2246 JEROME AVENUE"
1,1,0,"df11f898-32f4-ea11-b882-24ee9a37d45c","P.S. 360 - Q360 - Q892 - 29Q360 - 199-10 112 AVENUE","e011f898-32f4-ea11-b882-24ee9a37d45c",-73756259,40702329,"P.S. 892 - QUEENS","199-10 112 AVENUE"
1,1,0,"3d0410ca-32f4-ea11-b882-24ee9a37d45c","P.S. 56 The Louis Desario School - R056 - R056 - 31R056 - 250 KRAMER AVENUE","3e0410ca-32f4-ea11-b882-24ee9a37d45c",-74213943,40541856,"P.S. 56 - STATEN ISLAND","250 KRAMER AVENUE"
1,0,1,"369f4974-31f4-ea11-b882-24ee9a37d45c","Manhattan Charter School - M320 - M142 - 84M320 - 100 ATTORNEY STREET","379f4974-31f4-ea11-b882-24ee9a37d45c",-73984116,40718121,"P.S. 142 - MANHATTAN","100 ATTORNEY STREET"
5,3,2,"5e34aa92-31f4-ea11-b882-24ee9a37d45c","The Peck Slip School - M343 - M343 - 02M343 - 1 PECK SLIP","e7e0838c-31f4-ea11-b882-24ee9a37d45c",-74002407,40708774,"THE PECK SLIP SCHOOL - MANHATTAN","1 PECK SLIP"
2,0,2,"762b3eee-30f4-ea11-b882-24ee9a37d45c","Academy for Conservation and the Environment - K637 - K515 - 18K637 - 6565 FLATLANDS AVENUE","6d2b3eee-30f4-ea11-b882-24ee9a37d45c",-73916927,40634451,"SOUTH SHORE EDUCATIONAL CAMPUS - K","6565 FLATLANDS AVENUE"
2,1,1,"96e657bd-30f4-ea11-b882-24ee9a37d45c","P.S. 316 Elijah Stroud - K316 - K316 - 17K316 - 750 CLASSON AVENUE","94e657bd-30f4-ea11-b882-24ee9a37d45c",-73961418,40674685,"P.S. 316 - BROOKLYN","750 CLASSON AVENUE"
3,3,0,"bae0838c-31f4-ea11-b882-24ee9a37d45c","P.S. 234 Independence School - M234 - M234 - 02M234 - 292 GREENWICH STREET","bbe0838c-31f4-ea11-b882-24ee9a37d45c",-74010880,40719530,"P.S. 234 - MANHATTAN","292 GREENWICH STREET"
1,0,1,"4102fdd0-ebf6-ea11-b883-24ee9a37d459","South Richmond High School I.S./P.S. 25 - R025 - R025 - 75R025 - 4210 ARTHUR KILL ROAD","6fa9d9c3-32f4-ea11-b882-24ee9a37d45c",-74236681,40539758,"P.S. 25 ANNEX (OLD 4) - S. I.","4210 ARTHUR KILL ROAD"
1,0,1,"d3968d36-30f4-ea11-b882-24ee9a37d45c","P.S. 018 Edward Bush - K018 - K018 - 14K018 - 101 MAUJER STREET","d4968d36-30f4-ea11-b882-24ee9a37d45c",-73946695,40710880,"P.S. 18 - BROOKLYN","101 MAUJER STREET"
1,0,1,"f22d6c32-ebf6-ea11-b883-24ee9a37d459","P.S. K053 - K053 - K410 - 75K053 - 2800 OCEAN PARKWAY","518dbfcf-30f4-ea11-b882-24ee9a37d45c",-73968733,40582627,"ABRAHAM LINCOLN HS - K","2800 OCEAN PARKWAY"
1,1,0,"e5d27c6d-30f4-ea11-b882-24ee9a37d45c","Brownsville Collegiate Charter School - K710 - K150 - 84K710 - 364 SACKMAN STREET","e6d27c6d-30f4-ea11-b882-24ee9a37d45c",-73905140,40668768,"P.S. 150 - BROOKLYN","364 SACKMAN STREET"
4,3,1,"790e6e25-32f4-ea11-b882-24ee9a37d45c","P.S. 166 Henry Gradstein - Q166 - Q166 - 30Q166 - 33-09 35 AVENUE","7a0e6e25-32f4-ea11-b882-24ee9a37d45c",-73926249,40757497,"P.S. 166 - QUEENS","33-09 35 AVENUE"
10,10,0,"858d8486-31f4-ea11-b882-24ee9a37d45c","P.S. 199 Jessie Isador Straus - M199 - M199 - 03M199 - 270 WEST  70 STREET","868d8486-31f4-ea11-b882-24ee9a37d45c",-73984423,40777603,"P.S. 199 - MANHATTAN","270 WEST  70 STREET"
1,1,0,"3e2f7d06-31f4-ea11-b882-24ee9a37d45c","P.S. 207 Elizabeth G. Leary - K207 - K729 - 22K207 - 3874 Flatlands Avenue","3f2f7d06-31f4-ea11-b882-24ee9a37d45c",-73935842,40619891,"P.S. 207 ANNEX - BROOKLYN","3874 Flatlands Avenue"
2,2,0,"b5ab074a-33f4-ea11-b882-24ee9a37d45c","P.S. 168 - X168 - X194 - 75X168 - 2365 WATERBURY AVENUE","b6ab074a-33f4-ea11-b882-24ee9a37d45c",-73846594,40835410,"P.S./I.S. 194 - BRONX","2365 WATERBURY AVENUE"
3,0,3,"d0ba3c50-33f4-ea11-b882-24ee9a37d45c","Young Voices Academy of the Bronx - X357 - X292 - 11X357 - 800 LYDIG AVENUE","d1ba3c50-33f4-ea11-b882-24ee9a37d45c",-73863733,40854423,"THE DOMINIC CASTORE EDUCATIONAL CAMPUS - BRONX","800 LYDIG AVENUE"
3,3,0,"c70d3c5b-30f4-ea11-b882-24ee9a37d45c","Success Academy Charter School - Bensonhurst - New York 3 - K772 - K096 - 84K772 - 99 AVENUE P","c10d3c5b-30f4-ea11-b882-24ee9a37d45c",-73984985,40608135,"I.S. 96 - BROOKLYN","99 AVENUE P"
1,1,0,"9748b1f5-eaf6-ea11-b883-24ee9a37d459","P.S. 372 -The Children's School - K372 - K834 - 75K372 - 512 CARROLL STREET","fcd7cf12-31f4-ea11-b882-24ee9a37d45c",-73985500,40676198,"P.S. 372 (OUR LADY OF PEACE)-K","512 CARROLL STREET"
4,4,0,"8d41e65b-31f4-ea11-b882-24ee9a37d45c","P.S. 087 William Sherman - M087 - M087 - 03M087 - 160 WEST  78 STREET","8e41e65b-31f4-ea11-b882-24ee9a37d45c",-73978020,40781710,"P.S. 87 - MANHATTAN","160 WEST  78 STREET"
4,1,3,"6934aa92-31f4-ea11-b882-24ee9a37d45c","Success Academy Charter School - Washington Heights - New York 1 - M265 - M387 - 84M265 - 701 Fort Washington Avenue","6a34aa92-31f4-ea11-b882-24ee9a37d45c",-73935231,40857650,"Success Academy - Washington Heights","701 Fort Washington Avenue"
1,0,1,"3b3cbf01-ebf6-ea11-b883-24ee9a37d459","P.S. Q233 - Q233 - Q686 - 75Q233 - 91-30 METROPOLITAN AVENUE","a372c880-32f4-ea11-b882-24ee9a37d45c",-73855543,40708431,"METROPOLITAN AVENUE CAMPUS - QUEENS","91-30 METROPOLITAN AVENUE"
1,1,0,"4fe61462-31f4-ea11-b882-24ee9a37d45c","Success Academy Charter School - Harlem 3 - M385 - M101 - 84M385 - 141 EAST 111 STREET","50e61462-31f4-ea11-b882-24ee9a37d45c",-73944546,40796098,"P.S. 101 - MANHATTAN","141 EAST 111 STREET"
1,1,0,"8a03194f-30f4-ea11-b882-24ee9a37d45c","Success Academy Charter School - Bergen Beach - New York 4 - K781 - K078 - 84K781 - 1420 EAST  68 STREET","8b03194f-30f4-ea11-b882-24ee9a37d45c",-73912914,40620537,"I.S. 78 - BROOKLYN","1420 EAST  68 STREET"
1,0,1,"307eed06-32f4-ea11-b882-24ee9a37d45c","P.S. 097 Forest Park - Q097 - Q097 - 27Q097 - 85-52 85 STREET","317eed06-32f4-ea11-b882-24ee9a37d45c",-73860031,40694232,"P.S. 97 - QUEENS","85-52 85 STREET"
1,0,1,"fb8052e9-ebf6-ea11-b883-24ee9a37d459","P.S. X010 - X010 - X060 - 75X010 - 888 Rev J A Polite Ave","7436d900-33f4-ea11-b882-24ee9a37d45c",-73898399,40820108,"P.S. 333 - BRONX","888 Rev J A Polite Ave"
1,1,0,"299ebaee-32f4-ea11-b882-24ee9a37d45c","P.S. X014 Senator John Calandra - X014 - X014 - 08X014 - 3047 BRUCKNER BOULEVARD","2a9ebaee-32f4-ea11-b882-24ee9a37d45c",-73826277,40835318,"P.S. 14 - BRONX","3047 BRUCKNER BOULEVARD"
1,1,0,"ed3159fa-30f4-ea11-b882-24ee9a37d45c","A-Tech High School - K610 - K610 - 14K610 - 50 BEDFORD AVENUE","ec3159fa-30f4-ea11-b882-24ee9a37d45c",-73953328,40721448,"AUTOMOTIVE TRADES VOC HS - K","50 BEDFORD AVENUE"
1,0,1,"438dbfcf-30f4-ea11-b882-24ee9a37d45c","Life Academy High School for Film and Music - K559 - K400 - 21K559 - 2630 BENSON AVENUE","3a8dbfcf-30f4-ea11-b882-24ee9a37d45c",-73986313,40593028,"Lafayette Educational Campus","2630 BENSON AVENUE"
1,1,0,"8b01ce37-33f4-ea11-b882-24ee9a37d45c","Bronx Latin - X267 - X158 - 12X267 - 800 HOME STREET","8601ce37-33f4-ea11-b882-24ee9a37d45c",-73900593,40826933,"I.S. 158 - BRONX","800 HOME STREET"
2,1,1,"e9968d36-30f4-ea11-b882-24ee9a37d45c","Success Academy Charter School - Bed Stuy 3 - K883 - K025 - 84K883 - 787 LAFAYETTE AVENUE","ea968d36-30f4-ea11-b882-24ee9a37d45c",-73940749,40691472,"P.S. 25 - BROOKLYN","787 LAFAYETTE AVENUE"
1,0,1,"542b3eee-30f4-ea11-b882-24ee9a37d45c","Professional Pathways High School - K630 - K495 - 22K630 - 3000 AVENUE X","552b3eee-30f4-ea11-b882-24ee9a37d45c",-73936635,40593157,"Frank J. Macchiarola Educational Complex","3000 AVENUE X"
2,1,1,"868946f4-31f4-ea11-b882-24ee9a37d45c","Success Academy Charter School - Springfield Gardens - New York 6 - Q339 - Q059 - 84Q339 - 132-55 RIDGEDALE STREET","878946f4-31f4-ea11-b882-24ee9a37d45c",-73752772,40681881,"I.S. 59 - QUEENS","132-55 RIDGEDALE STREET"
2,1,1,"fde1abc9-30f4-ea11-b882-24ee9a37d45c","P.S. 156 Waverly - K156 - K356 - 23K156 - 104 SUTTER AVENUE","35a198c3-30f4-ea11-b882-24ee9a37d45c",-73917880,40665553,"P.S. 156 - BROOKLYN","104 SUTTER AVENUE"
3,2,1,"6be03d56-33f4-ea11-b882-24ee9a37d45c","New World High School - X513 - X362 - 11X513 - 921 EAST 228TH STREET","6ce03d56-33f4-ea11-b882-24ee9a37d45c",-73852714,40888242,"I.S./H.S. 362 - BRONX","921 EAST 228TH STREET"
6,4,2,"b68442ee-31f4-ea11-b882-24ee9a37d45c","P.S. 026 Rufus King - Q026 - Q026 - 26Q026 - 195-02 69 AVENUE","c5fc24e8-31f4-ea11-b882-24ee9a37d45c",-73777607,40735935,"P.S. 26 - QUEENS","195-02 69 AVENUE"
1,1,0,"92283fb1-30f4-ea11-b882-24ee9a37d45c","Success Academy Charter School - Cobble Hill - K129 - K293 - 84K129 - 284 Baltic Street","91283fb1-30f4-ea11-b882-24ee9a37d45c",-73993293,40685006,"J.H.S. 293 - BROOKLYN","284 Baltic Street"
1,0,1,"cf4e3585-4afb-ea11-b883-24ee9a37d459","KIDDIE ACADEMY OF WHITESTONE - QBCT - QBCT -  - 705 152ND STREET","d04e3585-4afb-ea11-b883-24ee9a37d459",-73810407,40794798,"KIDDIE ACADEMY OF WHITESTONE","705 152ND STREET"
2,2,0,"612f77fa-31f4-ea11-b882-24ee9a37d45c","I.S. 061 Leonardo Da Vinci - Q061 - Q061 - 24Q061 - 98-50 50 AVENUE","5f2f77fa-31f4-ea11-b882-24ee9a37d45c",-73862886,40741898,"I.S. 61 - QUEENS","98-50 50 AVENUE"
1,1,0,"81886843-31f4-ea11-b882-24ee9a37d45c","P.S. 003 Charrette School - M003 - M003 - 02M003 - 490 HUDSON STREET","82886843-31f4-ea11-b882-24ee9a37d45c",-74005949,40732603,"P.S. 3 - MANHATTAN","490 HUDSON STREET"
1,1,0,"588dbfcf-30f4-ea11-b882-24ee9a37d45c","Abraham Lincoln High School - K410 - K411 - 21K410 - 2800 OCEAN PARKWAY","598dbfcf-30f4-ea11-b882-24ee9a37d45c",-73968733,40582627,"LINCOLN AF - BROOKLYN","2800 OCEAN PARKWAY"
1,1,0,"8d7eda5c-ebf6-ea11-b883-24ee9a37d459","Success Academy Charter School - Harlem 1 - M351 - M088 - 84M351 - 215 WEST 114 STREET","8841e65b-31f4-ea11-b882-24ee9a37d45c",-73954152,40802610,"I.S. 88 - MANHATTAN","215 WEST 114 STREET"
1,1,0,"92dc32dc-31f4-ea11-b882-24ee9a37d45c","P.S. 002 Alfred Zimberg - Q002 - Q002 - 30Q002 - 75-10 21 Avenue","93dc32dc-31f4-ea11-b882-24ee9a37d45c",-73894108,40769798,"P.S. 2 - QUEENS","75-10 21 Avenue"
1,0,1,"ba72c880-32f4-ea11-b882-24ee9a37d45c","Information Technology High School - Q502 - Q725 - 30Q502 - 21-16 44th Road","b972c880-32f4-ea11-b882-24ee9a37d45c",-73946488,40748502,"HS FOR INFORMATION TECH - QUEENS","21-16 44th Road"
2,1,1,"22eabc42-30f4-ea11-b882-24ee9a37d45c","Success Academy Charter School - Williamsburg - K182 - K050 - 84K182 - 183 SOUTH  3 STREET","1feabc42-30f4-ea11-b882-24ee9a37d45c",-73960137,40711915,"J.H.S. 50 - BROOKLYN","183 SOUTH  3 STREET"
3,2,1,"3aa10a44-32f4-ea11-b882-24ee9a37d45c","P.S. 254 - The Rosa Parks School - Q254 - Q254 - 27Q254 - 84-40 101 STREET","39a10a44-32f4-ea11-b882-24ee9a37d45c",-73847886,40697200,"P.S. 254 - QUEENS","84-40 101 STREET"
3,3,0,"df0d3c5b-30f4-ea11-b882-24ee9a37d45c","P.S. 105 The Blythebourne - K105 - K105 - 20K105 - 1031 59 STREET","e00d3c5b-30f4-ea11-b882-24ee9a37d45c",-74003635,40633320,"P.S. 105 - BROOKLYN","1031 59 STREET"
1,1,0,"f391111a-ebf6-ea11-b883-24ee9a37d459","P.S. 372 -The Children's School - K372 - K113 - 75K372 - 300 ADELPHI STREET","1fe85c61-30f4-ea11-b882-24ee9a37d45c",-73971474,40688769,"I.S. 113 - BROOKLYN","300 ADELPHI STREET"
3,2,1,"e2ce496e-31f4-ea11-b882-24ee9a37d45c","Success Academy Charter School - Harlem 5 - M482 - M123 - 84M482 - 301 WEST 140 STREET","e3ce496e-31f4-ea11-b882-24ee9a37d45c",-73944551,40820216,"P.S. 123 - MANHATTAN","301 WEST 140 STREET"
2,1,1,"6c395a2c-ebf6-ea11-b883-24ee9a37d459","P.S. K369 - Coy L. Cox School - K369 - K313 - 75K369 - 283 ADAMS STREET","82e657bd-30f4-ea11-b882-24ee9a37d45c",-73988323,40694629,"ADAMS STREET EDUCATIONAL CAMPUS - K","283 ADAMS STREET"
3,1,2,"4a005d7a-31f4-ea11-b882-24ee9a37d45c","Success Academy Charter School - Harlem 5 - M482 - M175 - 84M482 - 175 WEST 134 STREET","47005d7a-31f4-ea11-b882-24ee9a37d45c",-73942706,40814388,"P.S. 175 - MANHATTAN","175 WEST 134 STREET"
4,2,2,"c9883319-32f4-ea11-b882-24ee9a37d45c","I.S. 141 The Steinway - Q141 - Q141 - 30Q141 - 37-11 21 AVENUE","ca883319-32f4-ea11-b882-24ee9a37d45c",-73904508,40775766,"I.S. 141 - QUEENS","37-11 21 AVENUE"
1,1,0,"8ba87f90-5a04-ec11-b8b4-24ee9a37d45c","Hunters Point Elementary School - Q384 - Q375 - 30Q384 - 1-35 57 Avenue","8ca87f90-5a04-ec11-b8b4-24ee9a37d45c",-73960836,40738864,"Hunters Point","1-35 57 Avenue"
1,0,1,"aebf14dd-ebf6-ea11-b883-24ee9a37d459","South Richmond High School I.S./P.S. 25 - R025 - R826 - 75R025 - 6581 Hylan Boulevard","7dbe7adc-32f4-ea11-b882-24ee9a37d45c",-74218688,40512019,"P.S. 3 ANNEX - STATEN ISLAND","6581 Hylan Boulevard"
6,6,0,"df8521d0-32f4-ea11-b882-24ee9a37d45c","P.S. 048 William G. Wilcox - R048 - R071 - 31R048 - 1050 Targee Street","db8521d0-32f4-ea11-b882-24ee9a37d45c",-74091239,40603492,"P.S./I.S. 48 - Staten Island","1050 Targee Street"
4,4,0,"8d01ce37-33f4-ea11-b882-24ee9a37d45c","Dr. Richard Izquierdo Health and Science Charter School - X482 - X158 - 84X482 - 800 HOME STREET","8601ce37-33f4-ea11-b882-24ee9a37d45c",-73900593,40826933,"I.S. 158 - BRONX","800 HOME STREET"
3,3,0,"8d83ff9e-30f4-ea11-b882-24ee9a37d45c","P.S. 247 Brooklyn - K247 - K247 - 20K247 - 7000 21 AVENUE","8e83ff9e-30f4-ea11-b882-24ee9a37d45c",-73987195,40612247,"P.S. 247 - BROOKLYN","7000 21 AVENUE"
2,1,1,"1ea6ba98-31f4-ea11-b882-24ee9a37d45c","Union Square Academy for Health Sciences - M533 - M460 - 02M533 - 40 IRVING PLACE","16a6ba98-31f4-ea11-b882-24ee9a37d45c",-73987064,40735361,"WASHINGTON IRVING HS - MANHATTAN","40 IRVING PLACE"
2,1,1,"2b0d6d19-33f4-ea11-b882-24ee9a37d45c","Archer Elementary School - X531 - X102 - 12X531 - 1827 ARCHER STREET","290d6d19-33f4-ea11-b882-24ee9a37d45c",-73866038,40838151,"P.S. 102 - BRONX","1827 ARCHER STREET"
2,1,1,"e8f57030-30f4-ea11-b882-24ee9a37d45c","P.S. 013 Roberto Clemente - K013 - K013 - 19K013 - 557 PENNSYLVANIA AVENUE","e7f57030-30f4-ea11-b882-24ee9a37d45c",-73893328,40664067,"P.S. 13 - BROOKLYN","557 PENNSYLVANIA AVENUE"
1,1,0,"ca8521d0-32f4-ea11-b882-24ee9a37d45c","P.S. 060 Alice Austen - R060 - R060 - 31R060 - 55 Merrill Avenue","cb8521d0-32f4-ea11-b882-24ee9a37d45c",-74162634,40610604,"P.S. 60 - STATEN ISLAND","55 Merrill Avenue"
1,1,0,"186e3d68-31f4-ea11-b882-24ee9a37d45c","P.S. 115 Alexander Humboldt - M115 - M115 - 06M115 - 586 WEST 177 STREET","166e3d68-31f4-ea11-b882-24ee9a37d45c",-73935140,40846116,"P.S. 115 - MANHATTAN","586 WEST 177 STREET"
1,0,1,"b69c11e8-30f4-ea11-b882-24ee9a37d45c","Academy for Excellence in Leadership - K403 - K480 - 32K403 - 400 IRVING AVENUE","b39c11e8-30f4-ea11-b882-24ee9a37d45c",-73911751,40696457,"BUSHWICK EDUCATIONAL CAMPUS - K","400 IRVING AVENUE"
8,7,1,"4c5b4cd6-32f4-ea11-b882-24ee9a37d45c","Staten Island Technical High School - R605 - R440 - 31R605 - 485 CLAWSON STREET","4b5b4cd6-32f4-ea11-b882-24ee9a37d45c",-74117086,40568299,"STATEN ISLAND TECHNICAL HS - S.I.","485 CLAWSON STREET"
2,1,1,"652f7d06-31f4-ea11-b882-24ee9a37d45c","West Brooklyn Community High School - K529 - K781 - 15K529 - 1053 41st Street","662f7d06-31f4-ea11-b882-24ee9a37d45c",-73992151,40642619,"WEST BROOKLYN COMMUNITY HS - K","1053 41st Street"
1,1,0,"6c9d7c62-33f4-ea11-b882-24ee9a37d45c","Bronx Lab School - X265 - X425 - 11X265 - 800 EAST GUN HILL ROAD","699d7c62-33f4-ea11-b882-24ee9a37d45c",-73861649,40875172,"EVANDER CHILDS HS - X","800 EAST GUN HILL ROAD"
1,1,0,"86e657bd-30f4-ea11-b882-24ee9a37d45c","P.S. 312 Bergen Beach - K312 - K312 - 22K312 - 7103 Avenue T","87e657bd-30f4-ea11-b882-24ee9a37d45c",-73909554,40622442,"P.S. 312 - BROOKLYN","7103 Avenue T"
1,0,1,"e377bb9f-33f4-ea11-b882-24ee9a37d45c","Urban Assembly School for Applied Math and Science, The - X241 - X970 - 09X241 - 1595 BATHGATE AVENUE","e177bb9f-33f4-ea11-b882-24ee9a37d45c",-73901774,40839508,"BATHGATE HS - BRONX","1595 BATHGATE AVENUE"
1,0,1,"f32ece86-32f4-ea11-b882-24ee9a37d45c","Queens High School for the Sciences at York College - Q687 - Q774 - 28Q687 - 94-50 159 Street","f42ece86-32f4-ea11-b882-24ee9a37d45c",-73798364,40700884,"QUEENS HIGH SCHOOL FOR THE SCIENCES","94-50 159 Street"
1,0,1,"f48052e9-ebf6-ea11-b883-24ee9a37d459","Success Academy Charter School - Bronx 3 - X380 - X039 - 84X380 - 965 LONGWOOD AVENUE","0203cefa-32f4-ea11-b882-24ee9a37d45c",-73897876,40817741,"NEW SCH FOR ARTS AND SCIENCE - X","965 LONGWOOD AVENUE"
2,2,0,"0b06003e-32f4-ea11-b882-24ee9a37d45c","Community Voices Middle School - Q356 - Q231 - 29Q356 - 145-00 SPRINGFIELD BOULEVARD","0c06003e-32f4-ea11-b882-24ee9a37d45c",-73759396,40664809,"I.S. 231 (TANDEM Q251) - QUEENS","145-00 SPRINGFIELD BOULEVARD"
9,9,0,"e38521d0-32f4-ea11-b882-24ee9a37d45c","I.S. 072 Rocco Laurie - R072 - R072 - 31R072 - 33 FERNDALE AVENUE","e48521d0-32f4-ea11-b882-24ee9a37d45c",-74158618,40592132,"I.S. 72 - STATEN ISLAND","33 FERNDALE AVENUE"
2,2,0,"12a6ba98-31f4-ea11-b882-24ee9a37d45c","Liberty High School Academy for Newcomers - M550 - M451 - 02M550 - 250 WEST  18 STREET","13a6ba98-31f4-ea11-b882-24ee9a37d45c",-74000238,40741820,"LIBERTY HS - MANHATTAN","250 WEST  18 STREET"
1,1,0,"bf92e6d5-30f4-ea11-b882-24ee9a37d45c","It Takes a Village Academy - K563 - K415 - 18K563 - 5800 TILDEN AVENUE","5b8dbfcf-30f4-ea11-b882-24ee9a37d45c",-73922212,40647728,"SAMUEL J. TILDEN EDUCATIONAL CAMPUS - K","5800 TILDEN AVENUE"
1,1,0,"bd692af7-e8fe-eb11-b8b2-24ee9a37d45c","Sequence For Cidz Inc. - MBWU - MAYD -  - 410 SAINT NICHOLAS AVENUE","386ce65b-49fb-ea11-b883-24ee9a37d459",-73949170,40813829,"410 SAINT NICHOLAS AVENUE","410 SAINT NICHOLAS AVENUE"
1,1,0,"f6ae0313-32f4-ea11-b882-24ee9a37d45c","P.S. 123 - Q123 - Q123 - 27Q123 - 145-01 119 AVENUE","f7ae0313-32f4-ea11-b882-24ee9a37d45c",-73795571,40678913,"P.S. 123 - QUEENS","145-01 119 AVENUE"
1,0,1,"e0d10307-33f4-ea11-b882-24ee9a37d45c","P.S. 066 School of Higher Expectations - X066 - X066 - 12X066 - 1001 JENNINGS STREET","ded10307-33f4-ea11-b882-24ee9a37d45c",-73886540,40831493,"P.S. 66 - BRONX","1001 JENNINGS STREET"
6,4,2,"90bc9674-32f4-ea11-b882-24ee9a37d45c","Hillcrest High School - Q505 - Q505 - 28Q505 - 160-05 HIGHLAND AVENUE","8fbc9674-32f4-ea11-b882-24ee9a37d45c",-73803001,40709461,"HILLCREST HS - Q","160-05 HIGHLAND AVENUE"
1,0,1,"07ba8b86-30f4-ea11-b882-24ee9a37d45c","Explore Empower Charter School - K742 - K210 - 84K742 - 188 ROCHESTER AVENUE","08ba8b86-30f4-ea11-b882-24ee9a37d45c",-73928917,40672710,"I.S. 394 - BROOKLYN","188 ROCHESTER AVENUE"
1,0,1,"9383ff9e-30f4-ea11-b882-24ee9a37d45c","P.S. 250 George H. Lindsay - K250 - K250 - 14K250 - 108 MONTROSE AVENUE","9483ff9e-30f4-ea11-b882-24ee9a37d45c",-73945659,40706708,"P.S. 250 - BROOKLYN","108 MONTROSE AVENUE"
2,2,0,"e217b7f4-32f4-ea11-b882-24ee9a37d45c","J.H.S. 022 Jordan L. Mott - X022 - X022 - 09X022 - 270 EAST 167 STREET","de17b7f4-32f4-ea11-b882-24ee9a37d45c",-73914350,40832022,"I.S. 22 - BRONX","270 EAST 167 STREET"
8,3,5,"b9b66262-32f4-ea11-b882-24ee9a37d45c","John Bowne High School - Q425 - Q425 - 25Q425 - 63-25 MAIN STREET","bab66262-32f4-ea11-b882-24ee9a37d45c",-73823841,40737448,"JOHN BOWNE HS - QUEENS","63-25 MAIN STREET"
2,0,2,"68dc32dc-31f4-ea11-b882-24ee9a37d45c","Success Academy Charter School - Hudson Yards - M358 - MBMO - 84M358 - 500 West 41 Street","dd430bd6-31f4-ea11-b882-24ee9a37d45c",-73996499,40758759,"Hudson Yards","500 West 41 Street"
3,2,1,"87c280bd-31f4-ea11-b882-24ee9a37d45c","Gregorio Luperon High School for Science and Mathematics - M552 - M876 - 06M552 - 501 WEST 165TH STREET","88c280bd-31f4-ea11-b882-24ee9a37d45c",-73938300,40838100,"GREGORIO LUPERON PREP. SCHOOL - M","501 WEST 165TH STREET"
1,0,1,"fa201dab-30f4-ea11-b882-24ee9a37d45c","P.S. 282 Park Slope - K282 - K282 - 13K282 - 180 6 Avenue","f8201dab-30f4-ea11-b882-24ee9a37d45c",-73977983,40676649,"P.S. 282 - BROOKLYN","180 6 Avenue"
2,1,1,"3beabc42-30f4-ea11-b882-24ee9a37d45c","P.S. 056 Lewis H. Latimer - K056 - K056 - 13K056 - 170 GATES AVENUE","39eabc42-30f4-ea11-b882-24ee9a37d45c",-73960536,40684286,"P.S. 56 - BROOKLYN","170 GATES AVENUE"
1,0,1,"3088e6db-30f4-ea11-b882-24ee9a37d45c","Brooklyn Technical High School - K430 - K430 - 13K430 - 29 FT GREENE PLACE","3188e6db-30f4-ea11-b882-24ee9a37d45c",-73976435,40688896,"BROOKLYN TECH HS - K","29 FT GREENE PLACE"
1,0,1,"af32c3fb-eaf6-ea11-b883-24ee9a37d459","Success Academy Charter School - Rosedale - New York 5 - Q337 - Q374 - 84Q337 - 147-65 249th Street","8feb6056-32f4-ea11-b882-24ee9a37d45c",-73738793,40655811,"Success Academy - Rosedale","147-65 249th Street"
1,1,0,"41767649-31f4-ea11-b882-24ee9a37d45c","P.S. 138 - M138 - M033 - 75M138 - 281 9 AVENUE","42767649-31f4-ea11-b882-24ee9a37d45c",-74000238,40749014,"P.S. 33 - MANHATTAN","281 9 AVENUE"
1,1,0,"b18a894e-4afb-ea11-b883-24ee9a37d459","Amalgamated Nursery School - XAAH - XAAH -  - 3980 ORLOFF AVENUE","b28a894e-4afb-ea11-b883-24ee9a37d459",-73891962,40884086,"AMALGAMATED NURSERY SCHOOL","3980 ORLOFF AVENUE"
1,1,0,"980e6e25-32f4-ea11-b882-24ee9a37d45c","P.S. 176 Cambria Heights - Q176 - Q176 - 29Q176 - 120-45 235 Street","990e6e25-32f4-ea11-b882-24ee9a37d45c",-73729226,40684987,"P.S. 176 - QUEENS","120-45 235 Street"
1,0,1,"f92ece86-32f4-ea11-b882-24ee9a37d45c","Success Academy Charter School - South Jamaica - Q374 - Q781 - 84Q374 - 120-27 141st Street","fa2ece86-32f4-ea11-b882-24ee9a37d45c",-73799756,40675626,"John Adams HS Annex - Queens","120-27 141st Street"
1,0,1,"17c73b4a-32f4-ea11-b882-24ee9a37d45c","P.S. 182 Samantha Smith - Q182 - Q277 - 28Q182 - 153-27 88TH AVENUE","15c73b4a-32f4-ea11-b882-24ee9a37d45c",-73803183,40706750,"PS 182 SAMANTHA SMITH - QUEENS","153-27 88TH AVENUE"
2,2,0,"96d810ab-31f4-ea11-b882-24ee9a37d45c","The High School of Fashion Industries - M600 - M600 - 02M600 - 225 WEST  24 STREET","94d810ab-31f4-ea11-b882-24ee9a37d45c",-73996354,40745677,"FASHION INDUSTRIES VOC HS - M","225 WEST  24 STREET"
3,0,3,"1c06003e-32f4-ea11-b882-24ee9a37d45c","I.S. 237 - Q237 - Q237 - 25Q237 - 46-21 COLDEN STREET","1b06003e-32f4-ea11-b882-24ee9a37d45c",-73821402,40749430,"J.H.S. 237 - QUEENS","46-21 COLDEN STREET"
2,0,2,"210410ca-32f4-ea11-b882-24ee9a37d45c","P.S. 046 Albert V. Maniscalco - R046 - R046 - 31R046 - 41 REID AVENUE","220410ca-32f4-ea11-b882-24ee9a37d45c",-74080829,40594455,"P.S. 46 - STATEN ISLAND","41 REID AVENUE"
3,2,1,"06b7c337-32f4-ea11-b882-24ee9a37d45c","J.H.S. 217 Robert A. Van Wyck - Q217 - Q217 - 28Q217 - 85-05 144 STREET","fcb6c337-32f4-ea11-b882-24ee9a37d45c",-73811461,40710384,"I.S. 217 - QUEENS","85-05 144 STREET"
3,2,1,"40b4977a-32f4-ea11-b882-24ee9a37d45c","Queens Technical High School - Q600 - Q600 - 24Q600 - 37-02 47 AVENUE","41b4977a-32f4-ea11-b882-24ee9a37d45c",-73927995,40741658,"QUEENS VOC HS - Q","37-02 47 AVENUE"
1,0,1,"0fa6ba98-31f4-ea11-b882-24ee9a37d45c","University Neighborhood High School - M448 - M446 - 01M448 - 200 Monroe Street","10a6ba98-31f4-ea11-b882-24ee9a37d45c",-73984128,40712269,"UNIVERSITY NEIGHBORHOOD - M","200 Monroe Street"
1,0,1,"953aa668-33f4-ea11-b882-24ee9a37d45c","High School of Computers and Technology - X275 - X425 - 11X275 - 800 EAST GUN HILL ROAD","699d7c62-33f4-ea11-b882-24ee9a37d45c",-73861649,40875172,"EVANDER CHILDS HS - X","800 EAST GUN HILL ROAD"
5,0,5,"e5d10307-33f4-ea11-b882-24ee9a37d45c","P.S. 067 Mohegan School - X067 - X067 - 12X067 - 2024 MOHEGAN AVENUE","e6d10307-33f4-ea11-b882-24ee9a37d45c",-73884192,40843781,"P.S. 67 - BRONX","2024 MOHEGAN AVENUE"
1,1,0,"98edfc72-4afb-ea11-b883-24ee9a37d459","The Learning Experience - Northern Boulevard - QBMZ - QBMZ -  - 215-15 NORTHERN BOULEVARD","99edfc72-4afb-ea11-b883-24ee9a37d459",-73766977,40760593,"The Learning Experience - Northern Boulevard","215-15 NORTHERN BOULEVARD"
1,0,1,"29f92a2a-4afb-ea11-b883-24ee9a37d459","Early Childhood Education Center - KCEB - KBUY -  - 871 50th Street","2af92a2a-4afb-ea11-b883-24ee9a37d459",-74002271,40640264,"BAbove 47","871 50th Street"
1,1,0,"d7fab455-31f4-ea11-b882-24ee9a37d45c","P.S. 064 Robert Simon - M064 - M064 - 01M064 - 600 EAST  6 STREET","d3fab455-31f4-ea11-b882-24ee9a37d45c",-73981597,40723130,"P.S. 64 (OLD 71) - MANHATTAN","600 EAST  6 STREET"
1,1,0,"b3fc24e8-31f4-ea11-b882-24ee9a37d45c","P.S. 022 Thomas Jefferson - Q022 - Q022 - 25Q022 - 153-33 SANFORD AVENUE","b1fc24e8-31f4-ea11-b882-24ee9a37d45c",-73811373,40761744,"P.S. 22 - QUEENS","153-33 SANFORD AVENUE"
1,1,0,"5f323483-e21e-eb11-b885-24ee9a37d45c","The Richmond Pre-K Center - R066 - R112 - 31R066 - 375 Tompkins Avenue","60323483-e21e-eb11-b885-24ee9a37d45c",-74073448,40616793,"3K CENTER @ TOMPKINS AVENUE - STATEN ISLAND","375 Tompkins Avenue"
7,6,1,"d7b66262-32f4-ea11-b882-24ee9a37d45c","William Cullen Bryant High School - Q445 - Q445 - 30Q445 - 48-10 31 AVENUE","d8b66262-32f4-ea11-b882-24ee9a37d45c",-73911165,40757072,"WILLIAM C. BRYANT HS - Q","48-10 31 AVENUE"
3,3,0,"1f005d7a-31f4-ea11-b882-24ee9a37d45c","P.S. 158 Bayard Taylor - M158 - M158 - 02M158 - 1458 YORK AVENUE","1d005d7a-31f4-ea11-b882-24ee9a37d45c",-73950745,40770215,"P.S. 158 - MANHATTAN","1458 YORK AVENUE"
1,1,0,"80eb0e7b-33f4-ea11-b882-24ee9a37d45c","Icahn Charter School 2 - X378 - X498 - 84X378 - 1640 BRONXDALE AVE","7eeb0e7b-33f4-ea11-b882-24ee9a37d45c",-73857989,40845023,"THE LT. CURTIS MEYRAN AND JOHN BELLEW ED COMPLEX","1640 BRONXDALE AVE"
3,1,2,"72d92255-30f4-ea11-b882-24ee9a37d45c","P.S. 086 The Irvington - K086 - K086 - 32K086 - 220 IRVING AVENUE","71d92255-30f4-ea11-b882-24ee9a37d45c",-73917804,40700595,"P.S. 86 - BROOKLYN","220 IRVING AVENUE"
2,1,1,"68e03d56-33f4-ea11-b882-24ee9a37d45c","P.S. 360 - X360 - X360 - 10X360 - 2880 KINGSBRIDGE TERRACE","69e03d56-33f4-ea11-b882-24ee9a37d45c",-73902214,40874717,"P.S. 360 - BRONX","2880 KINGSBRIDGE TERRACE"
2,1,1,"e1315367-30f4-ea11-b882-24ee9a37d45c","I.S. 136 Charles O. Dewey - K136 - K136 - 15K136 - 4004 4 AVENUE","d6315367-30f4-ea11-b882-24ee9a37d45c",-74007596,40652127,"I.S. 136 - BROOKLYN","4004 4 AVENUE"
1,0,1,"bbfc24e8-31f4-ea11-b882-24ee9a37d45c","P.S. 024 Andrew Jackson - Q024 - Q024 - 25Q024 - 45-57 UNION STREET","b6fc24e8-31f4-ea11-b882-24ee9a37d45c",-73818100,40751972,"P.S. 24 - QUEENS","45-57 UNION STREET"
1,1,0,"db37fba4-31f4-ea11-b882-24ee9a37d45c","Cascades High School - M650 - M510 - 01M650 - 198 Forsyth Street","d737fba4-31f4-ea11-b882-24ee9a37d45c",-73990468,40722415,"FORSYTH HS (AUXSVC-OLD 91) - M","198 Forsyth Street"
1,1,0,"a5edf392-32f4-ea11-b882-24ee9a37d45c","Joseph F. Quinn Intermediate School 77 - Q077 - Q849 - 24Q077 - 976 Seneca Avenue","a4edf392-32f4-ea11-b882-24ee9a37d45c",-73902147,40699101,"I.S. 77 - QUEENS","976 Seneca Avenue"
2,2,0,"22b7c337-32f4-ea11-b882-24ee9a37d45c","Hawtree Creek Middle School - Q297 - Q226 - 27Q297 - 121-10 ROCKAWAY BOULEVARD","1eb7c337-32f4-ea11-b882-24ee9a37d45c",-73816730,40675021,"I.S. 226 - QUEENS","121-10 ROCKAWAY BOULEVARD"
2,1,1,"f1b98b86-30f4-ea11-b882-24ee9a37d45c","P.S. 196 Ten Eyck - K196 - K196 - 14K196 - 207 BUSHWICK AVENUE","e9b98b86-30f4-ea11-b882-24ee9a37d45c",-73939385,40708804,"P.S. 196 - BROOKLYN","207 BUSHWICK AVENUE"
3,3,0,"85e03d56-33f4-ea11-b882-24ee9a37d45c","Bronx International High School - X403 - X400 - 09X403 - 1110 BOSTON ROAD","82e03d56-33f4-ea11-b882-24ee9a37d45c",-73903920,40827455,"MORRIS HS - X","1110 BOSTON ROAD"
2,2,0,"0506003e-32f4-ea11-b882-24ee9a37d45c","P.S. 229 Emanuel Kaplan - Q229 - Q229 - 24Q229 - 67-25 51 ROAD","0106003e-32f4-ea11-b882-24ee9a37d45c",-73897108,40734682,"P.S. 229 - QUEENS","67-25 51 ROAD"
1,1,0,"f677bb9f-33f4-ea11-b882-24ee9a37d45c","P.S. 083 Donald Hertz - X083 - X981 - 11X083 - 1840 BOGART AVENUE","f777bb9f-33f4-ea11-b882-24ee9a37d45c",-73858769,40849176,"P.S. 83 ANNEX - BRONX","1840 BOGART AVENUE"
4,2,2,"2a8dbfcf-30f4-ea11-b882-24ee9a37d45c","P.S. 109 - K109 - K395 - 22K109 - 1001 EAST  45 STREET","2fe2abc9-30f4-ea11-b882-24ee9a37d45c",-73933099,40635842,"P.S./I.S. 395 - BROOKLYN","1001 EAST  45 STREET"
2,2,0,"9601ce37-33f4-ea11-b882-24ee9a37d45c","P.S. 160 Walt Disney - X160 - X160 - 11X160 - 4140 HUTCHINSON RIVER PKWAY EA","9501ce37-33f4-ea11-b882-24ee9a37d45c",-73823816,40864073,"P.S. 160 - BRONX","4140 HUTCHINSON RIVER PKWAY EA"
5,1,4,"56767649-31f4-ea11-b882-24ee9a37d45c","P.S. 042 Benjamin Altman - M042 - M042 - 02M042 - 71 HESTER STREET","51767649-31f4-ea11-b882-24ee9a37d45c",-73990826,40716126,"P.S. 42 - MANHATTAN","71 HESTER STREET"
1,0,1,"ee37fba4-31f4-ea11-b882-24ee9a37d45c","I.S. 528 Bea Fuller Rodgers School - M528 - M528 - 06M528 - 180 WADSWORTH AVENUE","ed37fba4-31f4-ea11-b882-24ee9a37d45c",-73934676,40850683,"I.S. 528 - MANHATTAN","180 WADSWORTH AVENUE"
2,0,2,"abd810ab-31f4-ea11-b882-24ee9a37d45c","Stephen T. Mather Building Arts & Craftsmanship High School - M139 - M625 - 02M139 - 439 WEST 49TH STREET","a9d810ab-31f4-ea11-b882-24ee9a37d45c",-73990318,40763655,"HS OF GRAPHIC COMMUNICATION ARTS-M","439 WEST 49TH STREET"
5,4,1,"686e70b7-31f4-ea11-b882-24ee9a37d45c","West End Secondary School - M291 - M837 - 03M291 - 227-243 West 61st Street","696e70b7-31f4-ea11-b882-24ee9a37d45c",-73988338,40772608,"BEACON HS - MANHATTAN","227-243 West 61st Street"
8,1,7,"f302cefa-32f4-ea11-b882-24ee9a37d45c","P.S. 032 Belmont - X032 - X032 - 10X032 - 690 EAST 183 STREET","f402cefa-32f4-ea11-b882-24ee9a37d45c",-73886220,40851724,"P.S. 32 - BRONX","690 EAST 183 STREET"
1,1,0,"50a5db98-30f4-ea11-b882-24ee9a37d45c","P.S. 233 Langston Hughes - K233 - K233 - 18K233 - 9301 AVENUE B","0a22d292-30f4-ea11-b882-24ee9a37d45c",-73914282,40651642,"P.S. 233 - BROOKLYN","9301 AVENUE B"
1,1,0,"6307e99e-31f4-ea11-b882-24ee9a37d45c","Vanguard High School - M449 - M480 - 02M449 - 317 EAST  67 STREET","6007e99e-31f4-ea11-b882-24ee9a37d45c",-73959777,40765638,"JULIA RICHMAN ED. COMPLEX - M","317 EAST  67 STREET"
2,2,0,"5ade5eb7-30f4-ea11-b882-24ee9a37d45c","P.S. 306 Ethan Allen - K306 - K306 - 19K306 - 970 VERMONT STREET","59de5eb7-30f4-ea11-b882-24ee9a37d45c",-73886620,40655340,"P.S. 306 - BROOKLYN","970 VERMONT STREET"
1,1,0,"4e6e70b7-31f4-ea11-b882-24ee9a37d45c","Community Health Academy of the Heights - M346 - M814 - 06M346 - 504 WEST 158TH STREET","4f6e70b7-31f4-ea11-b882-24ee9a37d45c",-73942074,40833695,"THE COMMUNITY HEALTH ACADEMY OF THE HEIGHTS - M","504 WEST 158TH STREET"
1,1,0,"0f01adc5-83ef-eb11-b8b1-24ee9a37d45c","P.S. Q004 - Q004 - Q070 - 75Q004 - 30-44 43rd Street","7b2f77fa-31f4-ea11-b882-24ee9a37d45c",-73913964,40761762,"P.S. 70 - QUEENS","30-44 43rd Street"
1,1,0,"35ebaa73-30f4-ea11-b882-24ee9a37d45c","P.S. 164 Caesar Rodney - K164 - K164 - 20K164 - 4211 14 AVENUE","36ebaa73-30f4-ea11-b882-24ee9a37d45c",-73985739,40637101,"P.S. 164 - BROOKLYN","4211 14 AVENUE"
2,2,0,"cc92e6d5-30f4-ea11-b882-24ee9a37d45c","Brooklyn Lab School - K639 - K420 - 19K639 - 999 JAMAICA AVENUE","c692e6d5-30f4-ea11-b882-24ee9a37d45c",-73869305,40693002,"FRANKLIN K. LANE HS - K","999 JAMAICA AVENUE"
1,1,0,"d0315367-30f4-ea11-b882-24ee9a37d45c","P.S. 128 Bensonhurst - K128 - K128 - 21K128 - 2075 84 STREET","d1315367-30f4-ea11-b882-24ee9a37d45c",-73995084,40604980,"P.S. 128 (TANDEM BROOKLYN STUDIO)","2075 84 STREET"
1,1,0,"ed207b48-4afb-ea11-b883-24ee9a37d459","Birch Family Services, Inc - MBBI - MADU -  - 554 FORT WASHINGTON AVENUE","ee207b48-4afb-ea11-b883-24ee9a37d459",-73936827,40853755,"HERBERT G. BIRCH ANNEX","554 FORT WASHINGTON AVENUE"
1,0,1,"b9bfa431-33f4-ea11-b882-24ee9a37d45c","Frederick Douglass Academy III Secondary School - X517 - X148 - 09X517 - 3630 THIRD AVENUE","b0bfa431-33f4-ea11-b882-24ee9a37d45c",-73903951,40833493,"I.S. 219 (OLD 148) - BRONX","3630 THIRD AVENUE"
1,0,1,"a02aa42b-33f4-ea11-b882-24ee9a37d45c","P.S. X140 The Eagle School - X140 - X140 - 08X140 - 916 EAGLE AVENUE","9f2aa42b-33f4-ea11-b882-24ee9a37d45c",-73907489,40823318,"P.S. 140 - BRONX","916 EAGLE AVENUE"
6,5,1,"ced27c6d-30f4-ea11-b882-24ee9a37d45c","Brooklyn Collaborative Studies - K448 - K142 - 15K448 - 610 HENRY STREET","cfd27c6d-30f4-ea11-b882-24ee9a37d45c",-74002022,40679462,"J.H.S. 142 - BROOKLYN","610 HENRY STREET"
1,1,0,"30e85c61-30f4-ea11-b882-24ee9a37d45c","P.S. 115 Daniel Mucatel School - K115 - K115 - 18K115 - 1500 EAST  92 STREET","2fe85c61-30f4-ea11-b882-24ee9a37d45c",-73897896,40634861,"P.S. 115 - BROOKLYN","1500 EAST  92 STREET"
1,1,0,"dce8ce00-32f4-ea11-b882-24ee9a37d45c","PS 80  The Thurgood Marshall Magnet School of Multimedia and Communication - Q080 - Q080 - 28Q080 - 171-05 137TH AVENUE","dde8ce00-32f4-ea11-b882-24ee9a37d45c",-73769119,40673483,"P.S. 80 - QUEENS","171-05 137TH AVENUE"
1,0,1,"b13aa668-33f4-ea11-b882-24ee9a37d45c","West Bronx Academy for the Future - X243 - X435 - 10X243 - 500 EAST FORDHAM ROAD","b03aa668-33f4-ea11-b882-24ee9a37d45c",-73888625,40859466,"THEODORE ROOSEVELT EDUCATIONAL CAMPUS - X","500 EAST FORDHAM ROAD"
1,1,0,"dc8521d0-32f4-ea11-b882-24ee9a37d45c","P.S. 069 Daniel D. Tompkins - R069 - R069 - 31R069 - 144 KEATING PLACE","dd8521d0-32f4-ea11-b882-24ee9a37d45c",-74157327,40591480,"P.S. 69 - STATEN ISLAND","144 KEATING PLACE"
1,0,1,"38e61462-31f4-ea11-b882-24ee9a37d45c","P.S. 092 Mary McLeod Bethune - M092 - M092 - 05M092 - 222 WEST 134 STREET","36e61462-31f4-ea11-b882-24ee9a37d45c",-73945838,40814917,"P.S. 92 - MANHATTAN","222 WEST 134 STREET"
7,5,2,"8c72c880-32f4-ea11-b882-24ee9a37d45c","Thomas A. Edison Career and Technical Education High School - Q620 - Q620 - 28Q620 - 165-65 84 AVENUE","49b4977a-32f4-ea11-b882-24ee9a37d45c",-73799692,40716071,"THOMAS A. EDISON VOC HS - Q","165-65 84 AVENUE"
6,6,0,"8cbc9674-32f4-ea11-b882-24ee9a37d45c","The Queens College School for Math, Science and Technology - Q499 - Q499 - 25Q499 - 148-20 REEVES AVENUE","8bbc9674-32f4-ea11-b882-24ee9a37d45c",-73820821,40738599,"P.S./I.S. 499 - QUEENS","148-20 REEVES AVENUE"
1,1,0,"0dd8cf12-31f4-ea11-b882-24ee9a37d45c","P.S. 295 - K295 - K845 - 15K295 - 330 18 STREET","0bd8cf12-31f4-ea11-b882-24ee9a37d45c",-73988743,40660805,"P.S. 295 - BROOKLYN","330 18 STREET"
2,1,1,"f6d10307-33f4-ea11-b882-24ee9a37d45c","P.S. 072 Dr. William Dorney - X072 - X072 - 08X072 - 2951 DEWEY AVENUE","f4d10307-33f4-ea11-b882-24ee9a37d45c",-73818172,40823237,"P.S. 72 - BRONX","2951 DEWEY AVENUE"
2,1,1,"be56635c-33f4-ea11-b882-24ee9a37d45c","Bronx River High School - X349 - X405 - 08X349 - 3000 EAST TREMONT AVENUE","b556635c-33f4-ea11-b882-24ee9a37d45c",-73839583,40839775,"HERBERT H. LEHMAN HS - X","3000 EAST TREMONT AVENUE"
1,1,0,"a153dd74-33f4-ea11-b882-24ee9a37d45c","New Visions Charter High School for Advanced Math and Science - X539 - X475 - 84X539 - 99 TERRACE VIEW AVENUE","9853dd74-33f4-ea11-b882-24ee9a37d45c",-73912686,40877379,"JOHN F. KENNEDY HS - X","99 TERRACE VIEW AVENUE"
1,1,0,"1f7eed06-32f4-ea11-b882-24ee9a37d45c","P.S. 091 Richard Arkwright - Q091 - Q091 - 24Q091 - 68-10 CENTRAL AVE","207eed06-32f4-ea11-b882-24ee9a37d45c",-73883995,40703503,"P.S. 91 - QUEENS","68-10 CENTRAL AVE"
2,2,0,"cf2ff20c-32f4-ea11-b882-24ee9a37d45c","P.S./I.S. 116 William C. Hughley - Q116 - Q116 - 29Q116 - 107-25 WREN PLACE","d02ff20c-32f4-ea11-b882-24ee9a37d45c",-73781839,40700840,"P.S. 116 - QUEENS","107-25 WREN PLACE"
4,4,0,"6dd92255-30f4-ea11-b882-24ee9a37d45c","P.S. 084 Jose De Diego - K084 - K084 - 14K084 - 250 Berry Street","6ed92255-30f4-ea11-b882-24ee9a37d45c",-73963808,40715089,"P.S. 84 - BROOKLYN","250 Berry Street"
2,2,0,"430410ca-32f4-ea11-b882-24ee9a37d45c","Space Shuttle Columbia School - R058 - R058 - 31R058 - 77 MARSH AVENUE","2a0410ca-32f4-ea11-b882-24ee9a37d45c",-74160867,40582791,"P.S. 58 - STATEN ISLAND","77 MARSH AVENUE"
1,1,0,"ef3159fa-30f4-ea11-b882-24ee9a37d45c","District 13 PRE-K Center - K869 - K611 - 13K869 - 19 DOCK STREET","f03159fa-30f4-ea11-b882-24ee9a37d45c",-73992076,40702952,"DOCK ST CAMPUS - BROOKLYN","25 DOCK STREET"
1,1,0,"4f474313-33f4-ea11-b882-24ee9a37d45c","P.S. 100 Isaac Clason - X100 - X100 - 08X100 - 800 TAYLOR AVENUE","50474313-33f4-ea11-b882-24ee9a37d45c",-73862760,40822552,"P.S. 100 - BRONX","800 TAYLOR AVENUE"
1,1,0,"572b3eee-30f4-ea11-b882-24ee9a37d45c","Origins High School - K611 - K495 - 22K611 - 3000 AVENUE X","552b3eee-30f4-ea11-b882-24ee9a37d45c",-73936635,40593157,"Frank J. Macchiarola Educational Complex","3000 AVENUE X"
5,4,1,"d6968d36-30f4-ea11-b882-24ee9a37d45c","Brooklyn Arbor Elementary School - K414 - K019 - 14K414 - 325 SOUTH  3 STREET","d7968d36-30f4-ea11-b882-24ee9a37d45c",-73954678,40710107,"P.S. 19 - BROOKLYN","325 SOUTH  3 STREET"
4,4,0,"782f77fa-31f4-ea11-b882-24ee9a37d45c","P.S. 069 Jackson Heights - Q069 - Q069 - 30Q069 - 77-02 37 AVENUE","682f77fa-31f4-ea11-b882-24ee9a37d45c",-73888457,40748804,"P.S. 69 - QUEENS","77-02 37 AVENUE"
3,0,3,"99d810ab-31f4-ea11-b882-24ee9a37d45c","Chelsea Career and Technical Education High School - M615 - M615 - 02M615 - 131 AVENUE OF THE AMERICAS","9ad810ab-31f4-ea11-b882-24ee9a37d45c",-74005058,40724630,"CHELSEA VOC HS - MANHATTAN","131 AVENUE OF THE AMERICAS"
2,1,1,"9ae657bd-30f4-ea11-b882-24ee9a37d45c","P.S. 133 William A. Butler - K133 - K317 - 13K133 - 610 BALTIC STREET","99e657bd-30f4-ea11-b882-24ee9a37d45c",-73980455,40679916,"P.S. 133 WILLIAM A. BUTLER - BROOKLYN","610 BALTIC STREET"
1,0,1,"ac8fd48d-ebf6-ea11-b883-24ee9a37d459","P.S. Q233 - Q233 - Q042 - 75Q233 - 488 Beach  66 Street","ea8442ee-31f4-ea11-b882-24ee9a37d45c",-73794804,40594358,"P.S. 42 - QUEENS","488 Beach  66 Street"
2,2,0,"5b2b3eee-30f4-ea11-b882-24ee9a37d45c","New Visions Charter High School for the Humanities III - K739 - K495 - 84K739 - 3000 AVENUE X","552b3eee-30f4-ea11-b882-24ee9a37d45c",-73936635,40593157,"Frank J. Macchiarola Educational Complex","3000 AVENUE X"
1,0,1,"d8315367-30f4-ea11-b882-24ee9a37d45c","P.S. 131 Brooklyn - K131 - K131 - 15K131 - 4305 FT HAMILTON PARKWAY","d9315367-30f4-ea11-b882-24ee9a37d45c",-73993247,40640728,"P.S. 131 - BROOKLYN","4305 FT HAMILTON PARKWAY"
1,1,0,"af48b1f5-eaf6-ea11-b883-24ee9a37d459","Democracy Prep Charter School - M350 - M197 - 84M350 - 2230 5 AVENUE","7b8d8486-31f4-ea11-b882-24ee9a37d45c",-73938347,40813532,"P.S. 197 - MANHATTAN","2230 5 AVENUE"
1,0,1,"23ff3d8d-33f4-ea11-b882-24ee9a37d45c","Bronx Leadership Academy High School - X525 - X876 - 09X525 - 1710 Webster Avenue","24ff3d8d-33f4-ea11-b882-24ee9a37d45c",-73902969,40843250,"BRONX LEADERSHIP ACADEMY - BRONX","1710 Webster Avenue"
1,1,0,"434f56b6-80ef-eb11-b8b1-24ee9a37d45c","P.S. 36 - K036 - K208 - 75K036 - 4801 AVENUE D","1aba8b86-30f4-ea11-b882-24ee9a37d45c",-73930898,40642700,"P.S. 208 - BROOKLYN","4801 AVENUE D"
1,1,0,"86886843-31f4-ea11-b882-24ee9a37d45c","M.S. 243 Center School - M243 - M009 - 03M243 - 100 WEST  84 STREET","87886843-31f4-ea11-b882-24ee9a37d45c",-73974256,40785234,"P.S. 9 - MANHATTAN","100 WEST  84 STREET"
5,4,1,"c7e0838c-31f4-ea11-b882-24ee9a37d45c","Battery Park City School - M276 - M276 - 02M276 - 55 BATTERY PLACE","c6e0838c-31f4-ea11-b882-24ee9a37d45c",-74017456,40706384,"P.S./I.S. 276 - MANHATTAN","55 BATTERY PLACE"
1,1,0,"ebc88e4f-31f4-ea11-b882-24ee9a37d45c","Harold O. Levy School - M052 - M052 - 06M052 - 650 ACADEMY STREET","e6c88e4f-31f4-ea11-b882-24ee9a37d45c",-73925464,40865556,"I.S. 52 - MANHATTAN","650 ACADEMY STREET"
4,4,0,"2e005d7a-31f4-ea11-b882-24ee9a37d45c","Mott Hall II - M862 - M165 - 03M862 - 234 West 109 Street","2f005d7a-31f4-ea11-b882-24ee9a37d45c",-73965949,40802653,"P.S. 165 - MANHATTAN","234 West 109 Street"
2,2,0,"3b0d6d19-33f4-ea11-b882-24ee9a37d45c","P.S. 106 Parkchester - X106 - X106 - 11X106 - 1514 OLMSTEAD AVENUE","3c0d6d19-33f4-ea11-b882-24ee9a37d45c",-73854823,40836974,"P.S. 106 - BRONX","1514 OLMSTEAD AVENUE"
1,1,0,"2403cefa-32f4-ea11-b882-24ee9a37d45c","Thomas C. Giordano Middle School 45 - X045 - X045 - 10X045 - 2502 LORILLARD PLACE","2203cefa-32f4-ea11-b882-24ee9a37d45c",-73887026,40858389,"I.S. 45 - BRONX","2502 LORILLARD PLACE"
1,0,1,"18e63126-ebf6-ea11-b883-24ee9a37d459","P.S. K771 - K771 - K236 - 75K771 - 6302 AVENUE U","5ba5db98-30f4-ea11-b882-24ee9a37d45c",-73912005,40615494,"P.S. 236 - BROOKLYN","6302 AVENUE U"
1,0,1,"8bd810ab-31f4-ea11-b882-24ee9a37d45c","Facing History School, The - M303 - M535 - 02M303 - 525 WEST  50TH STREET","f137fba4-31f4-ea11-b882-24ee9a37d45c",-73992700,40765474,"PARK WEST HS (ECF) - MANHATTAN","525 WEST  50TH STREET"
1,1,0,"9d69c231-32f4-ea11-b882-24ee9a37d45c","P.S. 203 Oakland Gardens - Q203 - Q203 - 26Q203 - 53-11 SPRINGFIELD BOULEVARD","9e69c231-32f4-ea11-b882-24ee9a37d45c",-73759822,40753606,"P.S. 203 - QUEENS","53-11 SPRINGFIELD BOULEVARD"
3,2,1,"b3315367-30f4-ea11-b882-24ee9a37d45c","P.S. 119 Amersfort - K119 - K119 - 22K119 - 3829 AVENUE K","b4315367-30f4-ea11-b882-24ee9a37d45c",-73938733,40626038,"P.S. 119 - BROOKLYN","3829 AVENUE K"
1,1,0,"5536d900-33f4-ea11-b882-24ee9a37d45c","P.S. 049 Willis Avenue - X049 - X049 - 07X049 - 383 EAST 139 STREET","4d36d900-33f4-ea11-b882-24ee9a37d45c",-73922730,40810413,"P.S. 49 - BRONX","383 EAST 139 STREET"
1,0,1,"5d9f4974-31f4-ea11-b882-24ee9a37d45c","P.S. 153 Adam Clayton Powell - M153 - M153 - 06M153 - 1750 AMSTERDAM AVENUE","589f4974-31f4-ea11-b882-24ee9a37d45c",-73947599,40826514,"P.S. 153 - MANHATTAN","1750 AMSTERDAM AVENUE"
1,1,0,"4a275a30-4afb-ea11-b883-24ee9a37d459","Brooklyn Kindergarten Society/Acd - KBAZ - KBAZ -  - 232 POWELL STREET","4b275a30-4afb-ea11-b883-24ee9a37d459",-73904185,40668701,"BROOKLYN KINDERGARTEN SOCIETY/ACD","232 POWELL STREET"
3,2,1,"9d32c3fb-eaf6-ea11-b883-24ee9a37d459","P.S. 009 - Q009 - Q009 - 75Q009 - 58-74 57 STREET","f8f22ce2-31f4-ea11-b882-24ee9a37d45c",-73912458,40718234,"P.S. 9 (W REED SCHOOL) - QUEENS","58-74 57 STREET"
1,1,0,"d0e0838c-31f4-ea11-b882-24ee9a37d45c","Richard R. Green High School of Teaching - M580 - M282 - 02M580 - 7 BEAVER STREET","d1e0838c-31f4-ea11-b882-24ee9a37d45c",-74013303,40705688,"BROADWAY EDUCATION CAMPUS - M","26 BROADWAY"
1,0,1,"e4e0838c-31f4-ea11-b882-24ee9a37d45c","Sixth Avenue Elementary School - M340 - M340 - 02M340 - 64 WEST 17 STREET","e3e0838c-31f4-ea11-b882-24ee9a37d45c",-73995534,40739145,"THE SIXTH AVENUE EDUCATIONAL CAMPUS - MANHATTAN","64 WEST 17 STREET"
2,0,2,"20eabc42-30f4-ea11-b882-24ee9a37d45c","J.H.S. 050 John D. Wells - K050 - K050 - 14K050 - 183 SOUTH  3 STREET","1feabc42-30f4-ea11-b882-24ee9a37d45c",-73960137,40711915,"J.H.S. 50 - BROOKLYN","183 SOUTH  3 STREET"
1,0,1,"b0c10fab-32f4-ea11-b882-24ee9a37d45c","Academy of the City Charter School - Q359 - QARF - 84Q359 - 23-40 Astoria Boulevard","aec10fab-32f4-ea11-b882-24ee9a37d45c",-73923830,40770769,"Astoria Community Center","23-40 Astoria Boulevard"
1,0,1,"f18ac007-ebf6-ea11-b883-24ee9a37d459","Rose Hill Pre-K Center - X535 - X444 - 10X535 - 2512 Marion Avenue","60ffcc6e-33f4-ea11-b882-24ee9a37d45c",-73893236,40861316,"PRE-K CENTER @MARION AVENUE - BRONX","2512 Marion Avenue"
2,2,0,"462f7d06-31f4-ea11-b882-24ee9a37d45c","District 20 Pre-K Center - K768 - K747 - 20K768 - 21 Bay 11th Street","472f7d06-31f4-ea11-b882-24ee9a37d45c",-74008608,40609976,"PRE-K CENTER @ 21 BAY 11TH STREET - BROOKLYN","21 Bay 11th Street"
3,3,0,"069c4c1f-32f4-ea11-b882-24ee9a37d45c","P.S. 164 Queens Valley - Q164 - Q164 - 25Q164 - 138-01 77 AVENUE","ff9b4c1f-32f4-ea11-b882-24ee9a37d45c",-73823569,40721514,"P.S. 164 - QUEENS","138-01 77 AVENUE"
1,1,0,"2a7eed06-32f4-ea11-b882-24ee9a37d45c","P.S. 095 Eastwood - Q095 - Q095 - 29Q095 - 179-01 90 AVENUE","2b7eed06-32f4-ea11-b882-24ee9a37d45c",-73783283,40711295,"P.S. 95 - QUEENS","179-01 90 AVENUE"
1,1,0,"be85f462-ebf6-ea11-b883-24ee9a37d459","P.S. M169 - Robert F. Kennedy - M169 - M102 - 75M169 - 315 EAST 113 STREET","56e61462-31f4-ea11-b882-24ee9a37d45c",-73938418,40795000,"P.S. 102 - MANHATTAN","315 EAST 113 STREET"
5,5,0,"cbfab455-31f4-ea11-b882-24ee9a37d45c","The Children's Workshop School - M361 - M061 - 01M361 - 610 EAST  12 STREET","c8fab455-31f4-ea11-b882-24ee9a37d45c",-73978254,40727537,"P.S. 61 - MANHATTAN","610 EAST  12 STREET"
1,1,0,"de9319d7-ebf6-ea11-b883-24ee9a37d459","The Richmond Pre-K Center - R066 - R090 - 31R066 - 1535 RICHMOND AVENUE","f18521d0-32f4-ea11-b882-24ee9a37d45c",-74159152,40610497,"3K CENTER @ 1535 RICHMOND AVENUE - STATEN ISLAND","1535 RICHMOND AVENUE"
1,1,0,"7ef4a0ef-eaf6-ea11-b883-24ee9a37d459","P.S. K721 - Brooklyn Occupational Training Center - K721 - K722 - 75K721 - 64 AVENUE X","392f7d06-31f4-ea11-b882-24ee9a37d45c",-73981925,40588070,"P.S. 721 OTC - BROOKLYN","64 AVENUE X"
2,2,0,"509f4974-31f4-ea11-b882-24ee9a37d45c","P.S. 146 Ann M. Short - M146 - M146 - 04M146 - 421 EAST 106 STREET","4f9f4974-31f4-ea11-b882-24ee9a37d45c",-73938727,40789535,"P.S. 146 - MANHATTAN","421 EAST 106 STREET"
4,3,1,"86977d2b-32f4-ea11-b882-24ee9a37d45c","P.S. 193 Alfred J. Kennedy - Q193 - Q193 - 25Q193 - 152-20 11 AVENUE","87977d2b-32f4-ea11-b882-24ee9a37d45c",-73808987,40792053,"P.S. 193 - QUEENS","152-20 11 AVENUE"
1,1,0,"aaeb6056-32f4-ea11-b882-24ee9a37d45c","The Hector Figueroa School - Q398 - Q398 - 30Q398 - 69-01 34TH AVENUE","abeb6056-32f4-ea11-b882-24ee9a37d45c",-73896705,40752773,"P.S. 398 - QUEENS","69-01 34TH AVENUE"
1,1,0,"9948b1f5-eaf6-ea11-b883-24ee9a37d459","P.S. K134 - K134 - K849 - 22K134 - 4001 18 AVENUE","12d8cf12-31f4-ea11-b882-24ee9a37d45c",-73973180,40632145,"P.S. 134 - BROOKLYN","4001 18 AVENUE"
1,1,0,"ee09e2e1-30f4-ea11-b882-24ee9a37d45c","The High School for Enterprise, Business and Technology - K478 - K450 - 14K478 - 850 GRAND STREET","e909e2e1-30f4-ea11-b882-24ee9a37d45c",-73938921,40711134,"GRAND STREET CAMPUS (OLD E.D.HS)- K","850 GRAND STREET"
4,3,1,"286e3d68-31f4-ea11-b882-24ee9a37d45c","P.S. 333 Manhattan School for Children - M333 - M118 - 03M333 - 154 WEST  93 STREET","246e3d68-31f4-ea11-b882-24ee9a37d45c",-73971011,40791395,"I.S. 118 - MANHATTAN","154 WEST  93 STREET"
1,1,0,"04f32ce2-31f4-ea11-b882-24ee9a37d45c","P.S. 013 Clement C. Moore - Q013 - Q013 - 24Q013 - 55-01 94 STREET","05f32ce2-31f4-ea11-b882-24ee9a37d45c",-73867662,40737441,"P.S. 13 - QUEENS","55-01 94 STREET"
1,0,1,"0eaf1f69-ebf6-ea11-b883-24ee9a37d459","Restart Academy - M973 - M465 -  - 549 AUDUBON AVENUE","25a6ba98-31f4-ea11-b882-24ee9a37d45c",-73926060,40856532,"G. WASHINGTON HS EDUC. CAMPUS - M","549 AUDUBON AVENUE"
1,1,0,"818d8486-31f4-ea11-b882-24ee9a37d45c","P.S. 77 Lower Lab School - M077 - M198 - 02M077 - 1700 3 AVENUE","7f8d8486-31f4-ea11-b882-24ee9a37d45c",-73950420,40785018,"P.S. 198 - MANHATTAN","1700 3 AVENUE"
1,1,0,"fb8ac007-ebf6-ea11-b883-24ee9a37d459","P.S. X721 - Stephen McSweeney School - X721 - X722 - 75X721 - 2697 WESTCHESTER AVENUE","06a31781-33f4-ea11-b882-24ee9a37d45c",-73839114,40842725,"P.S. 721 (OTC) - BRONX","2697 WESTCHESTER AVENUE"
1,0,1,"a29c11e8-30f4-ea11-b882-24ee9a37d45c","High School for Youth and Community Development at Erasmus - K537 - K465 - 17K537 - 911 FLATBUSH AVENUE","9d9c11e8-30f4-ea11-b882-24ee9a37d45c",-73957173,40649602,"ERASMUS HALL CAMPUS - K","911 FLATBUSH AVENUE"
1,1,0,"e32d6c32-ebf6-ea11-b883-24ee9a37d459","P.S. K369 - Coy L. Cox School - K369 - K317 - 75K369 - 610 BALTIC STREET","99e657bd-30f4-ea11-b882-24ee9a37d45c",-73980455,40679916,"P.S. 133 WILLIAM A. BUTLER - BROOKLYN","610 BALTIC STREET"
1,1,0,"44005d7a-31f4-ea11-b882-24ee9a37d45c","P.S. 173 - M173 - M173 - 06M173 - 306 FORT WASHINGTON AVENUE","3c005d7a-31f4-ea11-b882-24ee9a37d45c",-73939785,40845459,"P.S. 173 - MANHATTAN","306 FORT WASHINGTON AVENUE"
2,1,1,"5dfdc1bd-32f4-ea11-b882-24ee9a37d45c","P.S. 018 John G. Whittier - R018 - R018 - 31R018 - 221 Broadway","5efdc1bd-32f4-ea11-b882-24ee9a37d45c",-74116817,40636521,"P.S. 18 - STATEN ISLAND","221 Broadway"
9,8,1,"d2b66262-32f4-ea11-b882-24ee9a37d45c","Forest Hills High School - Q440 - Q440 - 28Q440 - 67-01 110 STREET","d3b66262-32f4-ea11-b882-24ee9a37d45c",-73843972,40730017,"FOREST HILLS HS - Q","67-01 110 STREET"
2,0,2,"94a9d9c3-32f4-ea11-b882-24ee9a37d45c","P.S. 038 George Cromwell - R038 - R038 - 31R038 - 421 LINCOLN AVENUE","92a9d9c3-32f4-ea11-b882-24ee9a37d45c",-74099409,40574799,"P.S. 38 - STATEN ISLAND","421 LINCOLN AVENUE"
1,1,0,"0ffc3df4-30f4-ea11-b882-24ee9a37d45c","All City Leadership Secondary School - K554 - K554 - 32K554 - 321 Palmetto Street","10fc3df4-30f4-ea11-b882-24ee9a37d45c",-73913172,40697378,"ALL CITY LEADERSHIP SECONDARY SCHOOL - BROOKLYN","321 Palmetto Street"
1,1,0,"001bad3c-30f4-ea11-b882-24ee9a37d45c","Brooklyn Brownstone School - K628 - K035 - 16K628 - 272 Macdonough Street","fd1aad3c-30f4-ea11-b882-24ee9a37d45c",-73935891,40681528,"I.S. 35 - BROOKLYN","272 Macdonough Street"
1,0,1,"0a6e3d68-31f4-ea11-b882-24ee9a37d45c","P.S. 112 Jose Celso Barbosa - M112 - M112 - 04M112 - 535 EAST 119 STREET","0b6e3d68-31f4-ea11-b882-24ee9a37d45c",-73930528,40796889,"P.S. 112 (TANDEM M206) - MANHATTAN","535 EAST 119 STREET"
1,0,1,"84476368-32f4-ea11-b882-24ee9a37d45c","Long Island City High School - Q450 - Q452 - 30Q450 - 14-30 BROADWAY","81476368-32f4-ea11-b882-24ee9a37d45c",-73933907,40765881,"LONG ISLAND CITY HS(NEW)-Q","14-30 BROADWAY"
1,0,1,"f9ae0313-32f4-ea11-b882-24ee9a37d45c","P.S. 124 Osmond A Church - Q124 - Q124 - 27Q124 - 129-15 150 AVENUE","faae0313-32f4-ea11-b882-24ee9a37d45c",-73811266,40665669,"P.S. 124 - QUEENS","129-15 150 AVENUE"
2,2,0,"f3ed94c3-31f4-ea11-b882-24ee9a37d45c","Paula Hedbavny School - M278 - M918 - 06M278 - 421 W 219th St","f4ed94c3-31f4-ea11-b882-24ee9a37d45c",-73912339,40871673,"P.S./IS 278 - MANHATTAN","421 W 219th St"
1,0,1,"bc56635c-33f4-ea11-b882-24ee9a37d45c","Schuylerville Preparatory High School - X348 - X405 - 08X348 - 3000 EAST TREMONT AVENUE","b556635c-33f4-ea11-b882-24ee9a37d45c",-73839583,40839775,"HERBERT H. LEHMAN HS - X","3000 EAST TREMONT AVENUE"
1,0,1,"e29319d7-ebf6-ea11-b883-24ee9a37d459","The Richmond Pre-K Center - R066 - R113 - 31R066 - 841 FATHER CAPODANNO BOULEVARD","f98521d0-32f4-ea11-b882-24ee9a37d45c",-74083885,40575592,"3K CENTER @ FATHER CAPODANNO BOULEVARD - STATEN IS","841 FATHER CAPODANNO BOULEVARD"
1,1,0,"a072c880-32f4-ea11-b882-24ee9a37d45c","Young Women's Leadership School, Queens - Q896 - Q680 - 28Q896 - 150-91 87 ROAD","9d72c880-32f4-ea11-b882-24ee9a37d45c",-73804166,40708409,"YOUNG WOMENS' LEADERSHIP SCHOOL - QUEENS","150-91 87 ROAD"
4,1,3,"64bc9674-32f4-ea11-b882-24ee9a37d45c","Richmond Hill High School - Q475 - Q475 - 27Q475 - 89-30 114 Street","3002926e-32f4-ea11-b882-24ee9a37d45c",-73833815,40695171,"RICHMOND HILL HS - Q","89-30 114 Street"
1,1,0,"a332c3fb-eaf6-ea11-b883-24ee9a37d459","P.S. 131 Abigail Adams - Q131 - Q131 - 29Q131 - 170-21 84 Avenue","0eaf0313-32f4-ea11-b882-24ee9a37d45c",-73794061,40717150,"P.S. 131 - QUEENS","170-21 84 Avenue"
1,1,0,"9f476368-32f4-ea11-b882-24ee9a37d45c","Flushing High School - Q460 - Q460 - 25Q460 - 35-01 UNION STREET","97476368-32f4-ea11-b882-24ee9a37d45c",-73826811,40764892,"FLUSHING HS - Q","35-01 UNION STREET"
1,0,1,"4f3cbf01-ebf6-ea11-b883-24ee9a37d459","The Richmond Pre-K Center - R066 - R077 - 31R066 - 120 STUYVESANT PLACE","e98521d0-32f4-ea11-b882-24ee9a37d45c",-74076955,40643000,"PRE-K CENTER @ 120 STUYVESANT PLACE - S.I.","120 STUYVESANT PLACE"
1,1,0,"f3f22ce2-31f4-ea11-b882-24ee9a37d45c","J.H.S. 008 Richard S. Grossley - Q008 - Q008 - 28Q008 - 108-35 167 STREET","f1f22ce2-31f4-ea11-b882-24ee9a37d45c",-73786403,40696910,"J.H.S. 8 - QUEENS","108-35 167 STREET"
2,2,0,"33474313-33f4-ea11-b882-24ee9a37d45c","Ampark Neighborhood - X344 - X095 - 10X344 - 3961 HILLMAN AVENUE","34474313-33f4-ea11-b882-24ee9a37d45c",-73891664,40883049,"P.S. 95 - BRONX","3961 HILLMAN AVENUE"
1,0,1,"c08442ee-31f4-ea11-b882-24ee9a37d45c","P.S. 029 Queens - Q029 - Q029 - 25Q029 - 125-10 23 AVENUE","c18442ee-31f4-ea11-b882-24ee9a37d45c",-73842967,40778029,"P.S. 29 - QUEENS","125-10 23 AVENUE"
1,1,0,"84611579-4afb-ea11-b883-24ee9a37d459","Ivy League Early Learning Academy - QBGS - QBGS -  - 6158 Springfield Boulevard","85611579-4afb-ea11-b883-24ee9a37d459",-73756557,40748785,"KOG Industries, Inc.","6158 Springfield Boulevard"
15,5,10,"59be7adc-32f4-ea11-b882-24ee9a37d45c","Susan E. Wagner High School - R460 - R460 - 31R460 - 1200 MANOR ROAD","5abe7adc-32f4-ea11-b882-24ee9a37d45c",-74130819,40588985,"SUSAN E. WAGNER HS - S. I.","1200 MANOR ROAD"
1,1,0,"139ebaee-32f4-ea11-b882-24ee9a37d45c","P.S. 006 West Farms - X006 - X006 - 12X006 - 1000 EAST TREMONT AVENUE","0e9ebaee-32f4-ea11-b882-24ee9a37d45c",-73882531,40840445,"P.S. 6 - BRONX","1000 EAST TREMONT AVENUE"
1,1,0,"d4fa079f-32f4-ea11-b882-24ee9a37d45c","P.S. 206 The Horace Harding School - Q206 - Q956 - 28Q206 - 61-21 97 PLACE","d5fa079f-32f4-ea11-b882-24ee9a37d45c",-73861004,40734040,"P.S. 206 TRANSPORTABLE - Q","61-21 97 PLACE"
1,1,0,"130410ca-32f4-ea11-b882-24ee9a37d45c","CSI High School for International Studies - R047 - R043 - 31R047 - 100 ESSEX DRIVE","a0a9d9c3-32f4-ea11-b882-24ee9a37d45c",-74159343,40581958,"JEROME PARKER CAMPUS - S.I.","100 ESSEX DRIVE"
1,0,1,"c8bfa431-33f4-ea11-b882-24ee9a37d45c","KIPP Academy Charter School - X704 - X151 - 84X704 - 250 EAST 156 STREET","c1bfa431-33f4-ea11-b882-24ee9a37d45c",-73921140,40822574,"I.S. 151 - BRONX","250 EAST 156 STREET"
1,1,0,"ba69c231-32f4-ea11-b882-24ee9a37d45c","J.H.S. 210 Elizabeth Blackwell - Q210 - Q210 - 27Q210 - 93-11 101 AVENUE","bb69c231-32f4-ea11-b882-24ee9a37d45c",-73847633,40684760,"I.S. 210 - QUEENS","93-11 101 AVENUE"
3,2,1,"a369c231-32f4-ea11-b882-24ee9a37d45c","Energy Tech High School - Q258 - Q204 - 30Q258 - 36-41 28 STREET","9c69c231-32f4-ea11-b882-24ee9a37d45c",-73932628,40756471,"I.S. 204 - QUEENS","36-41 28 STREET"
3,3,0,"db2ff20c-32f4-ea11-b882-24ee9a37d45c","P.S. 120 Queens - Q120 - Q120 - 25Q120 - 58-01 136 STREET","dc2ff20c-32f4-ea11-b882-24ee9a37d45c",-73828674,40745215,"P.S. 120 - QUEENS","58-01 136 STREET"
2,2,0,"dc0d3c5b-30f4-ea11-b882-24ee9a37d45c","P.S./I.S. 104 The Fort Hamilton School - K104 - K104 - 20K104 - 9115 5 AVENUE","dd0d3c5b-30f4-ea11-b882-24ee9a37d45c",-74028492,40618077,"P.S. 104 - BROOKLYN","9115 5 AVENUE"
3,2,1,"2b0410ca-32f4-ea11-b882-24ee9a37d45c","P.S. 050 Frank Hankinson - R050 - R050 - 31R050 - 200 ADELAIDE AVENUE","2c0410ca-32f4-ea11-b882-24ee9a37d45c",-74124332,40560954,"P.S. 50 - STATEN ISLAND","200 ADELAIDE AVENUE"
2,2,0,"b52ff20c-32f4-ea11-b882-24ee9a37d45c","P.S. 107 Thomas A Dooley - Q107 - Q107 - 25Q107 - 167-02 45 AVENUE","b62ff20c-32f4-ea11-b882-24ee9a37d45c",-73799476,40755364,"P.S. 107 - QUEENS","167-02 45 AVENUE"
1,1,0,"3568ee1e-31f4-ea11-b882-24ee9a37d45c","P.S./I.S. 104 The Fort Hamilton School - K104 - K989 - 20K104 - 415 89 STREET","3668ee1e-31f4-ea11-b882-24ee9a37d45c",-74028579,40620407,"P.S. 104/P.S. 185 ANNEX-K","415 89 STREET"
2,2,0,"445bc58c-30f4-ea11-b882-24ee9a37d45c","P.S. 212 Lady Deborah Moody - K212 - K212 - 21K212 - 87 BAY  49 STREET","455bc58c-30f4-ea11-b882-24ee9a37d45c",-73985368,40587612,"P.S. 212 - BROOKLYN","87 BAY  49 STREET"
1,1,0,"ce968d36-30f4-ea11-b882-24ee9a37d45c","P.S. 017 Henry D. Woodworth - K017 - K017 - 14K017 - 208 NORTH  5 STREET","cc968d36-30f4-ea11-b882-24ee9a37d45c",-73957300,40715268,"P.S. 17 - BROOKLYN","208 NORTH  5 STREET"
2,1,1,"90c280bd-31f4-ea11-b882-24ee9a37d45c","Harvest Collegiate High School - M534 - M883 - 02M534 - 34 WEST  14 STREET","8fc280bd-31f4-ea11-b882-24ee9a37d45c",-73995731,40736416,"LEGACY HS FOR INTEGR. STUDIES - M","34 WEST  14 STREET"
1,0,1,"f4aeb707-ecf6-ea11-b883-24ee9a37d459","Passages Academy - X695 - X824 - 79X695 - 108 WEST 174 STREET","75593c87-33f4-ea11-b882-24ee9a37d45c",-73918314,40846755,"Bronx Hope- BRONX","108 WEST 174 STREET"
1,1,0,"7b07e99e-31f4-ea11-b882-24ee9a37d45c","Urban Assembly School for Media Studies, The - M307 - M490 - 03M307 - 122 AMSTERDAM AVENUE","7c07e99e-31f4-ea11-b882-24ee9a37d45c",-73985608,40774891,"MARTIN LUTHER KING, JR. HS - M","122 AMSTERDAM AVENUE"
2,2,0,"dbc1392a-30f4-ea11-b882-24ee9a37d45c","P.S. 001 The Bergen - K001 - K001 - 15K001 - 309 47 STREET","dcc1392a-30f4-ea11-b882-24ee9a37d45c",-74011420,40648959,"P.S. 1 - BROOKLYN","309 47 STREET"
1,1,0,"69e95536-4afb-ea11-b883-24ee9a37d459","Rainbow - Little Neck - QBLV - QBLV -  - 25021 Northern Boulevard","6ae95536-4afb-ea11-b883-24ee9a37d459",-73737064,40768826,"Rainbow - Little Neck","25021 Northern Boulevard"
1,0,1,"209ebaee-32f4-ea11-b882-24ee9a37d45c","P.S. X015 Institute for Environmental Learning - X015 - X015 - 10X015 - 2195 ANDREWS AVENUE","219ebaee-32f4-ea11-b882-24ee9a37d45c",-73909763,40859243,"P.S. 15 - BRONX","2195 ANDREWS AVENUE"
1,1,0,"8ceb0e7b-33f4-ea11-b882-24ee9a37d45c","Alfred E. Smith Career and Technical Education High School - X600 - X600 - 07X600 - 333 EAST 151 STREET","86eb0e7b-33f4-ea11-b882-24ee9a37d45c",-73919949,40818645,"ALFRED E. SMITH HS - X","333 EAST 151 STREET"
1,1,0,"0aba8b86-30f4-ea11-b882-24ee9a37d45c","P.S. 203 Floyd Bennett School - K203 - K203 - 22K203 - 5101 AVENUE M","0bba8b86-30f4-ea11-b882-24ee9a37d45c",-73925732,40622108,"P.S. 203 - BROOKLYN","5101 AVENUE M"
13,9,4,"05ee94c3-31f4-ea11-b882-24ee9a37d45c","Spruce Street School - M397 - M971 - 02M397 - 12 SPRUCE STREET","01ee94c3-31f4-ea11-b882-24ee9a37d45c",-74005473,40711321,"THE SPRUCE STREET EDUCATIONAL CAMPUS","12 SPRUCE STREET"
1,1,0,"32a198c3-30f4-ea11-b882-24ee9a37d45c","P.S. 346 Abe Stark - K346 - K346 - 19K346 - 1400 PENNSYLVANIA AVENUE","30a198c3-30f4-ea11-b882-24ee9a37d45c",-73881997,40646640,"P.S. 346 - BROOKLYN","1400 PENNSYLVANIA AVENUE"
4,2,2,"11e85c61-30f4-ea11-b882-24ee9a37d45c","P.S. 108 Sal Abbracciamento - K108 - K108 - 19K108 - 200 LINWOOD STREET","12e85c61-30f4-ea11-b882-24ee9a37d45c",-73884348,40681295,"P.S. 108 - BROOKLYN","200 LINWOOD STREET"
2,2,0,"7c476368-32f4-ea11-b882-24ee9a37d45c","Newcomers High School - Q555 - Q450 - 30Q555 - 28-01 41 AVENUE","dab66262-32f4-ea11-b882-24ee9a37d45c",-73936592,40751838,"NEWCOMERS HIGH SCHOOL (OLD LIC)-Q","28-01 41 AVENUE"
1,1,0,"200b210d-33f4-ea11-b882-24ee9a37d45c","P.S. 75 School of Research and Discovery - X075 - X075 - 08X075 - 984 FAILE STREET","1f0b210d-33f4-ea11-b882-24ee9a37d45c",-73888948,40822314,"P.S. 75 - BRONX","984 FAILE STREET"
2,0,2,"1ea31781-33f4-ea11-b882-24ee9a37d45c","KIPP Academy Charter School - X704 - X790 - 84X704 - 730 CONCOURSE VILLAGE WEST","0ea31781-33f4-ea11-b882-24ee9a37d45c",-73922366,40821828,"MOTT HAVEN EDUCATIONAL CAMPUS - BRONX","730 CONCOURSE VILLAGE WEST"
1,1,0,"af0e6e25-32f4-ea11-b882-24ee9a37d45c","P.S. 184 Flushing Manor - Q184 - Q184 - 25Q184 - 163-15 21 ROAD","b00e6e25-32f4-ea11-b882-24ee9a37d45c",-73799158,40778334,"P.S. 184 - QUEENS","163-15 21 ROAD"
1,1,0,"968d8486-31f4-ea11-b882-24ee9a37d45c","Middle School 322 - M322 - M218 - 06M322 - 4600 BROADWAY","978d8486-31f4-ea11-b882-24ee9a37d45c",-73930082,40860951,"I.S. 218 - MANHATTAN","4600 BROADWAY"
1,1,0,"018bc007-ebf6-ea11-b883-24ee9a37d459","Bronx Charter School for Better Learning - X718 - X937 - 84X718 - 3740 BAYCHESTER AVENUE","20497593-33f4-ea11-b882-24ee9a37d45c",-73839288,40884371,"BX CHARTER SCH FOR BETTER LRNG - X","3740 BAYCHESTER AVENUE"
1,1,0,"3cceb75a-4afb-ea11-b883-24ee9a37d459","Books and Rattles Inc. Site 1 - QALW - QALW -  - 75 02 51ST AVENUE","3dceb75a-4afb-ea11-b883-24ee9a37d459",-73888167,40736282,"BOOKS AND RATTLES, INC. SITE 1","75 02 51ST AVENUE"
3,1,2,"7ed92255-30f4-ea11-b882-24ee9a37d45c","P.S. 90 Edna Cohen School - K090 - K090 - 21K090 - 2840 WEST  12 STREET","7dd92255-30f4-ea11-b882-24ee9a37d45c",-73980387,40578192,"P.S. 90 - BROOKLYN","2840 WEST  12 STREET"
2,2,0,"71c280bd-31f4-ea11-b882-24ee9a37d45c","Eleanor Roosevelt High School - M416 - M855 - 02M416 - 411 EAST 76 STREET","72c280bd-31f4-ea11-b882-24ee9a37d45c",-73953276,40770288,"ELEANOR ROOSEVELT HS - MANHATTAN","411 EAST 76 STREET"
1,1,0,"9372c880-32f4-ea11-b882-24ee9a37d45c","Epic High School - North - Q334 - Q636 - 27Q334 - 94-25 117th Street","9472c880-32f4-ea11-b882-24ee9a37d45c",-73829409,40693013,"RICHMOND HILL HIGH SCHOOL ANNEX - QUEENS","94-25 117th Street"
1,1,0,"39474313-33f4-ea11-b882-24ee9a37d45c","P.S. 095 Sheila Mencher - X095 - X095 - 10X095 - 3961 HILLMAN AVENUE","34474313-33f4-ea11-b882-24ee9a37d45c",-73891664,40883049,"P.S. 95 - BRONX","3961 HILLMAN AVENUE"
4,3,1,"aa28a20c-31f4-ea11-b882-24ee9a37d45c","P.S. 089 Cypress Hills - K089 - K814 - 19K089 - 265 WARWICK STREET","a928a20c-31f4-ea11-b882-24ee9a37d45c",-73886712,40677707,"CYPRESS HILLS COMMUNITY SCHOOL - BROOKLYN","265 WARWICK STREET"
1,1,0,"7907e99e-31f4-ea11-b882-24ee9a37d45c","Art and Design High School - M630 - M488 - 02M630 - 231-249 EAST 56 STREET","6d07e99e-31f4-ea11-b882-24ee9a37d45c",-73967204,40759248,"MIDTOWN EAST CAMPUS - MANHATTAN","231-249 EAST 56 STREET"
2,2,0,"840e6e25-32f4-ea11-b882-24ee9a37d45c","P.S. 169 Bay Terrace - Q169 - Q169 - 25Q169 - 18-25 212 STREET","820e6e25-32f4-ea11-b882-24ee9a37d45c",-73778430,40782331,"P.S. 169 - QUEENS","18-25 212 STREET"
1,0,1,"a932c3fb-eaf6-ea11-b883-24ee9a37d459","P.S. Q004 - Q004 - Q179 - 75Q004 - 196-25 Peck Avenue","9c0e6e25-32f4-ea11-b882-24ee9a37d45c",-73778118,40741700,"P.S. 179 - QUEENS","196-25 Peck Avenue"
1,1,0,"6107e99e-31f4-ea11-b882-24ee9a37d45c","Ella Baker School - M225 - M480 - 02M225 - 317 EAST  67 STREET","6007e99e-31f4-ea11-b882-24ee9a37d45c",-73959777,40765638,"JULIA RICHMAN ED. COMPLEX - M","317 EAST  67 STREET"
1,0,1,"7fe2635c-32f4-ea11-b882-24ee9a37d45c","ALC - Beach Channel Educational Complex - Q996 - Q410 - 88Q996 - 100-00 BEACH CHANNEL DRIVE","71e2635c-32f4-ea11-b882-24ee9a37d45c",-73825317,40586012,"Beach Channel Educational Campus","100-00 BEACH CHANNEL DRIVE"
1,1,0,"39a6ba98-31f4-ea11-b882-24ee9a37d45c","Frank McCourt High School - M417 - M470 - 03M417 - 145 WEST  84 STREET","33a6ba98-31f4-ea11-b882-24ee9a37d45c",-73974483,40786134,"LOUIS D. BRANDEIS HS - MANHATTAN","145 WEST  84 STREET"
1,1,0,"cd315367-30f4-ea11-b882-24ee9a37d45c","P.S. 127 Mckinley Park - K127 - K127 - 20K127 - 7805 7 Avenue","ce315367-30f4-ea11-b882-24ee9a37d45c",-74018429,40623687,"P.S. 127 - BROOKLYN","7805 7 Avenue"
1,1,0,"1aa6ba98-31f4-ea11-b882-24ee9a37d45c","The High School For Language And Diplomacy - M399 - M460 - 02M399 - 40 IRVING PLACE","16a6ba98-31f4-ea11-b882-24ee9a37d45c",-73987064,40735361,"WASHINGTON IRVING HS - MANHATTAN","40 IRVING PLACE"
1,1,0,"b6689025-33f4-ea11-b882-24ee9a37d45c","P.S. 126 Dr Marjorie H Dunbar - X126 - X126 - 09X126 - 175 WEST 166 STREET","b5689025-33f4-ea11-b882-24ee9a37d45c",-73928200,40835866,"P.S. 126 (ECF) - BRONX","175 WEST 166 STREET"
1,1,0,"c82ff20c-32f4-ea11-b882-24ee9a37d45c","P.S./M.S. 114 Belle Harbor - Q114 - Q114 - 27Q114 - 134-01 CRONSTON AVENUE","c12ff20c-32f4-ea11-b882-24ee9a37d45c",-73854364,40577552,"P.S. 114 - QUEENS","134-01 CRONSTON AVENUE"
1,0,1,"b2e0838c-31f4-ea11-b882-24ee9a37d45c","The Mott Hall School - M223 - M223 - 06M223 - 71-111 Convent Ave","b3e0838c-31f4-ea11-b882-24ee9a37d45c",-73951292,40816626,"I.S. 223 (MOTT HALL) - MANHATTAN","71-111 Convent Ave"
1,1,0,"f721d292-30f4-ea11-b882-24ee9a37d45c","P.S. 230 Doris L. Cohen - K230 - K230 - 15K230 - 1 ALBEMARLE ROAD","f321d292-30f4-ea11-b882-24ee9a37d45c",-73980515,40645609,"P.S. 230 - BROOKLYN","1 ALBEMARLE ROAD"
1,1,0,"499f4974-31f4-ea11-b882-24ee9a37d45c","West Prep Academy - M421 - M145 - 03M421 - 150 West 105 Street","4a9f4974-31f4-ea11-b882-24ee9a37d45c",-73965611,40799098,"P.S. 145 - MANHATTAN","150 West 105 Street"
1,1,0,"e72ece86-32f4-ea11-b882-24ee9a37d45c","Civic Leadership Academy - Q293 - Q744 - 24Q293 - 45-10 94th Street","e22ece86-32f4-ea11-b882-24ee9a37d45c",-73871505,40743228,"ELMHURST EDUCATIONAL CAMPUS - Q","45-10 94th Street"
1,0,1,"604accc4-ebf6-ea11-b883-24ee9a37d459","P.S. 009 - Q009 - Q882 - 75Q009 - 90-36 150 STREET","cdedf392-32f4-ea11-b882-24ee9a37d45c",-73805044,40702776,"P.S. 182 - QUEENS","90-36 150 STREET"
1,1,0,"87d810ab-31f4-ea11-b882-24ee9a37d45c","High School of Hospitality Management - M296 - M535 - 02M296 - 525 WEST  50TH STREET","f137fba4-31f4-ea11-b882-24ee9a37d45c",-73992700,40765474,"PARK WEST HS (ECF) - MANHATTAN","525 WEST  50TH STREET"
3,3,0,"35767649-31f4-ea11-b882-24ee9a37d45c","Lower East Side Preparatory High School - M515 - M025 - 01M515 - 145 Stanton Street","29767649-31f4-ea11-b882-24ee9a37d45c",-73986038,40720040,"J.H.S. 25 - MANHATTAN","145 Stanton Street"
1,1,0,"5a9f4974-31f4-ea11-b882-24ee9a37d45c","P.S. 152 Dyckman Valley - M152 - M152 - 06M152 - 93 NAGLE AVENUE","5b9f4974-31f4-ea11-b882-24ee9a37d45c",-73927578,40859804,"P.S. 152 - MANHATTAN","93 NAGLE AVENUE"
1,1,0,"2102926e-32f4-ea11-b882-24ee9a37d45c","Queens Collegiate: A College Board School - Q310 - Q470 - 28Q310 - 167-01 GOTHIC DRIVE","1f02926e-32f4-ea11-b882-24ee9a37d45c",-73798658,40714551,"JAMAICA HS - Q","167-01 GOTHIC DRIVE"
1,0,1,"857e21a6-ebf6-ea11-b883-24ee9a37d459","P.S. 009 - Q009 - Q277 - 75Q009 - 153-27 88TH AVENUE","15c73b4a-32f4-ea11-b882-24ee9a37d45c",-73803183,40706750,"PS 182 SAMANTHA SMITH - QUEENS","153-27 88TH AVENUE"
9,9,0,"30b4977a-32f4-ea11-b882-24ee9a37d45c","Frank Sinatra School of the Arts High School - Q501 - Q570 - 30Q501 - 35-12 35TH AVENUE","2eb4977a-32f4-ea11-b882-24ee9a37d45c",-73925182,40756099,"FRANK SINATRA HIGH SCHOOL-Q","35-12 35TH AVENUE"
1,1,0,"2f416e00-31f4-ea11-b882-24ee9a37d45c","Brooklyn High School of the Arts - K656 - K655 - 15K656 - 345 DEAN STREET","30416e00-31f4-ea11-b882-24ee9a37d45c",-73980266,40683951,"BKLYN HS OF THE ARTS (OL S J HL)-K","345 DEAN STREET"
2,2,0,"cd8521d0-32f4-ea11-b882-24ee9a37d45c","I.S. 061 William A Morris - R061 - R061 - 31R061 - 445 CASTLETON AVENUE","460410ca-32f4-ea11-b882-24ee9a37d45c",-74097941,40634497,"I.S. 61 - STATEN ISLAND","445 CASTLETON AVENUE"
1,0,1,"950e6e25-32f4-ea11-b882-24ee9a37d45c","P.S. 175 The Lynn Gross Discovery School - Q175 - Q175 - 28Q175 - 64-35 102 STREET","960e6e25-32f4-ea11-b882-24ee9a37d45c",-73852210,40731016,"P.S. 175 - QUEENS","64-35 102 STREET"
2,2,0,"4be61462-31f4-ea11-b882-24ee9a37d45c","M.S. 224 Manhattan East School for Arts & Academics - M224 - M099 - 04M224 - 410 EAST 100 STREET","3de61462-31f4-ea11-b882-24ee9a37d45c",-73942154,40785107,"I.S. 99 - MANHATTAN","410 EAST 100 STREET"
2,2,0,"96d91731-31f4-ea11-b882-24ee9a37d45c","Brooklyn Urban Garden Charter School - K758 - KBNU - 84K758 - 500 19 Street","97d91731-31f4-ea11-b882-24ee9a37d45c",-73982624,40656202,"STANLEY LAMM INSTITUE PRE-SCHOOL OF LONGISLAND HO","500 19 Street"
1,0,1,"4febaa73-30f4-ea11-b882-24ee9a37d45c","New Bridges Elementary - K532 - K167 - 17K532 - 1025 EASTERN PARKWAY","4cebaa73-30f4-ea11-b882-24ee9a37d45c",-73934316,40669557,"P.S. 167 - BROOKLYN","1025 EASTERN PARKWAY"
1,0,1,"3268ee1e-31f4-ea11-b882-24ee9a37d45c","School of Math, Science, and Healthy Living - K971 - K971 - 20K971 - 6214 4TH AVENUE","3368ee1e-31f4-ea11-b882-24ee9a37d45c",-74020343,40639518,"P.S. 971 - BROOKLYN","6214 4TH AVENUE"
1,0,1,"00b7c337-32f4-ea11-b882-24ee9a37d45c","Wave Preparatory Elementary School - Q362 - Q215 - 27Q362 - 535 BRIAR PLACE","01b7c337-32f4-ea11-b882-24ee9a37d45c",-73758587,40599467,"P.S. 215 - QUEENS","535 BRIAR PLACE"
2,2,0,"788946f4-31f4-ea11-b882-24ee9a37d45c","P.S. 054 Hillside - Q054 - Q054 - 28Q054 - 86-02 127 STREET","778946f4-31f4-ea11-b882-24ee9a37d45c",-73824629,40702656,"P.S. 54 - QUEENS","86-02 127 STREET"
1,1,0,"8f2aa42b-33f4-ea11-b882-24ee9a37d45c","Theatre Arts Production Company School - X225 - X137 - 10X225 - 2225 WEBSTER AVENUE","8e2aa42b-33f4-ea11-b882-24ee9a37d45c",-73897404,40854257,"I.S. 391 (UDC) - BRONX","2225 WEBSTER AVENUE"
2,2,0,"70e03d56-33f4-ea11-b882-24ee9a37d45c","The Bronxwood Preparatory Academy - X514 - X362 - 11X514 - 921 EAST 228TH STREET","6ce03d56-33f4-ea11-b882-24ee9a37d45c",-73852714,40888242,"I.S./H.S. 362 - BRONX","921 EAST 228TH STREET"
1,1,0,"05af1f69-ebf6-ea11-b883-24ee9a37d459","District 2 Pre-K Center - M391 - M343 - 02M391 - 1 PECK SLIP","e7e0838c-31f4-ea11-b882-24ee9a37d45c",-74002407,40708774,"THE PECK SLIP SCHOOL - MANHATTAN","1 PECK SLIP"
1,0,1,"07ca024b-84ef-eb11-b8b1-24ee9a37d45c","P.S. Q177 - Q177 - Q435 - 75Q177 - 230-17 HILLSIDE AVENUE","c4b66262-32f4-ea11-b882-24ee9a37d45c",-73739726,40733888,"MARTIN VAN BUREN HS - QUEENS","230-17 HILLSIDE AVENUE"
6,4,2,"9fa9d9c3-32f4-ea11-b882-24ee9a37d45c","Marsh Avenue School for Expeditionary Learning - R063 - R043 - 31R063 - 100 ESSEX DRIVE","a0a9d9c3-32f4-ea11-b882-24ee9a37d45c",-74159343,40581958,"JEROME PARKER CAMPUS - S.I.","100 ESSEX DRIVE"
4,4,0,"ed21d292-30f4-ea11-b882-24ee9a37d45c","J.H.S. 227 Edward B. Shallow - K227 - K227 - 20K227 - 6500 16 AVENUE","ee21d292-30f4-ea11-b882-24ee9a37d45c",-73995961,40622102,"I.S. 227 - BROOKLYN","6500 16 AVENUE"
3,2,1,"460b210d-33f4-ea11-b882-24ee9a37d45c","Academy for Language and Technology - X365 - X082 - 09X365 - 1700 MACOMBS ROAD","3f0b210d-33f4-ea11-b882-24ee9a37d45c",-73915217,40849416,"I.S. 232 - BRONX","1700 MACOMBS ROAD"
1,1,0,"0e1bad3c-30f4-ea11-b882-24ee9a37d45c","P.S. 041 Francis White - K041 - K041 - 23K041 - 411 Thatford Avenue","0f1bad3c-30f4-ea11-b882-24ee9a37d45c",-73906925,40660455,"P.S. 41 - BROOKLYN","225 Newport Street"
2,1,1,"d917b7f4-32f4-ea11-b882-24ee9a37d45c","PS/MS 20 P.O.George J. Werdann, III - X020 - X020 - 10X020 - 3050 WEBSTER AVENUE","d817b7f4-32f4-ea11-b882-24ee9a37d45c",-73878731,40869482,"P.S. 20 - BRONX","3050 WEBSTER AVENUE"
1,1,0,"b132c3fb-eaf6-ea11-b883-24ee9a37d459","The Ezra Jack Keats Pre-K Center - Q335 - Q383 - 28Q335 - 132-10 JAMAICA AVENUE","93eb6056-32f4-ea11-b882-24ee9a37d45c",-73820221,40702178,"PRE-K CENTER @ 132-10 JAMAICA AVENUE - QUEENS","132-10 JAMAICA AVENUE"
1,1,0,"1c005d7a-31f4-ea11-b882-24ee9a37d45c","Yorkville East Middle School - M177 - M158 - 02M177 - 1458 YORK AVENUE","1d005d7a-31f4-ea11-b882-24ee9a37d45c",-73950745,40770215,"P.S. 158 - MANHATTAN","1458 YORK AVENUE"
2,2,0,"68507380-31f4-ea11-b882-24ee9a37d45c","P.S. 452 - M452 - M191 - 03M452 - 210 WEST  61 STREET","69507380-31f4-ea11-b882-24ee9a37d45c",-73987515,40771603,"P.S. 191 - MANHATTAN","210 WEST  61 STREET"
1,1,0,"8734aa92-31f4-ea11-b882-24ee9a37d45c","Urban Assembly Academy of Government and Law, The - M305 - M445 - 02M305 - 350 GRAND STREET","8834aa92-31f4-ea11-b882-24ee9a37d45c",-73989329,40717329,"SEWARD PARK HS - MANHATTAN","350 GRAND STREET"
1,1,0,"d20d3c5b-30f4-ea11-b882-24ee9a37d45c","P.S. 100 The Coney Island School - K100 - K100 - 21K100 - 2951 WEST  3 STREET","ca0d3c5b-30f4-ea11-b882-24ee9a37d45c",-73970830,40577591,"P.S. 100 - BROOKLYN","2951 WEST  3 STREET"
1,0,1,"c192e6d5-30f4-ea11-b882-24ee9a37d45c","Kurt Hahn Expeditionary Learning School - K569 - K415 - 18K569 - 5800 TILDEN AVENUE","5b8dbfcf-30f4-ea11-b882-24ee9a37d45c",-73922212,40647728,"SAMUEL J. TILDEN EDUCATIONAL CAMPUS - K","5800 TILDEN AVENUE"
1,1,0,"01f32ce2-31f4-ea11-b882-24ee9a37d45c","P.S. 012 James B. Colgate - Q012 - Q012 - 24Q012 - 42-00 72 STREET","02f32ce2-31f4-ea11-b882-24ee9a37d45c",-73893466,40742284,"P.S. 12 - QUEENS","42-00 72 STREET"
3,1,2,"da1f145d-51e6-eb11-b8b1-24ee9a37d45c","Success Academy Charter School - Rosedale - New York 5 - Q337 - Q390 - 84Q337 - 109-55 128 Street","db1f145d-51e6-eb11-b8b1-24ee9a37d45c",-73813926,40683802,"SAINT TERESA OF AVILA SCHOOL - QUEENS","109-55 128 Street"
1,1,0,"76e2635c-32f4-ea11-b882-24ee9a37d45c","P.S. Q256 - Q256 - Q410 - 75Q256 - 100-00 BEACH CHANNEL DRIVE","71e2635c-32f4-ea11-b882-24ee9a37d45c",-73825317,40586012,"Beach Channel Educational Campus","100-00 BEACH CHANNEL DRIVE"
2,2,0,"2bebaa73-30f4-ea11-b882-24ee9a37d45c","P.S. 159 Isaac Pitkin - K159 - K159 - 19K159 - 2781 PITKIN AVENUE","2cebaa73-30f4-ea11-b882-24ee9a37d45c",-73869705,40676111,"P.S. 159 - BROOKLYN","2781 PITKIN AVENUE"
1,0,1,"8e69c231-32f4-ea11-b882-24ee9a37d45c","P.S. 199 Maurice A. Fitzgerald - Q199 - Q199 - 24Q199 - 39-20 48 Avenue","98977d2b-32f4-ea11-b882-24ee9a37d45c",-73926081,40739831,"P.S. 199 - QUEENS","39-20 48 Avenue"
3,3,0,"66e2635c-32f4-ea11-b882-24ee9a37d45c","Hunters Point Community Middle School - Q291 - Q404 - 30Q291 - 1-50 51ST AVENUE","65e2635c-32f4-ea11-b882-24ee9a37d45c",-73959183,40742964,"HUNTERS POINT CAMPUS - QUEENS","1-50 51ST AVENUE"
3,3,0,"a93aa668-33f4-ea11-b882-24ee9a37d45c","Celia Cruz Bronx High School of Music, The - X442 - X430 - 10X442 - 2780 RESERVOIR AVENUE","a13aa668-33f4-ea11-b882-24ee9a37d45c",-73897066,40869061,"WALTON HS - X","2780 RESERVOIR AVENUE"
2,0,2,"b572c880-32f4-ea11-b882-24ee9a37d45c","P.S. Q016 The Nancy DeBenedittis School - Q016 - Q721 - 24Q016 - 41-15 104 STREET","b672c880-32f4-ea11-b882-24ee9a37d45c",-73860547,40748996,"P.S. 16 (OLD Q721 SPED) - QUEENS","41-15 104 STREET"
2,2,0,"6eceb75a-4afb-ea11-b883-24ee9a37d459","Rainbow LIC - Borden Avenue - QBPW - QBPW -  - 1-55 BORDEN AVENUE","6fceb75a-4afb-ea11-b883-24ee9a37d459",-73959041,40742519,"Rainbow LIC - Borden Avenue","1-55 BORDEN AVENUE"
1,0,1,"7db50aa5-30f4-ea11-b882-24ee9a37d45c","Success Academy Charter School - Fort Greene - K752 - K265 - 84K752 - 101 PARK AVENUE","79b50aa5-30f4-ea11-b882-24ee9a37d45c",-73976104,40697177,"I.S. 265 - BROOKLYN","101 PARK AVENUE"
3,2,1,"0878931f-33f4-ea11-b882-24ee9a37d45c","Young Women's Leadership School of the Bronx - X568 - X117 - 09X568 - 1865 MORRIS AVENUE","0578931f-33f4-ea11-b882-24ee9a37d45c",-73909022,40848552,"I.S. 117 - BRONX","1865 MORRIS AVENUE"
2,1,1,"ae56635c-33f4-ea11-b882-24ee9a37d45c","New Visions A.I.M. Charter High School II - X200 - X401 - 84X200 - 1010 REV. J. A. POLITE AVENUE","8ce03d56-33f4-ea11-b882-24ee9a37d45c",-73898265,40823124,"BRONX REGIONAL HS (OLD 133) - X","1010 REV. J. A. POLITE AVENUE"
1,0,1,"4d45378b-4afb-ea11-b883-24ee9a37d459","MARSHALL ENGLAND EARLY LEARNING CENTER - XANX - XAKG -  - 800 CONCOURSE VILLAGE EAST","4e45378b-4afb-ea11-b883-24ee9a37d459",-73918927,40824082,"MARSHALL ENGLAND EARLY LEARNING CENTER","800 CONCOURSE VILLAGE EAST"
2,2,0,"12cf496e-31f4-ea11-b882-24ee9a37d45c","Dos Puentes Elementary School - M103 - M132 - 06M103 - 185 WADSWORTH AVENUE","10cf496e-31f4-ea11-b882-24ee9a37d45c",-73933964,40850561,"P.S. 132 - MANHATTAN","185 WADSWORTH AVENUE"
1,0,1,"8de04648-53e6-eb11-b8b1-24ee9a37d45c","Success Academy Charter School - Bronx 3 - X380 - M043 - 84X380 - 509 WEST 129 STREET","59767649-31f4-ea11-b882-24ee9a37d45c",-73955520,40815747,"I.S. 172 (OLD 43) - MANHATTAN","509 WEST 129 STREET"
2,2,0,"dd8a0044-33f4-ea11-b882-24ee9a37d45c","P.S. 175 City Island - X175 - X175 - 11X175 - 200 CITY ISLAND AVENUE","de8a0044-33f4-ea11-b882-24ee9a37d45c",-73783540,40844353,"P.S. 175 - BRONX","200 CITY ISLAND AVENUE"
1,1,0,"d479df48-30f4-ea11-b882-24ee9a37d45c","Community Roots Charter School - K536 - K067 - 84K536 - 51 SAINT EDWARDS STREET","d179df48-30f4-ea11-b882-24ee9a37d45c",-73977674,40695339,"P.S. 67 - BROOKLYN","51 SAINT EDWARDS STREET"
1,1,0,"7dbc9674-32f4-ea11-b882-24ee9a37d45c","Benjamin Franklin High School for Finance & Information Technology - Q313 - Q490 - 29Q313 - 207- 01 116TH  AVENUE","7ebc9674-32f4-ea11-b882-24ee9a37d45c",-73746330,40698786,"CAMPUS MAGNET HS (JACKSON) - Q","207- 01 116TH  AVENUE"
1,1,0,"ec968d36-30f4-ea11-b882-24ee9a37d45c","P.S. 024 - K024 - K024 - 15K024 - 427 38 STREET","ed968d36-30f4-ea11-b882-24ee9a37d45c",-74004533,40652832,"P.S. 24 - BROOKLYN","427 38 STREET"
1,1,0,"9d886843-31f4-ea11-b882-24ee9a37d45c","P.S. 011 William T. Harris - M011 - M011 - 02M011 - 320 WEST  21 STREET","9e886843-31f4-ea11-b882-24ee9a37d45c",-74000743,40744186,"P.S. 11 - MANHATTAN","320 WEST  21 STREET"
3,3,0,"0d0410ca-32f4-ea11-b882-24ee9a37d45c","The Stephanie A. Vierno School - R041 - R041 - 31R041 - 216 CLAWSON STREET","0e0410ca-32f4-ea11-b882-24ee9a37d45c",-74108492,40573599,"P.S. 41 - STATEN ISLAND","216 CLAWSON STREET"
1,0,1,"aeab074a-33f4-ea11-b882-24ee9a37d45c","P.S. 211 - X211 - X193 - 12X211 - 1919 PROSPECT AVENUE","afab074a-33f4-ea11-b882-24ee9a37d45c",-73890145,40843705,"P.S. 211 - BRONX","1919 PROSPECT AVENUE"
2,0,2,"ad8fd48d-ebf6-ea11-b883-24ee9a37d459","Robert E. Peary School - Q075 - Q048 - 75Q075 - 155-02 108 AVENUE","598946f4-31f4-ea11-b882-24ee9a37d45c",-73796358,40693736,"P.S. 48 - QUEENS","155-02 108 AVENUE"
5,3,2,"1a30f69f-ebf6-ea11-b883-24ee9a37d459","Robert E. Peary School - Q075 - Q223 - 75Q075 - 125-20 SUTPHIN BOULEVARD","09b7c337-32f4-ea11-b882-24ee9a37d45c",-73789530,40673898,"P.S. 223 - QUEENS","125-20 SUTPHIN BOULEVARD"
2,1,1,"caba3c50-33f4-ea11-b882-24ee9a37d45c","Jonas Bronck Academy - X228 - X283 - 10X228 - 400 EAST FORDHAM ROAD","cbba3c50-33f4-ea11-b882-24ee9a37d45c",-73891562,40860987,"Jonas Bronck Academy","400 EAST FORDHAM ROAD"
2,0,2,"e0ba3c50-33f4-ea11-b882-24ee9a37d45c","The Matilda Avenue School - X483 - X314 - 11X483 - 4520 MATILDA AVENUE","dfba3c50-33f4-ea11-b882-24ee9a37d45c",-73854402,40901436,"P.S. 314 - BRONX","4520 MATILDA AVENUE"
1,1,0,"82f4a0ef-eaf6-ea11-b883-24ee9a37d459","The Little Brooklyn Pre-K Center - K767 - K749 - 15K767 - 173-177 25TH STREET","492f7d06-31f4-ea11-b882-24ee9a37d45c",-73998973,40661059,"PRE-K CENTER @25TH STREET - BROOKLYN","173-177 25TH STREET"
1,0,1,"a7886843-31f4-ea11-b882-24ee9a37d45c","P.S. 015 Roberto Clemente - M015 - M015 - 01M015 - 333 EAST  4 STREET","a5886843-31f4-ea11-b882-24ee9a37d45c",-73978747,40722075,"P.S. 15 - MANHATTAN","333 EAST  4 STREET"
5,2,3,"555b4cd6-32f4-ea11-b882-24ee9a37d45c","Port Richmond High School - R445 - R445 - 31R445 - 85 ST JOSEPHS AVENUE","515b4cd6-32f4-ea11-b882-24ee9a37d45c",-74141924,40635562,"PORT RICHMOND HS - S. I.","85 ST JOSEPHS AVENUE"
1,0,1,"3d88e6db-30f4-ea11-b882-24ee9a37d45c","World Academy for Total Community Health High School - K510 - K435 - 19K510 - 400 PENNSYLVANIA AVENUE","3688e6db-30f4-ea11-b882-24ee9a37d45c",-73895122,40666868,"THOMAS JEFFERSON HS - K","400 PENNSYLVANIA AVENUE"
1,0,1,"f8ce496e-31f4-ea11-b882-24ee9a37d45c","Castle Bridge School - M513 - M128 - 06M513 - 560 WEST 169 STREET","f9ce496e-31f4-ea11-b882-24ee9a37d45c",-73938701,40841032,"P.S. 128 - MANHATTAN","560 WEST 169 STREET"
2,2,0,"38005d7a-31f4-ea11-b882-24ee9a37d45c","J.H.S. 167 Robert F. Wagner - M167 - M167 - 02M167 - 220 EAST  76 STREET","39005d7a-31f4-ea11-b882-24ee9a37d45c",-73957827,40771541,"I.S. 167 - MANHATTAN","220 EAST  76 STREET"
1,1,0,"418dbfcf-30f4-ea11-b882-24ee9a37d45c","Kingsborough Early College School - K468 - K400 - 21K468 - 2630 BENSON AVENUE","3a8dbfcf-30f4-ea11-b882-24ee9a37d45c",-73986313,40593028,"Lafayette Educational Campus","2630 BENSON AVENUE"
2,2,0,"e0e0838c-31f4-ea11-b882-24ee9a37d45c","P.S. 051 Elias Howe - M051 - M338 - 02M051 - 525 WEST 44TH STREET","dfe0838c-31f4-ea11-b882-24ee9a37d45c",-73995825,40761487,"P.S. 51 ELIAS HOWE - MANHATTAN","525 WEST 44TH STREET"
1,1,0,"dd9b4c1f-32f4-ea11-b882-24ee9a37d45c","P.S. 152 Gwendoline N. Alleyne School - Q152 - Q152 - 30Q152 - 33-52 62 STREET","de9b4c1f-32f4-ea11-b882-24ee9a37d45c",-73900584,40753094,"P.S. 152 - QUEENS","33-52 62 STREET"
