"TotalCases","StudentCases","EmployeeCases","nycsr_locationsiteid","nycsr_sitename","nycsr_building.nycsr_buildingid","nycsr_building.nycsr_longitude","nycsr_building.nycsr_latitude","nycsr_building.nycsr_buildingname","nycsr_building.nycsr_address"
1,1,0,"de315367-30f4-ea11-b882-24ee9a37d45c","P.S. 135 Sheldon A. Brookner - K135 - K135 - 18K135 - 684 LINDEN BOULEVARD","df315367-30f4-ea11-b882-24ee9a37d45c",-73932949,40653093,"P.S. 135 - BROOKLYN","684 LINDEN BOULEVARD"
2,2,0,"b5bfa431-33f4-ea11-b882-24ee9a37d45c","Kappa - X215 - X148 - 09X215 - 3630 THIRD AVENUE","b0bfa431-33f4-ea11-b882-24ee9a37d45c",-73903951,40833493,"I.S. 219 (OLD 148) - BRONX","3630 THIRD AVENUE"
5,1,4,"d03159fa-30f4-ea11-b882-24ee9a37d45c","Sunset Park High School - K667 - K564 - 15K667 - 153 35 Street","18fc3df4-30f4-ea11-b882-24ee9a37d45c",-74004342,40655583,"SUNSET PARK HS - BROOKLYN","153 35 Street"
1,0,1,"aa72c880-32f4-ea11-b882-24ee9a37d45c","High School for Law Enforcement and Public Safety - Q690 - Q690 - 28Q690 - 116-25 GUY R BREWER BOULEVARD","a972c880-32f4-ea11-b882-24ee9a37d45c",-73783438,40685838,"HS FOR LAW ENFORCEMENT - QUEENS","116-25 GUY R BREWER BOULEVARD"
1,0,1,"653cbf01-ebf6-ea11-b883-24ee9a37d459","The Bronx School for Continuous Learners - X469 - X177 - 75X469 - 3177 WEBSTER AVENUE","dc8a0044-33f4-ea11-b882-24ee9a37d45c",-73875375,40872559,"THE NORWOOD EAST CAMPUS - BRONX","3177 WEBSTER AVENUE"
1,1,0,"28e0d393-ebf6-ea11-b883-24ee9a37d459","P.S. Q004 - Q004 - Q138 - 75Q004 - 251-11 WELLER AVENUE","1aaf0313-32f4-ea11-b882-24ee9a37d45c",-73734342,40659876,"P.S. 138 - QUEENS","251-11 WELLER AVENUE"
6,4,2,"46b4977a-32f4-ea11-b882-24ee9a37d45c","Aviation Career & Technical Education High School - Q610 - Q610 - 24Q610 - 45-30 36 STREET","44b4977a-32f4-ea11-b882-24ee9a37d45c",-73929577,40743309,"AVIATION HS - Q","45-30 36 STREET"
3,3,0,"d82ff20c-32f4-ea11-b882-24ee9a37d45c","P.S./I.S. 119 The Glendale - Q119 - Q119 - 24Q119 - 74-01 78 AVENUE","d92ff20c-32f4-ea11-b882-24ee9a37d45c",-73875073,40705187,"I.S. 119 - QUEENS","74-01 78 AVENUE"
1,1,0,"c837fba4-31f4-ea11-b882-24ee9a37d45c","Park East High School - M495 - M495 - 04M495 - 230 EAST 105 STREET","c737fba4-31f4-ea11-b882-24ee9a37d45c",-73944092,40790191,"PARK EAST HS - MANHATTAN","230 EAST 105 STREET"
1,1,0,"cc0d3c5b-30f4-ea11-b882-24ee9a37d45c","P.S. 97 The Highlawn - K097 - K097 - 21K097 - 1846 West 13 Street","cd0d3c5b-30f4-ea11-b882-24ee9a37d45c",-73985570,40601191,"P.S. 97 - BROOKLYN","1846 West 13 Street"
1,0,1,"c0e0838c-31f4-ea11-b882-24ee9a37d45c","East Side Elementary School, PS 267 - M267 - M267 - 02M267 - 213 EAST 63RD STREET","c1e0838c-31f4-ea11-b882-24ee9a37d45c",-73963861,40763883,"P.S. 59 - (MEETH) -MANHATTAN","213 EAST 63RD STREET"
1,0,1,"19e85c61-30f4-ea11-b882-24ee9a37d45c","I.S. 347 School of Humanities - K347 - K111 - 32K347 - 35 STARR STREET","18e85c61-30f4-ea11-b882-24ee9a37d45c",-73927938,40700810,"I.S. 111 - BROOKLYN","35 STARR STREET"
1,0,1,"cf0d3c5b-30f4-ea11-b882-24ee9a37d45c","P.S. 099 Isaac Asimov - K099 - K099 - 21K099 - 1120 EAST 10 STREET","d00d3c5b-30f4-ea11-b882-24ee9a37d45c",-73966031,40621474,"P.S. 99 - BROOKLYN","1120 EAST 10 STREET"
1,0,1,"bd69c231-32f4-ea11-b882-24ee9a37d45c","P.S. 212 - Q212 - Q212 - 30Q212 - 34-25 82 STREET","b969c231-32f4-ea11-b882-24ee9a37d45c",-73884458,40753035,"P.S. 212 - QUEENS","34-25 82 STREET"
4,1,3,"8d41e65b-31f4-ea11-b882-24ee9a37d45c","P.S. 087 William Sherman - M087 - M087 - 03M087 - 160 WEST 78 STREET","8e41e65b-31f4-ea11-b882-24ee9a37d45c",-73978020,40781710,"P.S. 87 - MANHATTAN","160 WEST 78 STREET"
9,7,2,"02fc3df4-30f4-ea11-b882-24ee9a37d45c","Leon M. Goldstein High School for the Sciences - K535 - K535 - 22K535 - 1830 SHORE BOULEVARD","01fc3df4-30f4-ea11-b882-24ee9a37d45c",-73934449,40578356,"LEON GOLDSTEIN HS - BROOKLYN","1830 SHORE BOULEVARD"
2,0,2,"e621d292-30f4-ea11-b882-24ee9a37d45c","P.S. K225 - The Eileen E. Zaglin - K225 - K225 - 21K225 - 1075 OCEAN VIEW AVENUE","e521d292-30f4-ea11-b882-24ee9a37d45c",-73955856,40580260,"P.S. 225 - BROOKLYN","1075 OCEAN VIEW AVENUE"
4,4,0,"9f476368-32f4-ea11-b882-24ee9a37d45c","Flushing High School - Q460 - Q460 - 25Q460 - 35-01 UNION STREET","97476368-32f4-ea11-b882-24ee9a37d45c",-73826811,40764892,"FLUSHING HS - Q","35-01 UNION STREET"
1,0,1,"80f4a0ef-eaf6-ea11-b883-24ee9a37d459","Adult and Continuing Education - K755 - K743 - 79K755 - 475 NOSTRAND AVENUE","412f7d06-31f4-ea11-b882-24ee9a37d45c",-73949130,40681512,"ADULT LRNG CTR (OLD GRLS HS) - K","475 NOSTRAND AVENUE"
2,2,0,"172ed53d-33f4-ea11-b882-24ee9a37d45c","P.S. 214 - X214 - X167 - 12X214 - 1970 WEST FARMS ROAD","152ed53d-33f4-ea11-b882-24ee9a37d45c",-73879931,40839297,"P.S. 214 - BRONX","1970 WEST FARMS ROAD"
2,2,0,"90c280bd-31f4-ea11-b882-24ee9a37d45c","Harvest Collegiate High School - M534 - M883 - 02M534 - 34 WEST 14 STREET","8fc280bd-31f4-ea11-b882-24ee9a37d45c",-73995731,40736416,"LEGACY HS FOR INTEGR. STUDIES - M","34 WEST 14 STREET"
3,0,3,"b5b36d80-30f4-ea11-b882-24ee9a37d45c","P.S. 179 Kensington - K179 - K179 - 20K179 - 202 AVENUE C","13d1de79-30f4-ea11-b882-24ee9a37d45c",-73977260,40640127,"P.S. 179 - BROOKLYN","202 AVENUE C"
1,0,1,"8453dd74-33f4-ea11-b882-24ee9a37d45c","Bronx Health Sciences High School - X249 - X455 - 11X249 - 750 BAYCHESTER AVENUE","8253dd74-33f4-ea11-b882-24ee9a37d45c",-73831669,40874035,"HARRY S. TRUMAN HS - X","750 BAYCHESTER AVENUE"
2,0,2,"3d3cbf01-ebf6-ea11-b883-24ee9a37d459","John F. Kennedy Jr. School - Q721 - Q722 - 75Q721 - 57-12 94 STREET","b172c880-32f4-ea11-b882-24ee9a37d45c",-73867882,40735613,"JOHN F. KENNEDY JR. SCHOOL - QUEENS","57-12 94 STREET"
3,1,2,"16a31781-33f4-ea11-b882-24ee9a37d45c","Bronx Leadership Academy II High School - X527 - X790 - 07X527 - 730 CONCOURSE VILLAGE WEST","0ea31781-33f4-ea11-b882-24ee9a37d45c",-73922366,40821828,"MOTT HAVEN EDUCATIONAL CAMPUS - BRONX","730 CONCOURSE VILLAGE WEST"
1,0,1,"a732c3fb-eaf6-ea11-b883-24ee9a37d459","P.S. Q177 - Q177 - Q177 - 75Q177 - 56-37 188 STREET","8b0e6e25-32f4-ea11-b882-24ee9a37d45c",-73787419,40743400,"P.S. 177 - QUEENS","56-37 188 STREET"
6,1,5,"553cbf01-ebf6-ea11-b883-24ee9a37d459","The David Marquis School of the Arts - R037 - R840 - 75R037 - 15 Fairfield Street","81be7adc-32f4-ea11-b882-24ee9a37d45c",-74151368,40564100,"P.S. 37 ( OLD I24X)-STATEN ISLAND","15 Fairfield Street"
2,2,0,"989c11e8-30f4-ea11-b882-24ee9a37d45c","Millennium Brooklyn HS - K684 - K460 - 15K684 - 237 7 AVENUE","929c11e8-30f4-ea11-b882-24ee9a37d45c",-73978580,40669255,"John Jay Educational Campus","237 7 AVENUE"
1,0,1,"8f53dd74-33f4-ea11-b882-24ee9a37d45c","Eagle Academy for Young Men - X231 - X465 - 09X231 - 4143 Third Avenue","8b53dd74-33f4-ea11-b882-24ee9a37d45c",-73897479,40845366,"Eagle Academy For Young Men - Bronx","4143 Third Avenue"
3,2,1,"75bc9674-32f4-ea11-b882-24ee9a37d45c","Grover Cleveland High School - Q485 - Q485 - 24Q485 - 21-27 HIMROD STREET","74bc9674-32f4-ea11-b882-24ee9a37d45c",-73909202,40711881,"GROVER CLEVELAND HS - Q","21-27 HIMROD STREET"
1,0,1,"54de5eb7-30f4-ea11-b882-24ee9a37d45c","Brighter Choice Community School - K627 - K304 - 16K627 - 280 HART STREET","53de5eb7-30f4-ea11-b882-24ee9a37d45c",-73941278,40693654,"P.S. 304 - BROOKLYN","280 HART STREET"
2,2,0,"4c8dbfcf-30f4-ea11-b882-24ee9a37d45c","Midwood High School - K405 - K405 - 22K405 - 2839 BEDFORD AVENUE","4d8dbfcf-30f4-ea11-b882-24ee9a37d45c",-73952356,40632829,"MIDWOOD HS - K","2839 BEDFORD AVENUE"
1,0,1,"35a10a44-32f4-ea11-b882-24ee9a37d45c","The Randolph Holder School for Social Justice - Q253 - Q253 - 27Q253 - 1307 CENTRAL AVENUE","30a10a44-32f4-ea11-b882-24ee9a37d45c",-73748799,40607247,"P.S. 253 -QUEENS","1307 CENTRAL AVENUE"
1,1,0,"e42ece86-32f4-ea11-b882-24ee9a37d45c","Young Women's Leadership School, Astoria - Q286 - Q739 - 30Q286 - 23-15 Newtown Avenue","e52ece86-32f4-ea11-b882-24ee9a37d45c",-73923830,40770769,"YOUNG WOMEN'S LEADERSHIP ACADEMY- QUEENS","23-15 Newtown Avenue"
2,0,2,"42a10a44-32f4-ea11-b882-24ee9a37d45c","New York City Academy for Discovery - Q306 - Q262 - 27Q306 - 95-16 89TH AVENUE","43a10a44-32f4-ea11-b882-24ee9a37d45c",-73848577,40691482,"P.S. 262 - QUEENS","95-16 89TH AVENUE"
1,0,1,"00d1de79-30f4-ea11-b882-24ee9a37d45c","Brooklyn Gardens Elementary School - K557 - K174 - 19K557 - 574 DUMONT AVENUE","fbd0de79-30f4-ea11-b882-24ee9a37d45c",-73897604,40665446,"P.S. 174 - BROOKLYN","574 DUMONT AVENUE"
3,2,1,"4e2b3eee-30f4-ea11-b882-24ee9a37d45c","The Christa McAuliffe School\I.S. 187 - K187 - K486 - 20K187 - 1171 65 STREET","4f2b3eee-30f4-ea11-b882-24ee9a37d45c",-74003883,40627929,"I.S. 187 - BROOKLYN","1171 65 STREET"
2,1,1,"bebfa431-33f4-ea11-b882-24ee9a37d45c","South Bronx Preparatory: A College Board School - X221 - X149 - 07X221 - 360 EAST 145 STREET","bcbfa431-33f4-ea11-b882-24ee9a37d45c",-73920851,40813612,"J.H.S. 149 - BRONX","360 EAST 145 STREET"
2,1,1,"15a31781-33f4-ea11-b882-24ee9a37d45c","P.S. X188 - X188 - X790 - 75X188 - 730 CONCOURSE VILLAGE WEST","0ea31781-33f4-ea11-b882-24ee9a37d45c",-73922366,40821828,"MOTT HAVEN EDUCATIONAL CAMPUS - BRONX","730 CONCOURSE VILLAGE WEST"
1,1,0,"237eed06-32f4-ea11-b882-24ee9a37d45c","I.S. 093 Ridgewood - Q093 - Q093 - 24Q093 - 66-56 FOREST AVENUE","0f7eed06-32f4-ea11-b882-24ee9a37d45c",-73903057,40705609,"I.S. 93 - QUEENS","66-56 FOREST AVENUE"
1,0,1,"438dbfcf-30f4-ea11-b882-24ee9a37d45c","Life Academy High School for Film and Music - K559 - K400 - 21K559 - 2630 BENSON AVENUE","3a8dbfcf-30f4-ea11-b882-24ee9a37d45c",-73986313,40593028,"Lafayette Educational Campus","2630 BENSON AVENUE"
1,0,1,"e79319d7-ebf6-ea11-b883-24ee9a37d459","The Richard H. Hungerford School - R721 - R435 - 75R721 - 465 NEW DORP LANE","fb8521d0-32f4-ea11-b882-24ee9a37d45c",-74105878,40570909,"NEW DORP HS (NEW) - S. I.","465 NEW DORP LANE"
1,0,1,"d78a0044-33f4-ea11-b882-24ee9a37d45c","Archimedes Academy for Math, Science and Technology Applications - X367 - X174 - 08X367 - 456 WHITE PLAINS ROAD","2a2ed53d-33f4-ea11-b882-24ee9a37d45c",-73856070,40815043,"I.S. 174 - BRONX","456 WHITE PLAINS ROAD"
1,0,1,"dca2f813-ebf6-ea11-b883-24ee9a37d459","The Joan Snow Pre-K Center - K853 - K063 - 22K853 - 1340 EAST 29TH STREET","c879df48-30f4-ea11-b882-24ee9a37d45c",-73946330,40618450,"PRE-K CENTER @1340 EAST 29TH STREET - BROOKLYN","1340 EAST 29TH STREET"
2,1,1,"fef22ce2-31f4-ea11-b882-24ee9a37d45c","P.S. 011 Kathryn Phelan - Q011 - Q011 - 30Q011 - 54-25 SKILLMAN AVENUE","fff22ce2-31f4-ea11-b882-24ee9a37d45c",-73909032,40746127,"P.S. 11 - QUEENS","54-25 SKILLMAN AVENUE"
2,0,2,"68f4a0ef-eaf6-ea11-b883-24ee9a37d459","P.S. K811 Connie Lekas School - K811 - K286 - 75K811 - 2525 HARING STREET","6e283fb1-30f4-ea11-b882-24ee9a37d45c",-73938610,40591132,"P.S. 811 (OLD P286) - BROOKLYN","2525 HARING STREET"
2,1,1,"10ba8b86-30f4-ea11-b882-24ee9a37d45c","P.S. 205 Clarion - K205 - K205 - 20K205 - 6701 20 AVENUE","11ba8b86-30f4-ea11-b882-24ee9a37d45c",-73986792,40614737,"P.S. 205 - BROOKLYN","6701 20 AVENUE"
1,0,1,"1c7eed06-32f4-ea11-b882-24ee9a37d45c","P.S. 090 Horace Mann - Q090 - Q090 - 27Q090 - 86-50 109 STREET","1d7eed06-32f4-ea11-b882-24ee9a37d45c",-73839517,40696653,"P.S. 90 - QUEENS","86-50 109 STREET"
3,0,3,"1830f69f-ebf6-ea11-b883-24ee9a37d459","P.S. Q004 - Q004 - Q213 - 75Q004 - 231-02 67 AVENUE","f8b6c337-32f4-ea11-b882-24ee9a37d45c",-73745390,40747457,"P.S. 213 - QUEENS","231-02 67 AVENUE"
1,0,1,"b856635c-33f4-ea11-b882-24ee9a37d45c","Renaissance High School for Musical Theater and the Arts - X293 - X405 - 08X293 - 3000 EAST TREMONT AVENUE","b556635c-33f4-ea11-b882-24ee9a37d45c",-73839583,40839775,"HERBERT H. LEHMAN HS - X","3000 EAST TREMONT AVENUE"
1,0,1,"9328a20c-31f4-ea11-b882-24ee9a37d45c","Science Skills Center High School for Science, Technology and the Creative Arts - K419 - K805 - 13K419 - 49 FLATBUSH AVENUE EXTENSION","9428a20c-31f4-ea11-b882-24ee9a37d45c",-73984528,40697330,"WATER'S EDGE EDUCATIONAL CAMPUS - K","49 FLATBUSH AVENUE EXTENSION"
1,1,0,"6c977d2b-32f4-ea11-b882-24ee9a37d45c","P.S. 188 Kingsbury - Q188 - Q188 - 26Q188 - 218-12 HARTLAND AVENUE","6d977d2b-32f4-ea11-b882-24ee9a37d45c",-73753985,40736063,"P.S. 188 - QUEENS","218-12 HARTLAND AVENUE"
2,2,0,"a672c880-32f4-ea11-b882-24ee9a37d45c","Queens Metropolitan High School - Q686 - Q686 - 28Q686 - 91-30 METROPOLITAN AVENUE","a372c880-32f4-ea11-b882-24ee9a37d45c",-73855543,40708431,"METROPOLITAN AVENUE CAMPUS - QUEENS","91-30 METROPOLITAN AVENUE"
1,1,0,"15fc3df4-30f4-ea11-b882-24ee9a37d45c","District 20 Pre-K Center - K768 - K560 - 20K768 - 550 59 Street","16fc3df4-30f4-ea11-b882-24ee9a37d45c",-74014450,40639394,"PRE-K CENTER @ 550 59 STREET - BROOKLYN","550 59 Street"
1,1,0,"b272c880-32f4-ea11-b882-24ee9a37d45c","Robert F. Kennedy Community High School - Q670 - Q707 - 25Q670 - 75-40 PARSONS BOULEVARD","b372c880-32f4-ea11-b882-24ee9a37d45c",-73811408,40725280,"R. F. KENNEDY COMM. MIDDLE/HS-Q","75-40 PARSONS BOULEVARD"
8,7,1,"5d07e99e-31f4-ea11-b882-24ee9a37d45c","Stuyvesant High School - M475 - M477 - 02M475 - 345 CHAMBERS STREET","5c07e99e-31f4-ea11-b882-24ee9a37d45c",-74013921,40718025,"STUYVESANT HS (NEW) - MANHATTAN","345 CHAMBERS STREET"
1,1,0,"07f32ce2-31f4-ea11-b882-24ee9a37d45c","P.S. 014 Fairview - Q014 - Q014 - 24Q014 - 107-01 OTIS AVENUE","faf22ce2-31f4-ea11-b882-24ee9a37d45c",-73854570,40741020,"P.S. 14 - QUEENS","107-01 OTIS AVENUE"
1,0,1,"6f283fb1-30f4-ea11-b882-24ee9a37d45c","I.S. 285 Meyer Levin - K285 - K285 - 18K285 - 5909 BEVERLY ROAD","70283fb1-30f4-ea11-b882-24ee9a37d45c",-73920784,40647818,"I.S. 285 - BROOKLYN","5909 BEVERLY ROAD"
1,0,1,"8d83ff9e-30f4-ea11-b882-24ee9a37d45c","P.S. 247 Brooklyn - K247 - K247 - 20K247 - 7000 21 AVENUE","8e83ff9e-30f4-ea11-b882-24ee9a37d45c",-73987195,40612247,"P.S. 247 - BROOKLYN","7000 21 AVENUE"
1,0,1,"b9bf14dd-ebf6-ea11-b883-24ee9a37d459","District 75 Secondary Site 75R037 (R844) - S057 - R844 -  - 200 Jefferson Blvd","8311b2e2-32f4-ea11-b882-24ee9a37d45c",-74182548,40543433,"P.S. 36 ANNEX - STATEN ISLAND","200 Jefferson Blvd"
2,0,2,"240b210d-33f4-ea11-b882-24ee9a37d45c","P.S. 076 The Bennington School - X076 - X076 - 11X076 - 900 ADEE AVENUE","250b210d-33f4-ea11-b882-24ee9a37d45c",-73860928,40869059,"P.S. 76 - BRONX","900 ADEE AVENUE"
1,1,0,"722f77fa-31f4-ea11-b882-24ee9a37d45c","J.H.S. 067 Louis Pasteur - Q067 - Q067 - 26Q067 - 51-60 MARATHON PARKWAY","732f77fa-31f4-ea11-b882-24ee9a37d45c",-73734832,40762241,"J.H.S. 67 - QUEENS","51-60 MARATHON PARKWAY"
1,1,0,"40474313-33f4-ea11-b882-24ee9a37d45c","P.S. 097 Bronx - X097 - X097 - 11X097 - 1375 Mace Avenue","41474313-33f4-ea11-b882-24ee9a37d45c",-73846768,40863524,"P.S. 97 - BRONX","1375 Mace Avenue"
1,0,1,"16a198c3-30f4-ea11-b882-24ee9a37d45c","P.S./I.S. 30 Mary White Ovington - K030 - K331 - 20K030 - 7002 4TH AVENUE","15a198c3-30f4-ea11-b882-24ee9a37d45c",-74023950,40633598,"P.S./I.S.30 MARY WHITE OVINGTON - BROOKLYN","7002 4TH AVENUE"
1,0,1,"3a767649-31f4-ea11-b882-24ee9a37d45c","P.S. 028 Wright Brothers - M028 - M028 - 06M028 - 475 WEST 155 STREET","3b767649-31f4-ea11-b882-24ee9a37d45c",-73942023,40831630,"P.S. 28 - MANHATTAN","475 WEST 155 STREET"
2,0,2,"b2689025-33f4-ea11-b882-24ee9a37d45c","Pugsley Preparatory Academy - X562 - X125 - 08X562 - 1111 Pugsley Avenue","af689025-33f4-ea11-b882-24ee9a37d45c",-73857882,40829153,"I.S. 125 - BRONX","1111 Pugsley Avenue"
1,0,1,"81eb6056-32f4-ea11-b882-24ee9a37d45c","The Woodside Community School - Q361 - Q339 - 30Q361 - 39-07 57th Street","82eb6056-32f4-ea11-b882-24ee9a37d45c",-73906430,40747701,"P.S. 339 - Queens","39-07 57th Street"
3,3,0,"240410ca-32f4-ea11-b882-24ee9a37d45c","Naples Street Elementary School - R009 - R048 - 31R009 - 1055 Targee Street","250410ca-32f4-ea11-b882-24ee9a37d45c",-74090245,40602650,"P.S. 48 - STATEN ISLAND","1055 Targee Street"
2,1,1,"8fe657bd-30f4-ea11-b882-24ee9a37d45c","P.S. 503: The School of Discovery - K503 - K314 - 20K503 - 330 59 Street","8ee657bd-30f4-ea11-b882-24ee9a37d45c",-74019299,40641950,"P.S. 314 - BROOKLYN","330 59 Street"
1,0,1,"6e36d900-33f4-ea11-b882-24ee9a37d45c","P.S. 056 Norwood Heights - X056 - X056 - 10X056 - 341 EAST 207 STREET","6f36d900-33f4-ea11-b882-24ee9a37d45c",-73874912,40875481,"P.S. 56 - BRONX","341 EAST 207 STREET"
1,1,0,"692f77fa-31f4-ea11-b882-24ee9a37d45c","P.S. 063 Old South - Q063 - Q063 - 27Q063 - 90-15 SUTTER AVENUE","6a2f77fa-31f4-ea11-b882-24ee9a37d45c",-73846796,40676978,"P.S. 63 - QUEENS","90-15 SUTTER AVENUE"
1,1,0,"0678931f-33f4-ea11-b882-24ee9a37d45c","I.S. 117 Joseph H. Wade - X117 - X117 - 09X117 - 1865 MORRIS AVENUE","0578931f-33f4-ea11-b882-24ee9a37d45c",-73909022,40848552,"I.S. 117 - BRONX","1865 MORRIS AVENUE"
1,1,0,"c056635c-33f4-ea11-b882-24ee9a37d45c","Herbert H. Lehman High School - X405 - X405 - 08X405 - 3000 EAST TREMONT AVENUE","b556635c-33f4-ea11-b882-24ee9a37d45c",-73839583,40839775,"HERBERT H. LEHMAN HS - X","3000 EAST TREMONT AVENUE"
2,1,1,"e38521d0-32f4-ea11-b882-24ee9a37d45c","I.S. 072 Rocco Laurie - R072 - R072 - 31R072 - 33 FERNDALE AVENUE","e48521d0-32f4-ea11-b882-24ee9a37d45c",-74158618,40592132,"I.S. 72 - STATEN ISLAND","33 FERNDALE AVENUE"
4,2,2,"d479df48-30f4-ea11-b882-24ee9a37d45c","Community Roots Charter School - K536 - K067 - 84K536 - 51 SAINT EDWARDS STREET","d179df48-30f4-ea11-b882-24ee9a37d45c",-73977674,40695339,"P.S. 67 - BROOKLYN","51 SAINT EDWARDS STREET"
1,0,1,"ede13320-ebf6-ea11-b883-24ee9a37d459","P.S. 36 - K036 - K213 - 75K036 - 580 HEGEMAN AVENUE","435bc58c-30f4-ea11-b882-24ee9a37d45c",-73889968,40659845,"P.S. 213 - BROOKLYN","580 HEGEMAN AVENUE"
1,1,0,"1eb4977a-32f4-ea11-b882-24ee9a37d45c","Townsend Harris High School - Q525 - Q515 - 25Q525 - 149-11 MELBOURNE AVENUE","1db4977a-32f4-ea11-b882-24ee9a37d45c",-73821532,40737038,"TOWNSEND HARRIS HS - Q","149-11 MELBOURNE AVENUE"
2,1,1,"0aba8b86-30f4-ea11-b882-24ee9a37d45c","P.S. 203 Floyd Bennett School - K203 - K203 - 22K203 - 5101 AVENUE M","0bba8b86-30f4-ea11-b882-24ee9a37d45c",-73925732,40622108,"P.S. 203 - BROOKLYN","5101 AVENUE M"
1,0,1,"4c507380-31f4-ea11-b882-24ee9a37d45c","Professor Juan Bosch Public School - M178 - M178 - 06M178 - 12-18 ELLWOOD STREET","4d507380-31f4-ea11-b882-24ee9a37d45c",-73928301,40859240,"P.S. 178 - MANHATTAN","12-18 ELLWOOD STREET"
1,1,0,"307c21b7-32f4-ea11-b882-24ee9a37d45c","I.S. R002 George L. Egbert - R002 - R002 - 31R002 - 333 Midland Avenue","2b7c21b7-32f4-ea11-b882-24ee9a37d45c",-74099685,40576728,"I.S. 2 - STATEN ISLAND","333 Midland Avenue"
1,0,1,"78977d2b-32f4-ea11-b882-24ee9a37d45c","J.H.S. 190 Russell Sage - Q190 - Q190 - 28Q190 - 68-17 AUSTIN STREET","75977d2b-32f4-ea11-b882-24ee9a37d45c",-73851700,40723478,"J.H.S. 190 - QUEENS","68-17 AUSTIN STREET"
2,1,1,"a5edf392-32f4-ea11-b882-24ee9a37d45c","Joseph F. Quinn Intermediate School 77 - Q077 - Q849 - 24Q077 - 976 Seneca Avenue","a4edf392-32f4-ea11-b882-24ee9a37d45c",-73902147,40699101,"I.S. 77 - QUEENS","976 Seneca Avenue"
1,1,0,"dc201dab-30f4-ea11-b882-24ee9a37d45c","Leadership Preparatory Brownsville Charter School - K711 - K275 - 84K711 - 985 ROCKAWAY AVENUE","d2201dab-30f4-ea11-b882-24ee9a37d45c",-73906662,40655644,"I.S. 275 - BROOKLYN","985 ROCKAWAY AVENUE"
1,0,1,"f391111a-ebf6-ea11-b883-24ee9a37d459","P.S. 372 -The Children's School - K372 - K113 - 75K372 - 300 ADELPHI STREET","1fe85c61-30f4-ea11-b882-24ee9a37d45c",-73971474,40688769,"I.S. 113 - BROOKLYN","300 ADELPHI STREET"
2,1,1,"0fa6ba98-31f4-ea11-b882-24ee9a37d45c","University Neighborhood High School - M448 - M446 - 01M448 - 200 Monroe Street","10a6ba98-31f4-ea11-b882-24ee9a37d45c",-73984128,40712269,"UNIVERSITY NEIGHBORHOOD - M","200 Monroe Street"
1,0,1,"72f4a0ef-eaf6-ea11-b883-24ee9a37d459","P.S. K369 - Coy L. Cox School - K369 - K369 - 75K369 - 383 STATE STREET","03e2abc9-30f4-ea11-b882-24ee9a37d45c",-73983312,40687432,"P.S. 369 (COY COX SCHOOL)-K","383 STATE STREET"
3,2,1,"ef9b4c1f-32f4-ea11-b882-24ee9a37d45c","J.H.S. 157 Stephen A. Halsey - Q157 - Q157 - 28Q157 - 63-55 102ND STREET","f09b4c1f-32f4-ea11-b882-24ee9a37d45c",-73852879,40732348,"J.H.S. 157 - QUEENS","63-55 102ND STREET"
3,3,0,"d90d3c5b-30f4-ea11-b882-24ee9a37d45c","P.S. 102 The Bayview - K102 - K102 - 20K102 - 211 72 STREET","da0d3c5b-30f4-ea11-b882-24ee9a37d45c",-74028758,40634318,"P.S. 102 - BROOKLYN","211 72 STREET"
1,0,1,"e2f57030-30f4-ea11-b882-24ee9a37d45c","Dr. Jacqueline Peek-Davis School - K012 - K012 - 17K012 - 430 HOWARD AVENUE","def57030-30f4-ea11-b882-24ee9a37d45c",-73920095,40673124,"P.S. 12 - BROOKLYN","430 HOWARD AVENUE"
2,2,0,"4dfdc1bd-32f4-ea11-b882-24ee9a37d45c","P.S. 11 Thomas Dongan School - R011 - R011 - 31R011 - 51 Jefferson Street","4efdc1bd-32f4-ea11-b882-24ee9a37d45c",-74098252,40590887,"P.S. 11 - STATEN ISLAND","51 Jefferson Street"
1,1,0,"920e6e25-32f4-ea11-b882-24ee9a37d45c","P.S. 174 William Sidney Mount - Q174 - Q174 - 28Q174 - 65-10 DIETERLE CRESCENT","930e6e25-32f4-ea11-b882-24ee9a37d45c",-73861462,40720583,"P.S. 174 - QUEENS","65-10 DIETERLE CRESCENT"
1,0,1,"0fead4e1-d214-ec11-b8b5-24ee9a37d45c","East New York Family Academy - K409 - K599 - 19K409 - 760 Van Siclen Avenue","7b3fd300-d214-ec11-b8b5-24ee9a37d45c",-73886668,40661102,"K599 – East New York","760 Van Siclen Avenue"
2,0,2,"3f953aac-ebf6-ea11-b883-24ee9a37d459","Mosaic Pre-K Center - Q331 - Q321 - 24Q331 - 70-24 47th Avenue","ea454b50-32f4-ea11-b882-24ee9a37d45c",-73893173,40738643,"PRE-K CENTER @47TH AVENUE - QUEENS","70-24 47th Avenue"
5,3,2,"2ca6ba98-31f4-ea11-b882-24ee9a37d45c","High School for Law and Public Service - M467 - M465 - 06M467 - 549 AUDUBON AVENUE","25a6ba98-31f4-ea11-b882-24ee9a37d45c",-73926060,40856532,"G. WASHINGTON HS EDUC. CAMPUS - M","549 AUDUBON AVENUE"
2,0,2,"6c8946f4-31f4-ea11-b882-24ee9a37d45c","P.S. 051 - Q051 - Q051 - 27Q051 - 87-45 117 STREET","6d8946f4-31f4-ea11-b882-24ee9a37d45c",-73831532,40698286,"P.S. 51 (ECC) - QUEENS","87-45 117 STREET"
2,2,0,"db21d292-30f4-ea11-b882-24ee9a37d45c","P.S. 222 Katherine R. Snyder - K222 - K222 - 22K222 - 3301 QUENTIN ROAD","dc21d292-30f4-ea11-b882-24ee9a37d45c",-73939205,40614005,"P.S. 222 - BROOKLYN","3301 QUENTIN ROAD"
1,0,1,"e622f4ed-49fb-ea11-b883-24ee9a37d459","Strong Place for Hope Day Care Center/DBA Strong Place for Hope Day Care - KBFN - KBIY -  - 333 2 STREET","e722f4ed-49fb-ea11-b883-24ee9a37d459",-73983488,40673996,"ALONZO A. DAUGHTRY MEMORIAL DAY CARE CENTER SITE 2","333 2 STREET"
1,1,0,"b82ff20c-32f4-ea11-b882-24ee9a37d45c","P.S. 108 Captain Vincent G. Fowler - Q108 - Q108 - 27Q108 - 108-10 109 AVENUE","b92ff20c-32f4-ea11-b882-24ee9a37d45c",-73831025,40679083,"P.S. 108 - QUEENS","108-10 109 AVENUE"
2,0,2,"a73aa668-33f4-ea11-b882-24ee9a37d45c","High School for Teaching and the Professions - X433 - X430 - 10X433 - 2780 RESERVOIR AVENUE","a13aa668-33f4-ea11-b882-24ee9a37d45c",-73897066,40869061,"WALTON HS - X","2780 RESERVOIR AVENUE"
1,1,0,"ea09e2e1-30f4-ea11-b882-24ee9a37d45c","PROGRESS High School for Professional Careers - K474 - K450 - 14K474 - 850 GRAND STREET","e909e2e1-30f4-ea11-b882-24ee9a37d45c",-73938921,40711134,"GRAND STREET CAMPUS (OLD E.D.HS)- K","850 GRAND STREET"
1,0,1,"5af4a0ef-eaf6-ea11-b883-24ee9a37d459","P.S. K771 - K771 - K225 - 75K771 - 1075 OCEAN VIEW AVENUE","e521d292-30f4-ea11-b882-24ee9a37d45c",-73955856,40580260,"P.S. 225 - BROOKLYN","1075 OCEAN VIEW AVENUE"
2,2,0,"dd8a0044-33f4-ea11-b882-24ee9a37d45c","P.S. 175 City Island - X175 - X175 - 11X175 - 200 CITY ISLAND AVENUE","de8a0044-33f4-ea11-b882-24ee9a37d45c",-73783540,40844353,"P.S. 175 - BRONX","200 CITY ISLAND AVENUE"
1,1,0,"c52ff20c-32f4-ea11-b882-24ee9a37d45c","P.S./I.S. 113 Anthony J. Pranzo - Q113 - Q113 - 24Q113 - 78-23 87TH STREET","c62ff20c-32f4-ea11-b882-24ee9a37d45c",-73861493,40705476,"P.S./I.S. 113 - QUEENS","78-23 87TH STREET"
1,1,0,"9241e65b-31f4-ea11-b882-24ee9a37d45c","Wadleigh Secondary School for the Performing & Visual Arts - M415 - M088 - 03M415 - 215 WEST 114 STREET","8841e65b-31f4-ea11-b882-24ee9a37d45c",-73954152,40802610,"I.S. 88 - MANHATTAN","215 WEST 114 STREET"
1,1,0,"130410ca-32f4-ea11-b882-24ee9a37d45c","CSI High School for International Studies - R047 - R043 - 31R047 - 100 ESSEX DRIVE","a0a9d9c3-32f4-ea11-b882-24ee9a37d45c",-74159343,40581958,"JEROME PARKER CAMPUS - S.I.","100 ESSEX DRIVE"
3,1,2,"4a9d7c62-33f4-ea11-b882-24ee9a37d45c","Bronxdale High School - X508 - X415 - 11X508 - 925 ASTOR AVENUE","439d7c62-33f4-ea11-b882-24ee9a37d45c",-73860729,40860443,"CHRISTOPHER COLUMBUS HS - X","925 ASTOR AVENUE"
2,2,0,"555b4cd6-32f4-ea11-b882-24ee9a37d45c","Port Richmond High School - R445 - R445 - 31R445 - 85 ST JOSEPHS AVENUE","515b4cd6-32f4-ea11-b882-24ee9a37d45c",-74141924,40635562,"PORT RICHMOND HS - S. I.","85 ST JOSEPHS AVENUE"
1,0,1,"604accc4-ebf6-ea11-b883-24ee9a37d459","P.S. 009 - Q009 - Q882 - 75Q009 - 90-36 150 STREET","cdedf392-32f4-ea11-b882-24ee9a37d45c",-73805044,40702776,"P.S. 182 - QUEENS","90-36 150 STREET"
2,1,1,"11eabc42-30f4-ea11-b882-24ee9a37d45c","P.S. 046 Edward C. Blum - K046 - K046 - 13K046 - 100 CLERMONT AVENUE","1a1bad3c-30f4-ea11-b882-24ee9a37d45c",-73971644,40694530,"P.S. 46 - BROOKLYN","100 CLERMONT AVENUE"
2,0,2,"13e2abc9-30f4-ea11-b882-24ee9a37d45c","P.S. 376 - K376 - K376 - 32K376 - 194 HARMAN STREET","14e2abc9-30f4-ea11-b882-24ee9a37d45c",-73920187,40698050,"P.S. 376A - BROOKLYN","194 HARMAN STREET"
2,2,0,"a93aa668-33f4-ea11-b882-24ee9a37d45c","Celia Cruz Bronx High School of Music, The - X442 - X430 - 10X442 - 2780 RESERVOIR AVENUE","a13aa668-33f4-ea11-b882-24ee9a37d45c",-73897066,40869061,"WALTON HS - X","2780 RESERVOIR AVENUE"
1,1,0,"367eed06-32f4-ea11-b882-24ee9a37d45c","P.S. 099 Kew Gardens - Q099 - Q099 - 28Q099 - 82-37 KEW GARDENS ROAD","377eed06-32f4-ea11-b882-24ee9a37d45c",-73827722,40711502,"P.S. 99 - QUEENS","82-37 KEW GARDENS ROAD"
2,2,0,"d3d27c6d-30f4-ea11-b882-24ee9a37d45c","Young Women's Leadership School of Brooklyn - K614 - K147 - 14K614 - 325 BUSHWICK AVENUE","d4d27c6d-30f4-ea11-b882-24ee9a37d45c",-73938790,40705005,"P.S. 147 - BROOKLYN","325 BUSHWICK AVENUE"
2,1,1,"e32d6c32-ebf6-ea11-b883-24ee9a37d459","P.S. K369 - Coy L. Cox School - K369 - K317 - 75K369 - 610 Baltic Street","99e657bd-30f4-ea11-b882-24ee9a37d45c",-73980455,40679916,"P.S. 133 WILLIAM A. BUTLER - BROOKLYN","610 Baltic Street"
3,2,1,"f5454b50-32f4-ea11-b882-24ee9a37d45c","P.S. 376 - Q376 - Q332 - 26Q376 - 210-21 48 AVENUE","f6454b50-32f4-ea11-b882-24ee9a37d45c",-73770314,40754954,"Bayside Hills School of Excellence","210-21 48 AVENUE"
1,1,0,"bc315367-30f4-ea11-b882-24ee9a37d45c","P.S. 121 Nelson A. Rockefeller - K121 - K121 - 21K121 - 5301 20 AVENUE","bd315367-30f4-ea11-b882-24ee9a37d45c",-73978472,40622671,"P.S. 121 - BROOKLYN","5301 20 AVENUE"
2,2,0,"5588e6db-30f4-ea11-b882-24ee9a37d45c","New Utrecht High School - K445 - K445 - 20K445 - 1601 80 STREET","5488e6db-30f4-ea11-b882-24ee9a37d45c",-74002308,40613041,"NEW UTRECHT HS - K","1601 80 STREET"
1,0,1,"4d3cbf01-ebf6-ea11-b883-24ee9a37d459","P.S. R373 - R373 - R040 - 75R373 - 91 HENDERSON AVENUE","97a9d9c3-32f4-ea11-b882-24ee9a37d45c",-74095454,40641180,"P.S. 373 (OLD P40) - STATEN ISLAND","91 HENDERSON AVENUE"
1,0,1,"df883319-32f4-ea11-b882-24ee9a37d45c","P.S. 144 Col Jeromus Remsen - Q144 - Q144 - 28Q144 - 69-20 JUNO STREET","e0883319-32f4-ea11-b882-24ee9a37d45c",-73852398,40714890,"P.S. 144 - QUEENS","69-20 JUNO STREET"
1,1,0,"18b7c337-32f4-ea11-b882-24ee9a37d45c","Waterside School For Leadership - Q318 - Q225 - 27Q318 - 190 BEACH 110 STREET","19b7c337-32f4-ea11-b882-24ee9a37d45c",-73831090,40580907,"P.S. 225 - QUEENS","190 BEACH 110 STREET"
1,0,1,"1c1bad3c-30f4-ea11-b882-24ee9a37d45c","P.S./I.S. 045 Horace E. Greene - K045 - K045 - 32K045 - 84 SCHAEFER STREET","1d1bad3c-30f4-ea11-b882-24ee9a37d45c",-73910430,40686424,"P.S. 45 - BROOKLYN","84 SCHAEFER STREET"
3,3,0,"e292e6d5-30f4-ea11-b882-24ee9a37d45c","James Madison High School - K425 - K425 - 22K425 - 3787 BEDFORD AVENUE","e092e6d5-30f4-ea11-b882-24ee9a37d45c",-73947661,40610499,"JAMES MADISON HS - K","3787 BEDFORD AVENUE"
1,0,1,"db92e6d5-30f4-ea11-b882-24ee9a37d45c","Academy for Young Writers - K404 - K422 - 19K404 - 1065 Elton Street","da92e6d5-30f4-ea11-b882-24ee9a37d45c",-73874064,40657266,"SPRING CREEK EDUCATIONAL CAMPUS - BROOKLYN","1065 Elton Street"
1,0,1,"ed8442ee-31f4-ea11-b882-24ee9a37d45c","P.S. Q256 - Q256 - Q043 - 75Q256 - 160 BEACH 29 STREET","ee8442ee-31f4-ea11-b882-24ee9a37d45c",-73761086,40593480,"P.S. 43 - QUEENS","160 BEACH 29 STREET"
2,1,1,"85be7adc-32f4-ea11-b882-24ee9a37d45c","P.S. 74 Future Leaders Elementary School - R074 - R831 - 31R074 - 211 DANIEL LOW TERRACE","86be7adc-32f4-ea11-b882-24ee9a37d45c",-74079438,40638993,"P.S. 74 - STATEN ISLAND","211 DANIEL LOW TERRACE"
1,0,1,"7201ce37-33f4-ea11-b882-24ee9a37d45c","P.S. 154 Jonathan D. Hyatt - X154 - X154 - 07X154 - 333 EAST 135 STREET","7101ce37-33f4-ea11-b882-24ee9a37d45c",-73925459,40808194,"P.S. 154 - BRONX","333 EAST 135 STREET"
3,2,1,"141bad3c-30f4-ea11-b882-24ee9a37d45c","I.S. 98 Bay Academy - K098 - K043 - 21K098 - 1401 EMMONS AVENUE","151bad3c-30f4-ea11-b882-24ee9a37d45c",-73954047,40583893,"I.S. 98 - BROOKLYN","1401 EMMONS AVENUE"
1,1,0,"b42aa42b-33f4-ea11-b882-24ee9a37d45c","J.H.S. 144 Michelangelo - X144 - X144 - 11X144 - 2545 GUNTHER AVENUE","b22aa42b-33f4-ea11-b882-24ee9a37d45c",-73836525,40863842,"I.S. 144 - BRONX","2545 GUNTHER AVENUE"
1,1,0,"81a9d9c3-32f4-ea11-b882-24ee9a37d45c","P.S. 031 William T. Davis - R031 - R031 - 31R031 - 55 LAYTON AVENUE","82a9d9c3-32f4-ea11-b882-24ee9a37d45c",-74085420,40642090,"P.S. 31 - STATEN ISLAND","55 LAYTON AVENUE"
1,0,1,"fc454b50-32f4-ea11-b882-24ee9a37d45c","College Point Collaborative - Q379 - Q336 - 25Q379 - 12406 14TH AVENUE","fd454b50-32f4-ea11-b882-24ee9a37d45c",-73843504,40785129,"The College Point Collaborative Educational Buildi","12406 14TH AVENUE"
1,0,1,"f902cefa-32f4-ea11-b882-24ee9a37d45c","P.S. X188 - X188 - X034 - 75X188 - 770 GROTE STREET","fa02cefa-32f4-ea11-b882-24ee9a37d45c",-73883877,40850168,"P.S. 34 - BRONX","770 GROTE STREET"
1,0,1,"cfc88e4f-31f4-ea11-b882-24ee9a37d45c","47 The American Sign Language and English Secondary School - M047 - M047 - 02M047 - 223 EAST 23 STREET","d0c88e4f-31f4-ea11-b882-24ee9a37d45c",-73981329,40738374,"J.H.S. 47 (SCH FOR THE DEAF) - M","223 EAST 23 STREET"
1,0,1,"a16b4ae9-ea40-ec11-b8c3-24ee9a37d45c","KIPP Bronx Charter School III - X617 - XCHO - 84X617 - 501 Gerard Avenue","a06b4ae9-ea40-ec11-b8c3-24ee9a37d45c",-73929502,40818347,"501 Gerard Avenue","501 Gerard Avenue"
1,0,1,"fb8ac007-ebf6-ea11-b883-24ee9a37d459","P.S. X721 - Stephen McSweeney School - X721 - X722 - 75X721 - 2697 WESTCHESTER AVENUE","06a31781-33f4-ea11-b882-24ee9a37d45c",-73839114,40842725,"P.S. 721 (OTC) - BRONX","2697 WESTCHESTER AVENUE"
1,0,1,"05af1f69-ebf6-ea11-b883-24ee9a37d459","District 2 Pre-K Center - M391 - M343 - 02M391 - 1 PECK SLIP","e7e0838c-31f4-ea11-b882-24ee9a37d45c",-74002407,40708774,"THE PECK SLIP SCHOOL - MANHATTAN","1 PECK SLIP"
1,0,1,"38e61462-31f4-ea11-b882-24ee9a37d45c","P.S. 092 Mary McLeod Bethune - M092 - M092 - 05M092 - 222 WEST 134 STREET","36e61462-31f4-ea11-b882-24ee9a37d45c",-73945838,40814917,"P.S. 92 - MANHATTAN","222 WEST 134 STREET"
2,1,1,"a49c11e8-30f4-ea11-b882-24ee9a37d45c","High School for Service & Learning at Erasmus - K539 - K465 - 17K539 - 911 FLATBUSH AVENUE","9d9c11e8-30f4-ea11-b882-24ee9a37d45c",-73957173,40649602,"ERASMUS HALL CAMPUS - K","911 FLATBUSH AVENUE"
1,0,1,"33ceb75a-4afb-ea11-b883-24ee9a37d459","YMCA OF GREATER NEW YORK - CROSS ISLAND - QAJX - QAJX -  - 238-10 HILLSIDE AVENUE","34ceb75a-4afb-ea11-b883-24ee9a37d459",-73727533,40732259,"YMCA OF GREATER NEW YORK - CROSS ISLAND","238-10 HILLSIDE AVENUE"
1,1,0,"d4f57030-30f4-ea11-b882-24ee9a37d45c","The Emily Warren Roebling School - K008 - K008 - 13K008 - 37 HICKS STREET","d5f57030-30f4-ea11-b882-24ee9a37d45c",-73992841,40700709,"P.S. 8 - BROOKLYN","37 HICKS STREET"
1,0,1,"139ebaee-32f4-ea11-b882-24ee9a37d45c","P.S. 006 West Farms - X006 - X006 - 12X006 - 1000 EAST TREMONT AVENUE","0e9ebaee-32f4-ea11-b882-24ee9a37d45c",-73882531,40840445,"P.S. 6 - BRONX","1000 EAST TREMONT AVENUE"
1,1,0,"21e85c61-30f4-ea11-b882-24ee9a37d45c","P.S. 112 Lefferts Park - K112 - K112 - 20K112 - 7115 15 AVENUE","22e85c61-30f4-ea11-b882-24ee9a37d45c",-74000565,40619417,"P.S. 112 - BROOKLYN","7115 15 AVENUE"
1,0,1,"18e2abc9-30f4-ea11-b882-24ee9a37d45c","P.S. K141 - K141 - K380 - 75K141 - 370 MARCY AVENUE","19e2abc9-30f4-ea11-b882-24ee9a37d45c",-73953702,40701790,"P.S. 380 - BROOKLYN","370 MARCY AVENUE"
3,3,0,"63ffcc6e-33f4-ea11-b882-24ee9a37d45c","The Bronx High School of Science - X445 - X445 - 10X445 - 75 WEST 205 STREET","64ffcc6e-33f4-ea11-b882-24ee9a37d45c",-73889011,40879958,"BRONX HS OF SCIENCE - X","75 WEST 205 STREET"
8,4,4,"b9b66262-32f4-ea11-b882-24ee9a37d45c","John Bowne High School - Q425 - Q425 - 25Q425 - 63-25 MAIN STREET","bab66262-32f4-ea11-b882-24ee9a37d45c",-73823841,40737448,"JOHN BOWNE HS - QUEENS","63-25 MAIN STREET"
1,0,1,"0ba198c3-30f4-ea11-b882-24ee9a37d45c","Hyde Leadership Charter School - Brooklyn - K769 - K328 - 84K769 - 330 ALABAMA AVENUE","0ca198c3-30f4-ea11-b882-24ee9a37d45c",-73898249,40667985,"P.S. 328 - BROOKLYN","330 ALABAMA AVENUE"
4,3,1,"377c21b7-32f4-ea11-b882-24ee9a37d45c","P.S. 004 Maurice Wollin - R004 - R004 - 31R004 - 200 NEDRA LANE","337c21b7-32f4-ea11-b882-24ee9a37d45c",-74195281,40552059,"P.S. 4 - STATEN ISLAND","200 NEDRA LANE"
1,0,1,"92977d2b-32f4-ea11-b882-24ee9a37d45c","P.S. 197 The Ocean School - Q197 - Q197 - 27Q197 - 825 HICKSVILLE ROAD","93977d2b-32f4-ea11-b882-24ee9a37d45c",-73744128,40599664,"P.S. 197 - QUEENS","825 HICKSVILLE ROAD"
1,1,0,"1404d718-31f4-ea11-b882-24ee9a37d45c","P.S. 001 The Bergen - K001 - K881 - 15K001 - 309 47 Street","1504d718-31f4-ea11-b882-24ee9a37d45c",-74011420,40648959,"P.S. 1 MINISCHOOL - BROOKLYN","309 47 Street"
1,1,0,"6934aa92-31f4-ea11-b882-24ee9a37d45c","Success Academy Charter School - Washington Heights - M265 - M387 - 84M265 - 701 Fort Washington Avenue","6a34aa92-31f4-ea11-b882-24ee9a37d45c",-73935231,40857650,"Success Academy - Washington Heights","701 Fort Washington Avenue"
1,0,1,"ab32c3fb-eaf6-ea11-b883-24ee9a37d459","P.S. Q224 - Q224 - Q186 - 75Q224 - 252-12 72 AVENUE","67977d2b-32f4-ea11-b882-24ee9a37d45c",-73721594,40749556,"P.S. 186 - QUEENS","252-12 72 AVENUE"
3,2,1,"b479df48-30f4-ea11-b882-24ee9a37d45c","Success Academy Charter School - Bed Stuy 2 - K125 - K059 - 84K125 - 211 THROOP AVENUE","b579df48-30f4-ea11-b882-24ee9a37d45c",-73943279,40697619,"P.S. 59 - BROOKLYN","211 THROOP AVENUE"
2,2,0,"8de04648-53e6-eb11-b8b1-24ee9a37d45c","Success Academy Charter School - Bronx 3 - X380 - M043 - 84X380 - 509 WEST 129 STREET","59767649-31f4-ea11-b882-24ee9a37d45c",-73955520,40815747,"I.S. 172 (OLD 43) - MANHATTAN","509 WEST 129 STREET"
1,0,1,"433cbf01-ebf6-ea11-b883-24ee9a37d459","P.S. Q811 - Q811 - Q811 - 75Q811 - 61-25 MARATHON PARKWAY","08bef08c-32f4-ea11-b882-24ee9a37d45c",-73728412,40756481,"P.S. 811 (OLD 187) - QUEENS","61-25 MARATHON PARKWAY"
1,1,0,"86977d2b-32f4-ea11-b882-24ee9a37d45c","P.S. 193 Alfred J. Kennedy - Q193 - Q193 - 25Q193 - 152-20 11 AVENUE","87977d2b-32f4-ea11-b882-24ee9a37d45c",-73808987,40792053,"P.S. 193 - QUEENS","152-20 11 AVENUE"
1,0,1,"868946f4-31f4-ea11-b882-24ee9a37d45c","Success Academy Charter School - Springfield Gardens - New York 6 - Q339 - Q059 - 84Q339 - 132-55 RIDGEDALE STREET","878946f4-31f4-ea11-b882-24ee9a37d45c",-73752772,40681881,"I.S. 59 - QUEENS","132-55 RIDGEDALE STREET"
2,0,2,"a8d810ab-31f4-ea11-b882-24ee9a37d45c","Success Academy Charter School - Hell's Kitchen - M170 - M625 - 84M170 - 439 WEST 49TH STREET","a9d810ab-31f4-ea11-b882-24ee9a37d45c",-73990318,40763655,"HS OF GRAPHIC COMMUNICATION ARTS-M","439 WEST 49TH STREET"
1,0,1,"22eabc42-30f4-ea11-b882-24ee9a37d45c","Success Academy Charter School - Williamsburg - K182 - K050 - 84K182 - 183 SOUTH 3 STREET","1feabc42-30f4-ea11-b882-24ee9a37d45c",-73960137,40711915,"J.H.S. 50 - BROOKLYN","183 SOUTH 3 STREET"
1,1,0,"6e2b3eee-30f4-ea11-b882-24ee9a37d45c","Brooklyn Community High School for Excellence and Equity - K566 - K515 - 18K566 - 6565 FLATLANDS AVENUE","6d2b3eee-30f4-ea11-b882-24ee9a37d45c",-73916927,40634451,"SOUTH SHORE EDUCATIONAL CAMPUS - K","6565 FLATLANDS AVENUE"
1,0,1,"b18a894e-4afb-ea11-b883-24ee9a37d459","Amalgamated Nursery School - XAAH - XAAH -  - 3980 ORLOFF AVENUE","b28a894e-4afb-ea11-b883-24ee9a37d459",-73891962,40884086,"AMALGAMATED NURSERY SCHOOL","3980 ORLOFF AVENUE"
2,1,1,"dbc1392a-30f4-ea11-b882-24ee9a37d45c","P.S. 001 The Bergen - K001 - K001 - 15K001 - 309 47 STREET","dcc1392a-30f4-ea11-b882-24ee9a37d45c",-74011420,40648959,"P.S. 1 - BROOKLYN","309 47 STREET"
3,1,2,"90bc9674-32f4-ea11-b882-24ee9a37d45c","Hillcrest High School - Q505 - Q505 - 28Q505 - 160-05 HIGHLAND AVENUE","8fbc9674-32f4-ea11-b882-24ee9a37d45c",-73803001,40709461,"HILLCREST HS - Q","160-05 HIGHLAND AVENUE"
1,1,0,"45e61462-31f4-ea11-b882-24ee9a37d45c","Bard High School Early College - M696 - M097 - 01M696 - 525 EAST HOUSTON STREET","46e61462-31f4-ea11-b882-24ee9a37d45c",-73976093,40718276,"BARD COLLEGE HS (OLD M097) - M","525 EAST HOUSTON STREET"
1,1,0,"f2fb3df4-30f4-ea11-b882-24ee9a37d45c","Brooklyn Community High School for Excellence and Equity - K566 - K516 - 18K566 - 6565 Flatlands Avenue","f3fb3df4-30f4-ea11-b882-24ee9a37d45c",-73916927,40634451,"SOUTH SHORE AF - BROOKLYN","6565 Flatlands Avenue"
1,1,0,"807eda5c-ebf6-ea11-b883-24ee9a37d459","P.S. M094 - M094 - M061 - 75M094 - 610 EAST 12 STREET","c8fab455-31f4-ea11-b882-24ee9a37d45c",-73978254,40727537,"P.S. 61 - MANHATTAN","610 EAST 12 STREET"
2,1,1,"9a2aa42b-33f4-ea11-b882-24ee9a37d45c","International Community High School - X334 - X139 - 07X334 - 345 BROOK AVENUE","942aa42b-33f4-ea11-b882-24ee9a37d45c",-73918774,40810314,"J.H.S. 222 - BRONX","345 BROOK AVENUE"
1,1,0,"9628a20c-31f4-ea11-b882-24ee9a37d45c","Urban Assembly School of Music and Art - K350 - K805 - 13K350 - 49 FLATBUSH AVENUE EXTENSION","9428a20c-31f4-ea11-b882-24ee9a37d45c",-73984528,40697330,"WATER'S EDGE EDUCATIONAL CAMPUS - K","49 FLATBUSH AVENUE EXTENSION"
1,0,1,"0bcf496e-31f4-ea11-b882-24ee9a37d45c","M.S. 131 - M131 - M131 - 02M131 - 100 HESTER STREET","03cf496e-31f4-ea11-b882-24ee9a37d45c",-73993607,40716231,"I.S. 131 - MANHATTAN","100 HESTER STREET"
2,0,2,"18f32ce2-31f4-ea11-b882-24ee9a37d45c","P.S. 019 Marino Jeantet - Q019 - Q019 - 24Q019 - 98-02 ROOSEVELT AVENUE","19f32ce2-31f4-ea11-b882-24ee9a37d45c",-73866557,40748600,"P.S. 19 - QUEENS","98-02 ROOSEVELT AVENUE"
1,1,0,"03b7c337-32f4-ea11-b882-24ee9a37d45c","J.H.S. 216 George J. Ryan - Q216 - Q216 - 26Q216 - 64-20 175 Street","04b7c337-32f4-ea11-b882-24ee9a37d45c",-73794501,40737188,"J.H.S. 216 - QUEENS","64-20 175 Street"
1,1,0,"d38521d0-32f4-ea11-b882-24ee9a37d45c","The Kathleen Grimm School for Leadership and Sustainability - R062 - R062 - 31R062 - 644 Bloomingdale Road","d48521d0-32f4-ea11-b882-24ee9a37d45c",-74217934,40541563,"K.GRIMM SCL FOR LDRSHP&SUSTAINABLTY@SANDY GR -S.I.","644 Bloomingdale Road"
2,1,1,"969c11e8-30f4-ea11-b882-24ee9a37d45c","Park Slope Collegiate - K464 - K460 - 15K464 - 237 7 AVENUE","929c11e8-30f4-ea11-b882-24ee9a37d45c",-73978580,40669255,"John Jay Educational Campus","237 7 AVENUE"
1,1,0,"176e3d68-31f4-ea11-b882-24ee9a37d45c","KIPP NYC Washington Heights Academy Charter School - M068 - M115 - 84M068 - 586 WEST 177 STREET","166e3d68-31f4-ea11-b882-24ee9a37d45c",-73935140,40846116,"P.S. 115 - MANHATTAN","586 WEST 177 STREET"
2,2,0,"68e2635c-32f4-ea11-b882-24ee9a37d45c","Academy for Careers in Television and Film - Q301 - Q404 - 30Q301 - 1-50 51ST AVENUE","65e2635c-32f4-ea11-b882-24ee9a37d45c",-73959183,40742964,"HUNTERS POINT CAMPUS - QUEENS","1-50 51ST AVENUE"
2,2,0,"512b3eee-30f4-ea11-b882-24ee9a37d45c","Fort Hamilton High School - K490 - K490 - 20K490 - 8301 SHORE ROAD","522b3eee-30f4-ea11-b882-24ee9a37d45c",-74038103,40626827,"FORT HAMILTON HS - K","8301 SHORE ROAD"
2,0,2,"43fdc1bd-32f4-ea11-b882-24ee9a37d45c","I.S. 007 Elias Bernstein - R007 - R007 - 31R007 - 1270 Huguenot Avenue","447c21b7-32f4-ea11-b882-24ee9a37d45c",-74186096,40522971,"I.S. 7 - STATEN ISLAND","1270 Huguenot Avenue"
1,1,0,"bdedf392-32f4-ea11-b882-24ee9a37d45c","District 30 Pre-K Center - Q389 - Q868 - 30Q389 - 48-09 CENTER BOULEVARD","bcedf392-32f4-ea11-b882-24ee9a37d45c",-73957177,40744368,"P.S. 78 - QUEENS","48-09 CENTER BOULEVARD"
2,1,1,"9eeb0e7b-33f4-ea11-b882-24ee9a37d45c","H.E.R.O. High (Health, Education, and Research Occupations High School) - X259 - X655 - 07X259 - 455 SOUTHERN BLVD","99eb0e7b-33f4-ea11-b882-24ee9a37d45c",-73907528,40810671,"SAMUEL GOMPERS VOC HS - X","455 SOUTHERN BLVD"
3,3,0,"692b3eee-30f4-ea11-b882-24ee9a37d45c","Franklin Delano Roosevelt High School - K505 - K505 - 20K505 - 5800 20 AVENUE","682b3eee-30f4-ea11-b882-24ee9a37d45c",-73982583,40621299,"FRANKLIN D. ROOSEVELT HS - K","5800 20 AVENUE"
1,1,0,"8b32c3fb-eaf6-ea11-b883-24ee9a37d459","Teachers College Community School - M517 - M916 - 05M517 - 168 MORNINGSIDE AVENUE","f0ed94c3-31f4-ea11-b882-24ee9a37d45c",-73953317,40812428,"TEACHERS COLLEGE COMMUNITY SCHOOL - MANHATTAN","168 MORNINGSIDE AVENUE"
3,1,2,"9d32c3fb-eaf6-ea11-b883-24ee9a37d459","P.S. 009 - Q009 - Q009 - 75Q009 - 58-74 57 STREET","f8f22ce2-31f4-ea11-b882-24ee9a37d45c",-73912458,40718234,"P.S. 9 (W REED SCHOOL) - QUEENS","58-74 57 STREET"
1,1,0,"b779df48-30f4-ea11-b882-24ee9a37d45c","P.S. 058 The Carroll - K058 - K058 - 15K058 - 330 SMITH STREET","b879df48-30f4-ea11-b882-24ee9a37d45c",-73995486,40680379,"P.S. 58 - BROOKLYN","330 SMITH STREET"
1,1,0,"9a886843-31f4-ea11-b882-24ee9a37d45c","Frederick Douglass Academy - M499 - M010 - 05M499 - 2581 7TH AVENUE","9b886843-31f4-ea11-b882-24ee9a37d45c",-73935746,40823988,"I.S. 10 (TANDEM M200) - MANHATTAN","2581 7TH AVENUE"
1,0,1,"b6e454d6-48fb-ea11-b883-24ee9a37d459","BRONX HOUSE 2 - XAPQ - XAPQ -  - 2222 WALLACE AVENUE","b7e454d6-48fb-ea11-b883-24ee9a37d459",-73863216,40858796,"BRONX HOUSE 2","2222 WALLACE AVENUE"
1,0,1,"35de5eb7-30f4-ea11-b882-24ee9a37d45c","Evergreen Middle School for Urban Exploration - K562 - K296 - 32K562 - 125 COVERT STREET","99283fb1-30f4-ea11-b882-24ee9a37d45c",-73910589,40688647,"I.S. 296 - BROOKLYN","125 COVERT STREET"
2,0,2,"e48a0044-33f4-ea11-b882-24ee9a37d45c","P.S. 178 - Dr. Selman Waksman - X178 - X178 - 11X178 - 850 BAYCHESTER AVENUE","e38a0044-33f4-ea11-b882-24ee9a37d45c",-73831669,40874035,"P.S. 178 - BRONX","850 BAYCHESTER AVENUE"
2,0,2,"8f593c87-33f4-ea11-b882-24ee9a37d45c","P.S. 246 Poe Center - X246 - X843 - 10X246 - 2641 Grand Concourse","90593c87-33f4-ea11-b882-24ee9a37d45c",-73895300,40865972,"P.S. 246 (POE CENTER) - BRONX","2641 Grand Concourse"
2,0,2,"9b476368-32f4-ea11-b882-24ee9a37d45c","Veritas Academy - Q240 - Q460 - 25Q240 - 35-01 UNION STREET","97476368-32f4-ea11-b882-24ee9a37d45c",-73826811,40764892,"FLUSHING HS - Q","35-01 UNION STREET"
2,2,0,"57042f6f-ebf6-ea11-b883-24ee9a37d459","Success Academy Charter School - Harlem 1 - M351 - M620 - 84M351 - 111 EAST 33RD STREET","a0d810ab-31f4-ea11-b882-24ee9a37d45c",-73981070,40746510,"NORMAN THOMAS HS (ECF) - MANHATTAN","111 EAST 33RD STREET"
4,4,0,"a53aa668-33f4-ea11-b882-24ee9a37d45c","International School for Liberal Arts - X342 - X430 - 10X342 - 2780 RESERVOIR AVENUE","a13aa668-33f4-ea11-b882-24ee9a37d45c",-73897066,40869061,"WALTON HS - X","2780 RESERVOIR AVENUE"
1,1,0,"9a778cb8-ebf6-ea11-b883-24ee9a37d459","P.S. Q993 - Q993 - Q499 - 75Q993 - 148-20 REEVES AVENUE","8bbc9674-32f4-ea11-b882-24ee9a37d45c",-73820821,40738599,"P.S./I.S. 499 - QUEENS","148-20 REEVES AVENUE"
2,1,1,"8f977d2b-32f4-ea11-b882-24ee9a37d45c","P.S. 196 Grand Central Parkway - Q196 - Q196 - 28Q196 - 71-25 113 STREET","90977d2b-32f4-ea11-b882-24ee9a37d45c",-73837379,40722792,"P.S. 196 - QUEENS","71-25 113 STREET"
2,1,1,"07fc3df4-30f4-ea11-b882-24ee9a37d45c","John Dewey High School - K540 - K540 - 21K540 - 50 AVENUE X","05fc3df4-30f4-ea11-b882-24ee9a37d45c",-73981925,40588070,"JOHN DEWEY HS - K","50 AVENUE X"
2,2,0,"d4b36d80-30f4-ea11-b882-24ee9a37d45c","P.S. 188 Michael E. Berdy - K188 - K188 - 21K188 - 3314 Neptune Avenue","cdb36d80-30f4-ea11-b882-24ee9a37d45c",-74000489,40576733,"P.S. 188 - BROOKLYN","3314 Neptune Avenue"
1,1,0,"f89b4c1f-32f4-ea11-b882-24ee9a37d45c","P.S. 160 Walter Francis Bishop - Q160 - Q160 - 28Q160 - 109-59 INWOOD STREET","ee9b4c1f-32f4-ea11-b882-24ee9a37d45c",-73799685,40688373,"P.S. 160 - QUEENS","109-59 INWOOD STREET"
1,1,0,"499587f5-ebf6-ea11-b883-24ee9a37d459","P.S. X017 - X017 - X161 - 75X017 - 628 TINTON AVENUE","ff2dd53d-33f4-ea11-b882-24ee9a37d45c",-73905233,40814168,"P.S. 161 - BRONX","628 TINTON AVENUE"
2,2,0,"39a6ba98-31f4-ea11-b882-24ee9a37d45c","Frank McCourt High School - M417 - M470 - 03M417 - 145 WEST 84 STREET","33a6ba98-31f4-ea11-b882-24ee9a37d45c",-73974483,40786134,"LOUIS D. BRANDEIS HS - MANHATTAN","145 WEST 84 STREET"
4,3,1,"d2b66262-32f4-ea11-b882-24ee9a37d45c","Forest Hills High School - Q440 - Q440 - 28Q440 - 67-01 110 STREET","d3b66262-32f4-ea11-b882-24ee9a37d45c",-73843972,40730017,"FOREST HILLS HS - Q","67-01 110 STREET"
1,0,1,"0eaff06d-49fb-ea11-b883-24ee9a37d459","REYNA GUTIERREZ - APT4G - XBLW - XBLW -  - 1895 MORRIS AVENUE","0faff06d-49fb-ea11-b883-24ee9a37d459",-73908367,40849477,"1895 MORRIS AVENUE","1895 MORRIS AVENUE"
2,0,2,"d156635c-33f4-ea11-b882-24ee9a37d45c","Bronx High School for Medical Science - X413 - X410 - 09X413 - 240 EAST 172 STREET","c856635c-33f4-ea11-b882-24ee9a37d45c",-73911366,40839307,"WILLIAM H. TAFT HS - X","240 EAST 172 STREET"
1,0,1,"c3bfa431-33f4-ea11-b882-24ee9a37d45c","P.S. 150 Charles James Fox - X150 - X150 - 12X150 - 920 EAST 167 STREET","c4bfa431-33f4-ea11-b882-24ee9a37d45c",-73894349,40824710,"P.S. 150 - BRONX","920 EAST 167 STREET"
1,1,0,"e8b98b86-30f4-ea11-b882-24ee9a37d45c","M.S. 582 - K582 - K196 - 14K582 - 207 BUSHWICK AVENUE","e9b98b86-30f4-ea11-b882-24ee9a37d45c",-73939385,40708804,"P.S. 196 - BROOKLYN","207 BUSHWICK AVENUE"
1,1,0,"dae0838c-31f4-ea11-b882-24ee9a37d45c","M.S. 297 - M297 - M323 - 02M297 - 75 MORTON STREET","d8e0838c-31f4-ea11-b882-24ee9a37d45c",-74007192,40731006,"75 Morton Campus","75 MORTON STREET"
5,2,3,"22e2abc9-30f4-ea11-b882-24ee9a37d45c","P.S. /I.S. 384 Frances E. Carter - K384 - K384 - 32K384 - 242 COOPER STREET","21e2abc9-30f4-ea11-b882-24ee9a37d45c",-73904695,40689883,"P.S. 384 - BROOKLYN","242 COOPER STREET"
2,1,1,"db454b50-32f4-ea11-b882-24ee9a37d45c","M.S. 358 - Q358 - Q314 - 28Q358 - 88-08 164TH STREET","d5454b50-32f4-ea11-b882-24ee9a37d45c",-73797981,40708698,"P.S./ I.S. 314 - Queens","88-08 164TH STREET"
1,1,0,"9672c880-32f4-ea11-b882-24ee9a37d45c","High School for Construction Trades, Engineering and Architecture - Q650 - Q650 - 27Q650 - 94-06 104TH STREET","8f72c880-32f4-ea11-b882-24ee9a37d45c",-73841475,40689177,"HS FOR CONST.TRADES,ENGG.,& ARCH-Q","94-06 104TH STREET"
1,0,1,"dfa2f813-ebf6-ea11-b883-24ee9a37d459","P.S. K369 - Coy L. Cox School - K369 - K067 - 75K369 - 51 SAINT EDWARDS STREET","d179df48-30f4-ea11-b882-24ee9a37d45c",-73977674,40695339,"P.S. 67 - BROOKLYN","51 SAINT EDWARDS STREET"
3,3,0,"e68521d0-32f4-ea11-b882-24ee9a37d45c","I.S. 075 Frank D. Paulo - R075 - R075 - 31R075 - 455 HUGUENOT AVENUE","e28521d0-32f4-ea11-b882-24ee9a37d45c",-74197033,40544535,"I.S. 75 - STATEN ISLAND","455 HUGUENOT AVENUE"
1,0,1,"8583ff9e-30f4-ea11-b882-24ee9a37d45c","M.S. 246 Walt Whitman - K246 - K246 - 17K246 - 72 VERONICA PLACE","8483ff9e-30f4-ea11-b882-24ee9a37d45c",-73953480,40648352,"I.S. 246 - BROOKLYN","72 VERONICA PLACE"
1,1,0,"a072c880-32f4-ea11-b882-24ee9a37d45c","Young Women's Leadership School, Queens - Q896 - Q680 - 28Q896 - 150-91 87 ROAD","9d72c880-32f4-ea11-b882-24ee9a37d45c",-73804166,40708409,"YOUNG WOMENS' LEADERSHIP SCHOOL - QUEENS","150-91 87 ROAD"
2,1,1,"76886843-31f4-ea11-b882-24ee9a37d45c","P.S. 002 Meyer London - M002 - M002 - 02M002 - 122 Henry Street","77886843-31f4-ea11-b882-24ee9a37d45c",-73991523,40712907,"P.S. 2 - MANHATTAN","122 Henry Street"
1,0,1,"21c73b4a-32f4-ea11-b882-24ee9a37d45c","Helen M. Marshall School - Q330 - Q287 - 24Q330 - 110-08 NORTHERN BOULEVARD","20c73b4a-32f4-ea11-b882-24ee9a37d45c",-73859202,40757888,"P.S. 330 - QUEENS","110-08 NORTHERN BOULEVARD"
1,1,0,"68e03d56-33f4-ea11-b882-24ee9a37d45c","P.S. 360 - X360 - X360 - 10X360 - 2880 KINGSBRIDGE TERRACE","69e03d56-33f4-ea11-b882-24ee9a37d45c",-73902214,40874717,"P.S. 360 - BRONX","2880 KINGSBRIDGE TERRACE"
2,2,0,"cd315367-30f4-ea11-b882-24ee9a37d45c","P.S. 127 Mckinley Park - K127 - K127 - 20K127 - 7805 7 Avenue","ce315367-30f4-ea11-b882-24ee9a37d45c",-74018429,40623687,"P.S. 127 - BROOKLYN","7805 7 Avenue"
2,1,1,"eb80b5c9-df1e-eb11-b885-24ee9a37d45c","Sunset School of Cultural Learning - K939 - K746 - 20K939 - 270 59th Street","e980b5c9-df1e-eb11-b885-24ee9a37d45c",-74020748,40642914,"P.S. @ 270 59TH STREET- BROOKLYN","270 59th Street"
1,0,1,"1203cefa-32f4-ea11-b882-24ee9a37d45c","P.S. 041 Gun Hill Road - X041 - X041 - 11X041 - 3352 OLINVILLE AVENUE","1303cefa-32f4-ea11-b882-24ee9a37d45c",-73867834,40874754,"P.S. 41 - BRONX","3352 OLINVILLE AVENUE"
2,0,2,"4a0d6d19-33f4-ea11-b882-24ee9a37d45c","P.S. 110 Theodore Schoenfeld - X110 - X110 - 09X110 - 580 CROTONA PARK SOUTH","420d6d19-33f4-ea11-b882-24ee9a37d45c",-73900654,40834470,"P.S. 110 - BRONX","580 CROTONA PARK SOUTH"
4,3,1,"daab074a-33f4-ea11-b882-24ee9a37d45c","P.S./I.S. 218 Rafael Hernandez Dual Language Magnet School - X218 - X235 - 09X218 - 1220 GERARD AVENUE","d8ab074a-33f4-ea11-b882-24ee9a37d45c",-73919571,40835681,"P.S./I.S. 218 - BRONX","1220 GERARD AVENUE"
1,0,1,"ff8ac007-ebf6-ea11-b883-24ee9a37d459","Mott Hall Charter School - X177 - X862 - 84X177 - 1260 FRANKLIN AVENUE","12ff3d8d-33f4-ea11-b882-24ee9a37d45c",-73901859,40830930,"P.S. 63 MINISCHOOL - BRONX","1260 FRANKLIN AVENUE"
1,1,0,"197eed06-32f4-ea11-b882-24ee9a37d45c","P.S. 89Q: The Jose Peralta School of Dreamers - Q089 - Q089 - 24Q089 - 85-28 BRITTON AVENUE","1a7eed06-32f4-ea11-b882-24ee9a37d45c",-73879641,40745963,"P.S. 89 - QUEENS","85-28 BRITTON AVENUE"
2,2,0,"bab36d80-30f4-ea11-b882-24ee9a37d45c","The SEEALL Academy - K180 - K180 - 20K180 - 5601 16 AVENUE","b8b36d80-30f4-ea11-b882-24ee9a37d45c",-73989250,40626454,"P.S. 180 - BROOKLYN","5601 16 AVENUE"
1,1,0,"d6d27c6d-30f4-ea11-b882-24ee9a37d45c","P.S. 145 Andrew Jackson - K145 - K145 - 32K145 - 100 NOLL STREET","d7d27c6d-30f4-ea11-b882-24ee9a37d45c",-73932388,40701107,"P.S. 145 - BROOKLYN","100 NOLL STREET"
2,1,1,"f1d10307-33f4-ea11-b882-24ee9a37d45c","P.S. 071 Rose E. Scala - X071 - X071 - 08X071 - 3040 ROBERTS AVENUE","e3d10307-33f4-ea11-b882-24ee9a37d45c",-73829562,40845379,"P.S. 71 - BRONX","3040 ROBERTS AVENUE"
1,1,0,"fd8052e9-ebf6-ea11-b883-24ee9a37d459","Mott Hall Charter School - X177 - X063 - 84X177 - 1260 FRANKLIN AVENUE","8736d900-33f4-ea11-b882-24ee9a37d45c",-73901859,40830930,"P.S. 63 - BRONX","1260 FRANKLIN AVENUE"
2,1,1,"2ee61462-31f4-ea11-b882-24ee9a37d45c","KIPP NYC Washington Heights Academy Charter School - M068 - M090 - 84M068 - 21 JUMEL PLACE","2ce61462-31f4-ea11-b882-24ee9a37d45c",-73935815,40839139,"I.S. 90 - MANHATTAN","21 JUMEL PLACE"
5,0,5,"95593c87-33f4-ea11-b882-24ee9a37d45c","P.S. 053 Basheer Quisim - X053 - X851 - 09X053 - 360 EAST 168 STREET","96593c87-33f4-ea11-b882-24ee9a37d45c",-73911906,40832648,"P.S. 53 MINISCHOOL #1 - BRONX","360 EAST 168 STREET"
2,0,2,"daaeb707-ecf6-ea11-b883-24ee9a37d459","P.S. X017 - X017 - X450 - 75X017 - 1980 LAFAYETTE AVENUE","62ffcc6e-33f4-ea11-b882-24ee9a37d45c",-73855930,40821218,"Adlai E. Stevenson Educational Campus","1980 LAFAYETTE AVENUE"
1,1,0,"48e61462-31f4-ea11-b882-24ee9a37d45c","P.S. 098 Shorac Kappock - M098 - M098 - 06M098 - 512 WEST 212 STREET","49e61462-31f4-ea11-b882-24ee9a37d45c",-73917814,40867741,"P.S. 98 - MANHATTAN","512 WEST 212 STREET"
2,2,0,"1f6e3d68-31f4-ea11-b882-24ee9a37d45c","Tag Young Scholars - M012 - M117 - 04M012 - 240 EAST 109 STREET","1b6e3d68-31f4-ea11-b882-24ee9a37d45c",-73942285,40792556,"J.H.S. 117 - MANHATTAN","240 EAST 109 STREET"
2,2,0,"9d476368-32f4-ea11-b882-24ee9a37d45c","Queens High School for Language Studies - Q241 - Q460 - 25Q241 - 35-01 UNION STREET","97476368-32f4-ea11-b882-24ee9a37d45c",-73826811,40764892,"FLUSHING HS - Q","35-01 UNION STREET"
3,0,3,"6336d900-33f4-ea11-b882-24ee9a37d45c","P.S. 053 Basheer Quisim - X053 - X053 - 09X053 - 360 EAST 168 STREET","6436d900-33f4-ea11-b882-24ee9a37d45c",-73911906,40832648,"P.S. 53 - BRONX","360 EAST 168 STREET"
1,0,1,"a69c11e8-30f4-ea11-b882-24ee9a37d45c","Science, Technology and Research Early College High School at Erasmus - K543 - K465 - 17K543 - 911 FLATBUSH AVENUE","9d9c11e8-30f4-ea11-b882-24ee9a37d45c",-73957173,40649602,"ERASMUS HALL CAMPUS - K","911 FLATBUSH AVENUE"
1,1,0,"50fdc1bd-32f4-ea11-b882-24ee9a37d45c","P.S. 013 M. L. Lindemeyer - R013 - R013 - 31R013 - 191 VERMONT AVENUE","51fdc1bd-32f4-ea11-b882-24ee9a37d45c",-74068963,40613322,"P.S. 13 - STATEN ISLAND","191 VERMONT AVENUE"
1,1,0,"5b5b4cd6-32f4-ea11-b882-24ee9a37d45c","Curtis High School - R450 - R450 - 31R450 - 105 HAMILTON AVENUE","5a5b4cd6-32f4-ea11-b882-24ee9a37d45c",-74082149,40645436,"CURTIS HS - S. I.","105 HAMILTON AVENUE"
3,3,0,"410b210d-33f4-ea11-b882-24ee9a37d45c","P.S. 081 Robert J. Christen - X081 - X081 - 10X081 - 5550 RIVERDALE AVENUE","420b210d-33f4-ea11-b882-24ee9a37d45c",-73904657,40903275,"P.S. 81 - BRONX","5550 RIVERDALE AVENUE"
2,2,0,"4fe61462-31f4-ea11-b882-24ee9a37d45c","Success Academy Charter School - Harlem 3 - M385 - M101 - 84M385 - 141 EAST 111 STREET","50e61462-31f4-ea11-b882-24ee9a37d45c",-73944546,40796098,"P.S. 101 - MANHATTAN","141 EAST 111 STREET"
2,2,0,"4c9f4974-31f4-ea11-b882-24ee9a37d45c","P.S. 145, The Bloomingdale School - M145 - M145 - 03M145 - 150 West 105 Street","4a9f4974-31f4-ea11-b882-24ee9a37d45c",-73965611,40799098,"P.S. 145 - MANHATTAN","150 West 105 Street"
1,0,1,"dbe13320-ebf6-ea11-b883-24ee9a37d459","Sid Miller Academy - K396 - K167 - 75K396 - 1025 EASTERN PARKWAY","4cebaa73-30f4-ea11-b882-24ee9a37d45c",-73934316,40669557,"P.S. 167 - BROOKLYN","1025 EASTERN PARKWAY"
1,1,0,"1ea6ba98-31f4-ea11-b882-24ee9a37d45c","Union Square Academy for Health Sciences - M533 - M460 - 02M533 - 40 IRVING PLACE","16a6ba98-31f4-ea11-b882-24ee9a37d45c",-73987064,40735361,"WASHINGTON IRVING HS - MANHATTAN","40 IRVING PLACE"
1,1,0,"6f41e65b-31f4-ea11-b882-24ee9a37d45c","P.S. 075 Emily Dickinson - M075 - M075 - 03M075 - 735 WEST END AVENUE","6a41e65b-31f4-ea11-b882-24ee9a37d45c",-73973996,40795109,"P.S. 75 - MANHATTAN","735 WEST END AVENUE"
1,0,1,"2806003e-32f4-ea11-b882-24ee9a37d45c","P.S. 239 - Q239 - Q239 - 24Q239 - 17-15 WEIRFIELD STREET","2606003e-32f4-ea11-b882-24ee9a37d45c",-73903838,40699431,"P.S. 239 - QUEENS","17-15 WEIRFIELD STREET"
1,0,1,"f717b7f4-32f4-ea11-b882-24ee9a37d45c","M.S. 390 - X390 - X026 - 10X390 - 1930 ANDREWS AVENUE","e917b7f4-32f4-ea11-b882-24ee9a37d45c",-73913016,40854335,"P.S. 396 - BRONX","1930 ANDREWS AVENUE"
1,1,0,"02cf496e-31f4-ea11-b882-24ee9a37d45c","Pace High School - M298 - M131 - 02M298 - 100 HESTER STREET","03cf496e-31f4-ea11-b882-24ee9a37d45c",-73993607,40716231,"I.S. 131 - MANHATTAN","100 HESTER STREET"
1,1,0,"41767649-31f4-ea11-b882-24ee9a37d45c","P.S. 138 - M138 - M033 - 75M138 - 281 9 AVENUE","42767649-31f4-ea11-b882-24ee9a37d45c",-74000238,40749014,"P.S. 33 - MANHATTAN","281 9 AVENUE"
1,1,0,"db2ff20c-32f4-ea11-b882-24ee9a37d45c","P.S. 120 Queens - Q120 - Q120 - 25Q120 - 58-01 136 STREET","dc2ff20c-32f4-ea11-b882-24ee9a37d45c",-73828674,40745215,"P.S. 120 - QUEENS","58-01 136 STREET"
1,0,1,"ded27c6d-30f4-ea11-b882-24ee9a37d45c","P.S. 373 - Brooklyn Transition Center - K373 - K148 - 75K373 - 185 ELLERY STREET","dcd27c6d-30f4-ea11-b882-24ee9a37d45c",-73945211,40699214,"P.S. 373 (OLD P148) - BROOKLYN","185 ELLERY STREET"
1,0,1,"0be63126-ebf6-ea11-b883-24ee9a37d459","P.S. 36 - K036 - K224 - 75K036 - 757 WORTMAN AVENUE","e121d292-30f4-ea11-b882-24ee9a37d45c",-73866542,40664143,"P.S. 224 - BROOKLYN","757 WORTMAN AVENUE"
2,2,0,"369ebaee-32f4-ea11-b882-24ee9a37d45c","P.S. 018 John Peter Zenger - X018 - X018 - 07X018 - 502 MORRIS AVENUE","379ebaee-32f4-ea11-b882-24ee9a37d45c",-73922697,40816369,"P.S. 18 - BRONX","502 MORRIS AVENUE"
2,0,2,"60507380-31f4-ea11-b882-24ee9a37d45c","P.S. 138 - M138 - M189 - 75M138 - 2580 AMSTERDAM AVENUE","5f507380-31f4-ea11-b882-24ee9a37d45c",-73928048,40853045,"P.S. 189 - MANHATTAN","2580 AMSTERDAM AVENUE"
1,1,0,"668946f4-31f4-ea11-b882-24ee9a37d45c","P.S. 049 Dorothy Bonawit Kole - Q049 - Q049 - 24Q049 - 63-60 80th Street","678946f4-31f4-ea11-b882-24ee9a37d45c",-73875493,40719567,"P.S./I.S. 49 - QUEENS","63-60 80th Street"
2,1,1,"df0d3c5b-30f4-ea11-b882-24ee9a37d45c","P.S. 105 The Blythebourne - K105 - K105 - 20K105 - 1031 59 STREET","e00d3c5b-30f4-ea11-b882-24ee9a37d45c",-74003635,40633320,"P.S. 105 - BROOKLYN","1031 59 STREET"
2,1,1,"5f6e70b7-31f4-ea11-b882-24ee9a37d45c","High School of Economics and Finance - M489 - M833 - 02M489 - 100 TRINITY PLACE","606e70b7-31f4-ea11-b882-24ee9a37d45c",-74012328,40709270,"HS FOR ECONOMICS & FINANCE - M","100 TRINITY PLACE"
1,0,1,"a2d810ab-31f4-ea11-b882-24ee9a37d45c","Manhattan Academy For Arts & Language - M427 - M620 - 02M427 - 111 EAST 33RD STREET","a0d810ab-31f4-ea11-b882-24ee9a37d45c",-73981070,40746510,"NORMAN THOMAS HS (ECF) - MANHATTAN","111 EAST 33RD STREET"
1,1,0,"40b4977a-32f4-ea11-b882-24ee9a37d45c","Queens Technical High School - Q600 - Q600 - 24Q600 - 37-02 47 AVENUE","41b4977a-32f4-ea11-b882-24ee9a37d45c",-73927995,40741658,"QUEENS VOC HS - Q","37-02 47 AVENUE"
1,0,1,"5907e99e-31f4-ea11-b882-24ee9a37d45c","High School for Health Professions and Human Services - M420 - M475 - 02M420 - 345 East 15th Street","5607e99e-31f4-ea11-b882-24ee9a37d45c",-73982590,40732665,"HEALTH PROFESSIONS HS (OL STY) - M","345 East 15th Street"
1,1,0,"1de85c61-30f4-ea11-b882-24ee9a37d45c","Achievement First East New York Charter School - K358 - K111 - 84K358 - 35 STARR STREET","18e85c61-30f4-ea11-b882-24ee9a37d45c",-73927938,40700810,"I.S. 111 - BROOKLYN","35 STARR STREET"
1,1,0,"aaeb6056-32f4-ea11-b882-24ee9a37d45c","The Hector Figueroa School - Q398 - Q398 - 30Q398 - 69-01 34TH AVENUE","abeb6056-32f4-ea11-b882-24ee9a37d45c",-73896705,40752773,"P.S. 398 - QUEENS","69-01 34TH AVENUE"
1,1,0,"f3ed94c3-31f4-ea11-b882-24ee9a37d45c","Paula Hedbavny School - M278 - M918 - 06M278 - 421 W 219th St","f4ed94c3-31f4-ea11-b882-24ee9a37d45c",-73912339,40871673,"P.S./IS 278 - MANHATTAN","421 W 219th St"
1,0,1,"8b476368-32f4-ea11-b882-24ee9a37d45c","Newtown High School - Q455 - Q455 - 24Q455 - 48-01 90 STREET","8c476368-32f4-ea11-b882-24ee9a37d45c",-73874129,40740824,"NEWTOWN HS - Q","48-01 90 STREET"
1,0,1,"34e85c61-30f4-ea11-b882-24ee9a37d45c","P.S. 116 Elizabeth L Farrell - K116 - K116 - 32K116 - 515 KNICKERBOCKER AVENUE","35e85c61-30f4-ea11-b882-24ee9a37d45c",-73916563,40698077,"P.S. 116 - BROOKLYN","515 KNICKERBOCKER AVENUE"
1,0,1,"b22ff20c-32f4-ea11-b882-24ee9a37d45c","Lighthouse Elementary School - Q106 - Q106 - 27Q106 - 180 BEACH 35 STREET","b32ff20c-32f4-ea11-b882-24ee9a37d45c",-73766846,40594738,"P.S. 106 - QUEENS","180 BEACH 35 STREET"
1,1,0,"4f474313-33f4-ea11-b882-24ee9a37d45c","P.S. 100 Isaac Clason - X100 - X100 - 08X100 - 800 TAYLOR AVENUE","50474313-33f4-ea11-b882-24ee9a37d45c",-73862760,40822552,"P.S. 100 - BRONX","800 TAYLOR AVENUE"
2,2,0,"950e6e25-32f4-ea11-b882-24ee9a37d45c","P.S. 175 The Lynn Gross Discovery School - Q175 - Q175 - 28Q175 - 64-35 102 STREET","960e6e25-32f4-ea11-b882-24ee9a37d45c",-73852210,40731016,"P.S. 175 - QUEENS","64-35 102 STREET"
1,1,0,"64395a2c-ebf6-ea11-b883-24ee9a37d459","Achievement First Apollo Charter School - K774 - K292 - 84K774 - 301 VERMONT STREET","8a283fb1-30f4-ea11-b882-24ee9a37d45c",-73893319,40671601,"I.S. 292 - BROOKLYN","301 VERMONT STREET"
2,2,0,"10b7c337-32f4-ea11-b882-24ee9a37d45c","P.S. 221 The North Hills School - Q221 - Q221 - 26Q221 - 57-40 MARATHON PARKWAY","11b7c337-32f4-ea11-b882-24ee9a37d45c",-73731518,40758808,"P.S. 221 - QUEENS","57-40 MARATHON PARKWAY"
1,1,0,"9aeb6056-32f4-ea11-b882-24ee9a37d45c","District 29 Pre-K Center - Q381 - Q387 - 29Q381 - 100-01 Springfield Boulevard","9beb6056-32f4-ea11-b882-24ee9a37d45c",-73735602,40714844,"PRE-K CENTER @100-01 SPRINGFIELD GARDENS - QUEENS","100-01 Springfield Boulevard"
1,1,0,"380d6d19-33f4-ea11-b882-24ee9a37d45c","P.S. 105 Sen Abraham Bernstein - X105 - X105 - 11X105 - 725 Brady Avenue","390d6d19-33f4-ea11-b882-24ee9a37d45c",-73866264,40853075,"P.S. 105 - BRONX","725 Brady Avenue"
1,0,1,"191bad3c-30f4-ea11-b882-24ee9a37d45c","Fort Greene Preparatory Academy - K691 - K046 - 13K691 - 100 CLERMONT AVENUE","1a1bad3c-30f4-ea11-b882-24ee9a37d45c",-73971644,40694530,"P.S. 46 - BROOKLYN","100 CLERMONT AVENUE"
1,0,1,"81886843-31f4-ea11-b882-24ee9a37d45c","P.S. 003 Charrette School - M003 - M003 - 02M003 - 490 HUDSON STREET","82886843-31f4-ea11-b882-24ee9a37d45c",-74005949,40732603,"P.S. 3 - MANHATTAN","490 HUDSON STREET"
1,0,1,"99d810ab-31f4-ea11-b882-24ee9a37d45c","Chelsea Career and Technical Education High School - M615 - M615 - 02M615 - 131 AVENUE OF THE AMERICAS","9ad810ab-31f4-ea11-b882-24ee9a37d45c",-74005058,40724630,"CHELSEA VOC HS - MANHATTAN","131 AVENUE OF THE AMERICAS"
1,0,1,"24e2abc9-30f4-ea11-b882-24ee9a37d45c","KIPP Always Mentally Prepared Charter School - K357 - K390 - 84K357 - 1224 PARK PLACE","25e2abc9-30f4-ea11-b882-24ee9a37d45c",-73937601,40672290,"I.S. 390 - BROOKLYN","1224 PARK PLACE"
1,1,0,"02ba8b86-30f4-ea11-b882-24ee9a37d45c","The Madeleine Brennan School - K201 - K201 - 20K201 - 8010 12 AVENUE","03ba8b86-30f4-ea11-b882-24ee9a37d45c",-74013749,40619043,"I.S. 201 - BROOKLYN","8010 12 AVENUE"
1,1,0,"64977d2b-32f4-ea11-b882-24ee9a37d45c","J.H.S. 185 Edward Bleeker - Q185 - Q185 - 25Q185 - 147-26 25 DRIVE","ae0e6e25-32f4-ea11-b882-24ee9a37d45c",-73818607,40774906,"J.H.S. 185 - QUEENS","147-26 25 DRIVE"
2,2,0,"ce92e6d5-30f4-ea11-b882-24ee9a37d45c","Cypress Hills Collegiate Preparatory School - K659 - K420 - 19K659 - 999 JAMAICA AVENUE","c692e6d5-30f4-ea11-b882-24ee9a37d45c",-73869305,40693002,"FRANKLIN K. LANE HS - K","999 JAMAICA AVENUE"
3,0,3,"08af0313-32f4-ea11-b882-24ee9a37d45c","P.S. 129 Patricia Larkin - Q129 - Q129 - 25Q129 - 128-02 7 Avenue","09af0313-32f4-ea11-b882-24ee9a37d45c",-73839505,40789926,"P.S. 129 - QUEENS","128-02 7 Avenue"
2,0,2,"e62d6c32-ebf6-ea11-b883-24ee9a37d459","P.S. K771 - K771 - K329 - 75K771 - 2929 WEST 30 STREET","11a198c3-30f4-ea11-b882-24ee9a37d45c",-73995770,40574666,"P.S. 329 - BROOKLYN","2929 WEST 30 STREET"
1,0,1,"6034aa92-31f4-ea11-b882-24ee9a37d45c","P.S. 138 - M138 - M380 - 75M138 - 508 WEST 153RD STREET","6134aa92-31f4-ea11-b882-24ee9a37d45c",-73944846,40830415,"P.S. 380- MANHATTAN","508 WEST 153RD STREET"
1,1,0,"0dcf496e-31f4-ea11-b882-24ee9a37d45c","Emma Lazarus High School - M394 - M131 - 02M394 - 100 HESTER STREET","03cf496e-31f4-ea11-b882-24ee9a37d45c",-73993607,40716231,"I.S. 131 - MANHATTAN","100 HESTER STREET"
1,1,0,"8c886843-31f4-ea11-b882-24ee9a37d45c","P.S. 006 Lillie D. Blake - M006 - M006 - 02M006 - 45 EAST 81 STREET","8d886843-31f4-ea11-b882-24ee9a37d45c",-73960427,40777737,"P.S. 6 - MANHATTAN","45 EAST 81 STREET"
12,8,4,"a52aa42b-33f4-ea11-b882-24ee9a37d45c","Riverdale / Kingsbridge Academy (Middle School / High School 141) - X141 - X141 - 10X141 - 660 West 237 Street","a62aa42b-33f4-ea11-b882-24ee9a37d45c",-73914141,40887407,"M.S./H.S. 141 - BRONX","660 West 237 Street"
1,1,0,"43474313-33f4-ea11-b882-24ee9a37d45c","J.H.S. 098 Herman Ridder - X098 - X098 - 12X098 - 1619 BOSTON ROAD","3c474313-33f4-ea11-b882-24ee9a37d45c",-73890591,40836245,"I.S. 98 - BRONX","1619 BOSTON ROAD"
1,1,0,"49ebaa73-30f4-ea11-b882-24ee9a37d45c","The East New York Arts and Civics High School - K953 - K166 - 19K953 - 800 VAN SICLEN AVE","41ebaa73-30f4-ea11-b882-24ee9a37d45c",-73885704,40659934,"I.S. 166 - BROOKLYN","800 VAN SICLEN AVE"
1,1,0,"2baf0313-32f4-ea11-b882-24ee9a37d45c","P.S. 139 Rego Park - Q139 - Q139 - 28Q139 - 93-06 63 DRIVE","29af0313-32f4-ea11-b882-24ee9a37d45c",-73862561,40728012,"P.S. 139 - QUEENS","93-06 63 DRIVE"
1,0,1,"0206003e-32f4-ea11-b882-24ee9a37d45c","The Ivan Lafayette Early Childhood School of the Arts - Q228 - Q228 - 30Q228 - 32-63 93 STREET","0306003e-32f4-ea11-b882-24ee9a37d45c",-73874947,40756931,"P.S. 228 (ECC) - QUEENS","32-63 93 STREET"
2,1,1,"8f0e6e25-32f4-ea11-b882-24ee9a37d45c","P.S. 173 Fresh Meadows - Q173 - Q173 - 26Q173 - 174-10 67 AVENUE","900e6e25-32f4-ea11-b882-24ee9a37d45c",-73795651,40734097,"P.S. 173 - QUEENS","174-10 67 AVENUE"
2,2,0,"f6f57030-30f4-ea11-b882-24ee9a37d45c","P.S. 015 Patrick F. Daly - K015 - K015 - 15K015 - 71 SULLIVAN STREET","f5f57030-30f4-ea11-b882-24ee9a37d45c",-74011864,40677085,"P.S. 15 - BROOKLYN","71 SULLIVAN STREET"
2,1,1,"602b3eee-30f4-ea11-b882-24ee9a37d45c","High School for Innovation in Advertising and Media - K617 - K500 - 18K617 - 1600 ROCKAWAY PARKWAY","5e2b3eee-30f4-ea11-b882-24ee9a37d45c",-73898601,40640543,"CANARSIE HS - K","1600 ROCKAWAY PARKWAY"
1,0,1,"a132c3fb-eaf6-ea11-b883-24ee9a37d459","P.S. 085 Judge Charles Vallone - Q085 - Q085 - 30Q085 - 23-70 31 STREET","0a7eed06-32f4-ea11-b882-24ee9a37d45c",-73915039,40773126,"P.S. 85 - QUEENS","23-70 31 STREET"
2,2,0,"fbfb3df4-30f4-ea11-b882-24ee9a37d45c","Edward R. Murrow High School - K525 - K525 - 21K525 - 1600 AVENUE L","fafb3df4-30f4-ea11-b882-24ee9a37d45c",-73959141,40619671,"EDWARD R. MURROW HS - K","1600 AVENUE L"
3,3,0,"538dbfcf-30f4-ea11-b882-24ee9a37d45c","Abraham Lincoln High School - K410 - K410 - 21K410 - 2800 OCEAN PARKWAY","518dbfcf-30f4-ea11-b882-24ee9a37d45c",-73968733,40582627,"ABRAHAM LINCOLN HS - K","2800 OCEAN PARKWAY"
1,0,1,"1778931f-33f4-ea11-b882-24ee9a37d45c","Girls Preparatory Charter School of the Bronx - X487 - X120 - 84X487 - 890 CAULDWELL AVENUE","1478931f-33f4-ea11-b882-24ee9a37d45c",-73906739,40822291,"I.S. 301 - BRONX","890 CAULDWELL AVENUE"
1,0,1,"db77bb9f-33f4-ea11-b882-24ee9a37d45c","P.S. 067 Mohegan School - X067 - X967 - 12X067 - 2024 Mohegan Avenue","dc77bb9f-33f4-ea11-b882-24ee9a37d45c",-73884192,40843781,"P.S. 67 TRANSPORTABLE - X","2024 Mohegan Avenue"
1,0,1,"fcb98b86-30f4-ea11-b882-24ee9a37d45c","P.S. 199 Frederick Wachtel - K199 - K199 - 21K199 - 1100 ELM AVENUE","fdb98b86-30f4-ea11-b882-24ee9a37d45c",-73963026,40616310,"P.S. 199 - BROOKLYN","1100 ELM AVENUE"
1,1,0,"d8e8ce00-32f4-ea11-b882-24ee9a37d45c","P.S. 079 Francis Lewis - Q079 - Q079 - 25Q079 - 147-27 15 DRIVE","d7e8ce00-32f4-ea11-b882-24ee9a37d45c",-73817338,40786201,"P.S. 79 - QUEENS","147-27 15 DRIVE"
2,1,1,"60b50aa5-30f4-ea11-b882-24ee9a37d45c","J.H.S. 259 William McKinley - K259 - K259 - 20K259 - 7305 Ft Hamilton Parkway","61b50aa5-30f4-ea11-b882-24ee9a37d45c",-74014633,40626089,"I.S. 259 - BROOKLYN","7305 Ft Hamilton Parkway"
1,1,0,"9cd810ab-31f4-ea11-b882-24ee9a37d45c","NYC iSchool - M376 - M615 - 02M376 - 131 AVENUE OF THE AMERICAS","9ad810ab-31f4-ea11-b882-24ee9a37d45c",-74005058,40724630,"CHELSEA VOC HS - MANHATTAN","131 AVENUE OF THE AMERICAS"
1,1,0,"e377bb9f-33f4-ea11-b882-24ee9a37d45c","Urban Assembly School for Applied Math and Science, The - X241 - X970 - 09X241 - 1595 BATHGATE AVENUE","e177bb9f-33f4-ea11-b882-24ee9a37d45c",-73901774,40839508,"BATHGATE HS - BRONX","1595 BATHGATE AVENUE"
1,0,1,"bde0838c-31f4-ea11-b882-24ee9a37d45c","Washington Heights Academy - M366 - M263 - 06M366 - 202 SHERMAN AVE","bee0838c-31f4-ea11-b882-24ee9a37d45c",-73921631,40865575,"PS/IS 263 - Manhattan","202 SHERMAN AVE"
1,1,0,"019ebaee-32f4-ea11-b882-24ee9a37d45c","Eximius College Preparatory Academy: A College Board School - X250 - X002 - 09X250 - 1363 FULTON AVENUE","d974b6e8-32f4-ea11-b882-24ee9a37d45c",-73902794,40833884,"MORRISANIA SEC ED COMPLEX-X","1363 FULTON AVENUE"
1,0,1,"be56635c-33f4-ea11-b882-24ee9a37d45c","Bronx River High School - X349 - X405 - 08X349 - 3000 EAST TREMONT AVENUE","b556635c-33f4-ea11-b882-24ee9a37d45c",-73839583,40839775,"HERBERT H. LEHMAN HS - X","3000 EAST TREMONT AVENUE"
1,1,0,"907e21a6-ebf6-ea11-b883-24ee9a37d459","P.S./I.S. 78Q - Q078 - Q312 - 30Q078 - 46-08 5TH STREET","cf454b50-32f4-ea11-b882-24ee9a37d45c",-73955145,40747077,"P.S./.IS. 78 - QUEENS","46-08 5TH STREET"
1,1,0,"8407e99e-31f4-ea11-b882-24ee9a37d45c","Manhattan / Hunter Science High School - M541 - M490 - 03M541 - 122 AMSTERDAM AVENUE","7c07e99e-31f4-ea11-b882-24ee9a37d45c",-73985608,40774891,"MARTIN LUTHER KING, JR. HS - M","122 AMSTERDAM AVENUE"
1,1,0,"882aa42b-33f4-ea11-b882-24ee9a37d45c","P186X Walter J. Damrosch School - X186 - X136 - 75X186 - 750 Jennings Street","892aa42b-33f4-ea11-b882-24ee9a37d45c",-73897797,40831388,"P.S. 186 (OLD J136) - BRONX","750 Jennings Street"
1,0,1,"30c15a75-ebf6-ea11-b883-24ee9a37d459","Adult and Continuing Education - K755 - M827 - 79K755 - 500 8 AVENUE","576e70b7-31f4-ea11-b882-24ee9a37d45c",-73992405,40753038,"AUX. SERV-MAN. LEARNING CENTER - M","500 8 AVENUE"
1,0,1,"c5689025-33f4-ea11-b882-24ee9a37d45c","P.S. 130 Abram Stevens Hewitt - X130 - X130 - 08X130 - 750 PROSPECT AVENUE","c4689025-33f4-ea11-b882-24ee9a37d45c",-73901709,40817742,"P.S. 130 - BRONX","750 PROSPECT AVENUE"
1,0,1,"520b210d-33f4-ea11-b882-24ee9a37d45c","P.S. 085 Great Expectations - X085 - X085 - 10X085 - 2400 MARION AVENUE","530b210d-33f4-ea11-b882-24ee9a37d45c",-73894682,40858689,"P.S. 85 - BRONX","2400 MARION AVENUE"
1,1,0,"dc8521d0-32f4-ea11-b882-24ee9a37d45c","P.S. 069 Daniel D. Tompkins - R069 - R069 - 31R069 - 144 KEATING PLACE","dd8521d0-32f4-ea11-b882-24ee9a37d45c",-74157327,40591480,"P.S. 69 - STATEN ISLAND","144 KEATING PLACE"
1,0,1,"e2e0a4fb-ebf6-ea11-b883-24ee9a37d459","P.S. X010 - X010 - X240 - 75X010 - 1501 JEROME AVENUE","baba3c50-33f4-ea11-b882-24ee9a37d45c",-73916084,40842503,"DOE NEW SETTLEMENT COMMUNITY CAMPUS - X","1501 JEROME AVENUE"
1,0,1,"69c130ae-6c0c-ed11-b091-088e901ef405","P.S. X010 - X010 - X104 - 75X010 - 1449 SHAKESPEARE AVENUE","360d6d19-33f4-ea11-b882-24ee9a37d45c",-73920826,40843453,"P.S. 199 - BRONX","1449 SHAKESPEARE AVENUE"
1,1,0,"8e476368-32f4-ea11-b882-24ee9a37d45c","International High School for Health Sciences - Q236 - Q455 - 24Q236 - 48-01 90 STREET","8c476368-32f4-ea11-b882-24ee9a37d45c",-73874129,40740824,"NEWTOWN HS - Q","48-01 90 STREET"
1,0,1,"c9883319-32f4-ea11-b882-24ee9a37d45c","I.S. 141 The Steinway - Q141 - Q141 - 30Q141 - 37-11 21 AVENUE","ca883319-32f4-ea11-b882-24ee9a37d45c",-73904508,40775766,"I.S. 141 - QUEENS","37-11 21 AVENUE"
1,1,0,"fd8ac007-ebf6-ea11-b883-24ee9a37d459","KIPP Freedom Charter School - X598 - X859 - 84X598 - 2246 JEROME AVENUE","a3593c87-33f4-ea11-b882-24ee9a37d45c",-73903764,40857932,"P.S. 315 - BRONX","2246 JEROME AVENUE"
1,0,1,"31ff3d8d-33f4-ea11-b882-24ee9a37d45c","P.S. 085 Great Expectations - X085 - X885 - 10X085 - 2400 MARION AVENUE","32ff3d8d-33f4-ea11-b882-24ee9a37d45c",-73894682,40858689,"P.S. 85 MINISCHOOL - BRONX","2400 MARION AVENUE"
2,2,0,"1a9ebaee-32f4-ea11-b882-24ee9a37d45c","P.S. 008 Isaac Varian - X008 - X008 - 10X008 - 3010 BRIGGS AVENUE","1b9ebaee-32f4-ea11-b882-24ee9a37d45c",-73883339,40872259,"P.S. 8 - BRONX","3010 BRIGGS AVENUE"
1,1,0,"acbfa431-33f4-ea11-b882-24ee9a37d45c","I.S. 339 - X339 - X147 - 09X339 - 1600 WEBSTER AVENUE","a9bfa431-33f4-ea11-b882-24ee9a37d45c",-73904353,40840536,"I.S. 339 (OLD 147) - BRONX","1600 WEBSTER AVENUE"
1,1,0,"27005d7a-31f4-ea11-b882-24ee9a37d45c","P.S. 163 Alfred E. Smith - M163 - M163 - 03M163 - 163 West 97 Street","26005d7a-31f4-ea11-b882-24ee9a37d45c",-73968470,40795163,"P.S. 163 - MANHATTAN","163 West 97 Street"
1,1,0,"cbd27c6d-30f4-ea11-b882-24ee9a37d45c","P.S. 139 Alexine A. Fenty - K139 - K139 - 22K139 - 330 RUGBY ROAD","cad27c6d-30f4-ea11-b882-24ee9a37d45c",-73965862,40641340,"P.S. 139 - BROOKLYN","330 RUGBY ROAD"
1,0,1,"d874b6e8-32f4-ea11-b882-24ee9a37d45c","Bronx Center for Science and Mathematics - X260 - X002 - 09X260 - 1363 FULTON AVENUE","d974b6e8-32f4-ea11-b882-24ee9a37d45c",-73902794,40833884,"MORRISANIA SEC ED COMPLEX-X","1363 FULTON AVENUE"
1,0,1,"0a9c4c1f-32f4-ea11-b882-24ee9a37d45c","P.S. 165 Edith K. Bergtraum - Q165 - Q165 - 25Q165 - 70-35 150 Street","0b9c4c1f-32f4-ea11-b882-24ee9a37d45c",-73816966,40729746,"P.S. 165 - QUEENS","70-35 150 Street"
1,0,1,"2302926e-32f4-ea11-b882-24ee9a37d45c","High School for Community Leadership - Q328 - Q470 - 28Q328 - 167-01 GOTHIC DRIVE","1f02926e-32f4-ea11-b882-24ee9a37d45c",-73798658,40714551,"JAMAICA HS - Q","167-01 GOTHIC DRIVE"
2,1,1,"38005d7a-31f4-ea11-b882-24ee9a37d45c","J.H.S. 167 Robert F. Wagner - M167 - M167 - 02M167 - 220 EAST 76 STREET","39005d7a-31f4-ea11-b882-24ee9a37d45c",-73957827,40771541,"I.S. 167 - MANHATTAN","220 EAST 76 STREET"
1,0,1,"c4ab074a-33f4-ea11-b882-24ee9a37d45c","I.S. 206 Ann Mersereau - X206 - X206 - 10X206 - 2280 AQUEDUCT AVENUE","c5ab074a-33f4-ea11-b882-24ee9a37d45c",-73906285,40859534,"I.S. 206B - BRONX","2280 AQUEDUCT AVENUE"
2,2,0,"d79b4c1f-32f4-ea11-b882-24ee9a37d45c","P.S. 150 Queens - Q150 - Q150 - 30Q150 - 40-01 43 AVENUE","d89b4c1f-32f4-ea11-b882-24ee9a37d45c",-73923375,40745887,"P.S. 150 - QUEENS","40-01 43 AVENUE"
1,0,1,"2f416e00-31f4-ea11-b882-24ee9a37d45c","Brooklyn High School of the Arts - K656 - K655 - 15K656 - 345 DEAN STREET","30416e00-31f4-ea11-b882-24ee9a37d45c",-73980266,40683951,"BKLYN HS OF THE ARTS (OL S J HL)-K","345 DEAN STREET"
1,1,0,"0ea198c3-30f4-ea11-b882-24ee9a37d45c","P.S. 328 Phyllis Wheatley - K328 - K328 - 19K328 - 330 ALABAMA AVENUE","0ca198c3-30f4-ea11-b882-24ee9a37d45c",-73898249,40667985,"P.S. 328 - BROOKLYN","330 ALABAMA AVENUE"
1,1,0,"ef3159fa-30f4-ea11-b882-24ee9a37d45c","District 13 PRE-K Center - K869 - K611 - 13K869 - 19 DOCK STREET","f03159fa-30f4-ea11-b882-24ee9a37d45c",-73992076,40702952,"DOCK ST CAMPUS - BROOKLYN","25 DOCK STREET"
1,1,0,"516e70b7-31f4-ea11-b882-24ee9a37d45c","P.S. 527 - East Side School for Social Action - M527 - M816 - 02M527 - 323 EAST 91 STREET","526e70b7-31f4-ea11-b882-24ee9a37d45c",-73947856,40780652,"P.S. 527 - East Side School for Social Action","323 EAST 91 STREET"
2,2,0,"0fc73b4a-32f4-ea11-b882-24ee9a37d45c","P.S. 273 - Q273 - Q273 - 27Q273 - 88-07 102ND STREET","10c73b4a-32f4-ea11-b882-24ee9a37d45c",-73844335,40693613,"P.S. 273 - QUEENS","88-07 102ND STREET"
1,1,0,"c2fc24e8-31f4-ea11-b882-24ee9a37d45c","World Journalism Preparatory: A College Board School - Q285 - Q025 - 25Q285 - 34-65 192 STREET","befc24e8-31f4-ea11-b882-24ee9a37d45c",-73789365,40764884,"J.H.S. 25 - QUEENS","34-65 192 STREET"
3,1,2,"2d767649-31f4-ea11-b882-24ee9a37d45c","P.S. 020 Anna Silver - M020 - M020 - 01M020 - 166 ESSEX STREET","2e767649-31f4-ea11-b882-24ee9a37d45c",-73986312,40721305,"P.S. 20 - MANHATTAN","166 ESSEX STREET"
5,5,0,"6ce2635c-32f4-ea11-b882-24ee9a37d45c","Bayside High School - Q495 - Q405 - 26Q495 - 32-24 CORPORAL KENNEDY STREET","6be2635c-32f4-ea11-b882-24ee9a37d45c",-73781041,40771398,"BAYSIDE HS - Q","32-24 CORPORAL KENNEDY STREET"
1,0,1,"68977d2b-32f4-ea11-b882-24ee9a37d45c","P.S. 186 Castlewood - Q186 - Q186 - 26Q186 - 252-12 72 AVENUE","67977d2b-32f4-ea11-b882-24ee9a37d45c",-73721594,40749556,"P.S. 186 - QUEENS","252-12 72 AVENUE"
1,0,1,"bf0a7997-4afb-ea11-b883-24ee9a37d459","Bronx River Headstart - XAKE - XAKE -  - 1555 EAST 174 STREET","c00a7997-4afb-ea11-b883-24ee9a37d459",-73876976,40834952,"BRONX RIVER HEADSTART","1555 EAST 174 STREET"
1,1,0,"4b0b210d-33f4-ea11-b882-24ee9a37d45c","P.S. 083 Donald Hertz - X083 - X083 - 11X083 - 950 RHINELANDER AVENUE","4c0b210d-33f4-ea11-b882-24ee9a37d45c",-73858769,40849176,"P.S. 83 - BRONX","950 RHINELANDER AVENUE"
2,2,0,"68dc32dc-31f4-ea11-b882-24ee9a37d45c","Success Academy Charter School - Hudson Yards - M358 - MBMO - 84M358 - 500 West 41 Street","dd430bd6-31f4-ea11-b882-24ee9a37d45c",-73996499,40758759,"Hudson Yards","500 West 41 Street"
1,1,0,"8653dd74-33f4-ea11-b882-24ee9a37d45c","Harry S Truman High School - X455 - X455 - 11X455 - 750 BAYCHESTER AVENUE","8253dd74-33f4-ea11-b882-24ee9a37d45c",-73831669,40874035,"HARRY S. TRUMAN HS - X","750 BAYCHESTER AVENUE"
1,1,0,"686e70b7-31f4-ea11-b882-24ee9a37d45c","West End Secondary School - M291 - M837 - 03M291 - 227-243 West 61st Street","696e70b7-31f4-ea11-b882-24ee9a37d45c",-73988338,40772608,"BEACON HS - MANHATTAN","227-243 West 61st Street"
1,1,0,"409f4974-31f4-ea11-b882-24ee9a37d45c","J.H.S. 143 Eleanor Roosevelt - M143 - M143 - 06M143 - 511 WEST 182ND STREET","3f9f4974-31f4-ea11-b882-24ee9a37d45c",-73930991,40849311,"I.S. 143 - MANHATTAN","511 WEST 182ND STREET"
2,0,2,"e7201dab-30f4-ea11-b882-24ee9a37d45c","J.H.S. 278 Marine Park - K278 - K278 - 22K278 - 1925 STUART STREET","e8201dab-30f4-ea11-b882-24ee9a37d45c",-73938721,40606745,"I.S. 278 - BROOKLYN","1925 STUART STREET"
1,1,0,"8c72c880-32f4-ea11-b882-24ee9a37d45c","Thomas A. Edison Career and Technical Education High School - Q620 - Q620 - 28Q620 - 165-65 84 AVENUE","49b4977a-32f4-ea11-b882-24ee9a37d45c",-73799692,40716071,"THOMAS A. EDISON VOC HS - Q","165-65 84 AVENUE"
1,1,0,"df2ece86-32f4-ea11-b882-24ee9a37d45c","Bard High School Early College Queens - Q299 - Q735 - 24Q299 - 30-20 THOMSON AVENUE","db2ece86-32f4-ea11-b882-24ee9a37d45c",-73937004,40744175,"QUEENS HIGH SCHOOL COMPLEX - Q","30-20 THOMSON AVENUE"
1,0,1,"dbfab455-31f4-ea11-b882-24ee9a37d45c","Tompkins Square Middle School - M839 - M064 - 01M839 - 600 EAST 6 STREET","d3fab455-31f4-ea11-b882-24ee9a37d45c",-73981597,40723130,"P.S. 64 (OLD 71) - MANHATTAN","600 EAST 6 STREET"
1,1,0,"2da10a44-32f4-ea11-b882-24ee9a37d45c","P.S. 128 The Lorraine Tuzzo, Juniper Valley Elementary School - Q128 - Q247 - 24Q128 - 69-10 65th Drive","2ca10a44-32f4-ea11-b882-24ee9a37d45c",-73885974,40715005,"PS/IS 128","69-10 65th Drive"
1,1,0,"33474313-33f4-ea11-b882-24ee9a37d45c","Ampark Neighborhood - X344 - X095 - 10X344 - 3961 HILLMAN AVENUE","34474313-33f4-ea11-b882-24ee9a37d45c",-73891664,40883049,"P.S. 95 - BRONX","3961 HILLMAN AVENUE"
2,1,1,"63b50aa5-30f4-ea11-b882-24ee9a37d45c","The Fresh Creek School - K325 - K260 - 19K325 - 875 WILLIAMS AVENUE","64b50aa5-30f4-ea11-b882-24ee9a37d45c",-73893294,40653368,"P.S. 260 - BROOKLYN","875 WILLIAMS AVENUE"
2,0,2,"982aa42b-33f4-ea11-b882-24ee9a37d45c","P.S./I.S. 224 - X224 - X139 - 07X224 - 345 BROOK AVENUE","942aa42b-33f4-ea11-b882-24ee9a37d45c",-73918774,40810314,"J.H.S. 222 - BRONX","345 BROOK AVENUE"
1,1,0,"cdfab455-31f4-ea11-b882-24ee9a37d45c","Neighborhood School - M363 - M063 - 01M363 - 121 EAST 3 STREET","cefab455-31f4-ea11-b882-24ee9a37d45c",-73986214,40724440,"P.S. 63 - MANHATTAN","121 EAST 3 STREET"
1,0,1,"91e657bd-30f4-ea11-b882-24ee9a37d45c","P.S. 506: The School of Journalism & Technology - K506 - K314 - 20K506 - 330 59 Street","8ee657bd-30f4-ea11-b882-24ee9a37d45c",-74019299,40641950,"P.S. 314 - BROOKLYN","330 59 Street"
2,1,1,"cbe8ce00-32f4-ea11-b882-24ee9a37d45c","I.S. 73 - The Frank Sansivieri Intermediate School - Q073 - Q073 - 24Q073 - 70-02 54 AVENUE","cce8ce00-32f4-ea11-b882-24ee9a37d45c",-73893318,40728558,"I.S. 73 - QUEENS","70-02 54 AVENUE"
2,2,0,"d1d27c6d-30f4-ea11-b882-24ee9a37d45c","The Brooklyn New School, P.S. 146 - K146 - K142 - 15K146 - 610 HENRY STREET","cfd27c6d-30f4-ea11-b882-24ee9a37d45c",-74002022,40679462,"J.H.S. 142 - BROOKLYN","610 HENRY STREET"
1,0,1,"00cf496e-31f4-ea11-b882-24ee9a37d45c","P.S. 129 John H. Finley - M129 - M129 - 05M129 - 425 WEST 130 STREET","fece496e-31f4-ea11-b882-24ee9a37d45c",-73952020,40814914,"P.S. 129 - MANHATTAN","425 WEST 130 STREET"
1,1,0,"22d8cf12-31f4-ea11-b882-24ee9a37d45c","Success Academy Charter School - Bergen Beach - K781 - K864 - 84K781 - 3109 NEWKIRK AVENUE","23d8cf12-31f4-ea11-b882-24ee9a37d45c",-73947025,40640551,"P.S. 361 (OLD 89) - BROOKLYN","3109 NEWKIRK AVENUE"
1,0,1,"35a6ba98-31f4-ea11-b882-24ee9a37d45c","The Urban Assembly School for Green Careers - M402 - M470 - 03M402 - 145 WEST 84 STREET","33a6ba98-31f4-ea11-b882-24ee9a37d45c",-73974483,40786134,"LOUIS D. BRANDEIS HS - MANHATTAN","145 WEST 84 STREET"
5,4,1,"1e06003e-32f4-ea11-b882-24ee9a37d45c","East-West School of International Studies - Q281 - Q237 - 25Q281 - 46-21 COLDEN STREET","1b06003e-32f4-ea11-b882-24ee9a37d45c",-73821402,40749430,"J.H.S. 237 - QUEENS","46-21 COLDEN STREET"
2,0,2,"f98ac007-ebf6-ea11-b883-24ee9a37d459","P.S. 723 - X723 - X701 - 75X723 - 3540 Bivona Street","aaeb0e7b-33f4-ea11-b882-24ee9a37d45c",-73831856,40882980,"P.S. 723 - BRONX","3540 Bivona Street"
1,0,1,"399f4974-31f4-ea11-b882-24ee9a37d45c","P.S. 140 Nathan Straus - M140 - M140 - 01M140 - 123 RIDGE STREET","3a9f4974-31f4-ea11-b882-24ee9a37d45c",-73983769,40719148,"P.S. 140 - MANHATTAN","123 RIDGE STREET"
1,1,0,"ac2aa42b-33f4-ea11-b882-24ee9a37d45c","The New School for Leadership and Journalism - X244 - X143 - 10X244 - 120 WEST 231 STREET","ad2aa42b-33f4-ea11-b882-24ee9a37d45c",-73901565,40875636,"I.S. 143 - BRONX","120 WEST 231 STREET"
1,0,1,"e3315367-30f4-ea11-b882-24ee9a37d45c","P.S. 138 Brooklyn - K138 - K138 - 17K138 - 760 PROSPECT PLACE","e4315367-30f4-ea11-b882-24ee9a37d45c",-73951559,40673943,"P.S. 138 - BROOKLYN","760 PROSPECT PLACE"
1,1,0,"68ffcc6e-33f4-ea11-b882-24ee9a37d45c","Millennium Art Academy - X312 - X450 - 08X312 - 1980 LAFAYETTE AVENUE","62ffcc6e-33f4-ea11-b882-24ee9a37d45c",-73855930,40821218,"Adlai E. Stevenson Educational Campus","1980 LAFAYETTE AVENUE"
1,1,0,"f2ae0313-32f4-ea11-b882-24ee9a37d45c","P.S. 122 Mamie Fay - Q122 - Q122 - 30Q122 - 21-21 DITMARS BOULEVARD","cb2ff20c-32f4-ea11-b882-24ee9a37d45c",-73915785,40780507,"P.S. 122 - QUEENS","21-21 DITMARS BOULEVARD"
1,0,1,"a5e657bd-30f4-ea11-b882-24ee9a37d45c","Ebbets Field Middle School - K352 - K320 - 17K352 - 46 MCKEEVER PLACE","a1e657bd-30f4-ea11-b882-24ee9a37d45c",-73959484,40665199,"P.S. 375 - BROOKLYN","46 MCKEEVER PLACE"
1,1,0,"56f4a0ef-eaf6-ea11-b883-24ee9a37d459","Achievement First Voyager Charter School - K876 - K092 - 84K876 - 601 PARKSIDE AVENUE","86d92255-30f4-ea11-b882-24ee9a37d45c",-73953810,40656276,"P.S. 92 - BROOKLYN","601 PARKSIDE AVENUE"
2,2,0,"1baf0313-32f4-ea11-b882-24ee9a37d45c","The Bellaire School - Q135 - Q135 - 29Q135 - 207-11 89 AVENUE","1caf0313-32f4-ea11-b882-24ee9a37d45c",-73757591,40720864,"P.S. 135 - QUEENS","207-11 89 AVENUE"
1,0,1,"dd92e6d5-30f4-ea11-b882-24ee9a37d45c","Spring Creek Community School - K422 - K422 - 19K422 - 1065 Elton Street","da92e6d5-30f4-ea11-b882-24ee9a37d45c",-73874064,40657266,"SPRING CREEK EDUCATIONAL CAMPUS - BROOKLYN","1065 Elton Street"
1,0,1,"20eabc42-30f4-ea11-b882-24ee9a37d45c","J.H.S. 050 John D. Wells - K050 - K050 - 14K050 - 183 SOUTH 3 STREET","1feabc42-30f4-ea11-b882-24ee9a37d45c",-73960137,40711915,"J.H.S. 50 - BROOKLYN","183 SOUTH 3 STREET"
1,0,1,"cb689025-33f4-ea11-b882-24ee9a37d45c","Soundview Academy for Culture and Scholarship - X448 - X131 - 08X448 - 885 Bolton Avenue","c8689025-33f4-ea11-b882-24ee9a37d45c",-73859998,40822925,"I.S. 131 - BRONX","885 Bolton Avenue"
1,0,1,"dd6fc305-e8fe-eb11-b8b2-24ee9a37d45c","Coney Island YMCA - KDYK - KDSJ -  - 2980 West 29 Street","de6fc305-e8fe-eb11-b8b2-24ee9a37d45c",-73995169,0,"2980 WEST 29 STREET","2980 West 29 Street"
2,0,2,"d6689025-33f4-ea11-b882-24ee9a37d45c","P.S. 134 George F. Bristow - X134 - X134 - 12X134 - 1330 BRISTOW STREET","d7689025-33f4-ea11-b882-24ee9a37d45c",-73894241,40831613,"P.S. 134 - BRONX","1330 BRISTOW STREET"
1,1,0,"752f77fa-31f4-ea11-b882-24ee9a37d45c","P.S. 068 Cambridge - Q068 - Q068 - 24Q068 - 59-09 SAINT FELIX AVENUE","762f77fa-31f4-ea11-b882-24ee9a37d45c",-73897372,40696961,"P.S. 68 - QUEENS","59-09 SAINT FELIX AVENUE"
1,0,1,"4f0d6d19-33f4-ea11-b882-24ee9a37d45c","P.S. 111 Seton Falls - X111 - X111 - 11X111 - 3740 Baychester Avenue","4d0d6d19-33f4-ea11-b882-24ee9a37d45c",-73839288,40884371,"P.S. 111 - BRONX","3740 Baychester Avenue"
1,0,1,"89886843-31f4-ea11-b882-24ee9a37d45c","P.S. 005 Ellen Lurie - M005 - M005 - 06M005 - 3703 TENTH AVENUE","8a886843-31f4-ea11-b882-24ee9a37d45c",-73922277,40857633,"P.S. 5 - MANHATTAN","3703 TENTH AVENUE"
1,0,1,"4f36d900-33f4-ea11-b882-24ee9a37d45c","P.S. 047 John Randolph - X047 - X047 - 12X047 - 1794 EAST 172 STREET","5036d900-33f4-ea11-b882-24ee9a37d45c",-73866974,40832529,"P.S. 47 - BRONX","1794 EAST 172 STREET"
1,1,0,"eb9b4c1f-32f4-ea11-b882-24ee9a37d45c","P.S. 156 Laurelton - Q156 - Q156 - 29Q156 - 229-02 137 AVENUE","e69b4c1f-32f4-ea11-b882-24ee9a37d45c",-73743327,40672259,"P.S. 156 - QUEENS","229-02 137 AVENUE"
2,1,1,"36474313-33f4-ea11-b882-24ee9a37d45c","P.S. 094 Kings College School - X094 - X094 - 10X094 - 3530 KINGS COLLEGE PLACE","37474313-33f4-ea11-b882-24ee9a37d45c",-73875268,40880661,"P.S. 94 - BRONX","3530 KINGS COLLEGE PLACE"
1,0,1,"380b210d-33f4-ea11-b882-24ee9a37d45c","J.H.S. 080 The Mosholu Parkway - X080 - X080 - 10X080 - 149 EAST MOSHOLU PKWY N","370b210d-33f4-ea11-b882-24ee9a37d45c",-73881245,40876819,"I.S. 80/P.S. 280 - BRONX","3202 STEUBEN AVENUE"
1,0,1,"ff02cefa-32f4-ea11-b882-24ee9a37d45c","P.S. 036 Unionport - X036 - X036 - 08X036 - 1070 Castle Hill Avenue","0c18b7f4-32f4-ea11-b882-24ee9a37d45c",-73849791,40829480,"P.S. 36 - BRONX","1070 Castle Hill Avenue"
2,2,0,"18474313-33f4-ea11-b882-24ee9a37d45c","P.S. 086 Kingsbridge Heights - X086 - X086 - 10X086 - 2756 RESERVOIR AVENUE","19474313-33f4-ea11-b882-24ee9a37d45c",-73897066,40869061,"P.S. 86 - BRONX","2756 RESERVOIR AVENUE"
1,1,0,"54ebaa73-30f4-ea11-b882-24ee9a37d45c","P.S. 169 Sunset Park - K169 - K169 - 15K169 - 4305 7 AVENUE","55ebaa73-30f4-ea11-b882-24ee9a37d45c",-74001700,40645825,"P.S. 169 - BROOKLYN","4305 7 AVENUE"
1,1,0,"66a5db98-30f4-ea11-b882-24ee9a37d45c","P.S. 238 Anne Sullivan - K238 - K238 - 21K238 - 1633 EAST 8 STREET","65a5db98-30f4-ea11-b882-24ee9a37d45c",-73964586,40608801,"P.S. 238 - BROOKLYN","1633 EAST 8 STREET"
1,0,1,"4be95536-4afb-ea11-b883-24ee9a37d459","HUDSON GUILD CHILDREN'S CENTER - MAUP - MAUP -  - 459 West 26 Street","4ce95536-4afb-ea11-b883-24ee9a37d459",-74002140,40749805,"HUDSON GUILD CHILDREN'S CENTER","459 West 26 Street"
1,1,0,"9e9c11e8-30f4-ea11-b882-24ee9a37d45c","Academy for College Preparation and Career Exploration: A College Board School - K382 - K465 - 17K382 - 911 FLATBUSH AVENUE","9d9c11e8-30f4-ea11-b882-24ee9a37d45c",-73957173,40649602,"ERASMUS HALL CAMPUS - K","911 FLATBUSH AVENUE"
1,1,0,"84476368-32f4-ea11-b882-24ee9a37d45c","Long Island City High School - Q450 - Q452 - 30Q450 - 14-30 BROADWAY","81476368-32f4-ea11-b882-24ee9a37d45c",-73933907,40765881,"LONG ISLAND CITY HS(NEW)-Q","14-30 BROADWAY"
1,0,1,"88c1797b-ebf6-ea11-b883-24ee9a37d459","Restart Academy - M973 - MAKG -  - 411 WEST 114 STREET","8a3eb8c9-31f4-ea11-b882-24ee9a37d45c",-73960923,40805305,"CARES","411 WEST 114 STREET"
2,2,0,"bb3aa668-33f4-ea11-b882-24ee9a37d45c","Bronx High School for Law and Community Service - X439 - X435 - 10X439 - 500 EAST FORDHAM ROAD","b03aa668-33f4-ea11-b882-24ee9a37d45c",-73888625,40859466,"THEODORE ROOSEVELT EDUCATIONAL CAMPUS - X","500 EAST FORDHAM ROAD"
1,0,1,"b33aa668-33f4-ea11-b882-24ee9a37d45c","Knowledge and Power Preparatory Academy International High School (Kappa) - X374 - X435 - 10X374 - 500 EAST FORDHAM ROAD","b03aa668-33f4-ea11-b882-24ee9a37d45c",-73888625,40859466,"THEODORE ROOSEVELT EDUCATIONAL CAMPUS - X","500 EAST FORDHAM ROAD"
1,0,1,"b73aa668-33f4-ea11-b882-24ee9a37d45c","Fordham High School for the Arts - X437 - X435 - 10X437 - 500 EAST FORDHAM ROAD","b03aa668-33f4-ea11-b882-24ee9a37d45c",-73888625,40859466,"THEODORE ROOSEVELT EDUCATIONAL CAMPUS - X","500 EAST FORDHAM ROAD"
1,1,0,"c0fc24e8-31f4-ea11-b882-24ee9a37d45c","I.S. 025 Adrien Block - Q025 - Q025 - 25Q025 - 34-65 192 STREET","befc24e8-31f4-ea11-b882-24ee9a37d45c",-73789365,40764884,"J.H.S. 25 - QUEENS","34-65 192 STREET"
1,1,0,"5b0c1bb1-31f4-ea11-b882-24ee9a37d45c","The High School for Climate Justice - M655 - M645 - 02M655 - 320 EAST 96 STREET","570c1bb1-31f4-ea11-b882-24ee9a37d45c",-73945933,40783286,"OLD MANHATTAN VOC/TECH HS - M","320 EAST 96 STREET"
3,1,2,"539d7c62-33f4-ea11-b882-24ee9a37d45c","Pan American International High School at Monroe - X388 - X420 - 12X388 - 1300 BOYNTON AVENUE","519d7c62-33f4-ea11-b882-24ee9a37d45c",-73878191,40832508,"JAMES MONROE EDUCATIONAL CAMPUS - X","1300 BOYNTON AVENUE"
1,1,0,"5f3cbf01-ebf6-ea11-b883-24ee9a37d459","P.S. X010 - X010 - X101 - 75X010 - 2750 LAFAYETTE AVENUE","4e474313-33f4-ea11-b882-24ee9a37d45c",-73829211,40827080,"I.S. 101 - BRONX","2750 LAFAYETTE AVENUE"
1,1,0,"39de5eb7-30f4-ea11-b882-24ee9a37d45c","P.S. 297 Abraham Stockton - K297 - K297 - 14K297 - 700 PARK AVENUE","38de5eb7-30f4-ea11-b882-24ee9a37d45c",-73948166,40697377,"P.S. 297 - BROOKLYN","700 PARK AVENUE"
1,0,1,"f48052e9-ebf6-ea11-b883-24ee9a37d459","Success Academy Charter School - Bronx 3 - X380 - X039 - 84X380 - 965 LONGWOOD AVENUE","0203cefa-32f4-ea11-b882-24ee9a37d45c",-73897876,40817741,"NEW SCH FOR ARTS AND SCIENCE - X","965 LONGWOOD AVENUE"
1,0,1,"f61aad3c-30f4-ea11-b882-24ee9a37d45c","Success Academy Charter School - Bed Stuy 1 - K367 - K033 - 84K367 - 70 Tompkins Avenue","eb1aad3c-30f4-ea11-b882-24ee9a37d45c",-73947557,40696698,"I.S. 33 - BROOKLYN","70 Tompkins Avenue"
1,1,0,"add810ab-31f4-ea11-b882-24ee9a37d45c","Business Of Sports School - M393 - M625 - 02M393 - 439 WEST 49TH STREET","a9d810ab-31f4-ea11-b882-24ee9a37d45c",-73990318,40763655,"HS OF GRAPHIC COMMUNICATION ARTS-M","439 WEST 49TH STREET"
1,0,1,"37767649-31f4-ea11-b882-24ee9a37d45c","P.S. 138 - M138 - M030 - 75M138 - 144-176 EAST 128 STREET","38767649-31f4-ea11-b882-24ee9a37d45c",-73935461,40805653,"P.S. 30 - MANHATTAN","144-176 EAST 128 STREET"
1,0,1,"d3ed94c3-31f4-ea11-b882-24ee9a37d45c","Young Women's Leadership School - M610 - M895 - 04M610 - 105 East 106th Street","d4ed94c3-31f4-ea11-b882-24ee9a37d45c",-73947171,40792932,"YOUNG WOMEN'S LEADERSHIP HS - M","105 East 106th Street"
2,1,1,"ab0e6e25-32f4-ea11-b882-24ee9a37d45c","P.S. 183 Dr. Richard R. Green - Q183 - Q183 - 27Q183 - 2-45 BEACH 79 STREET","a30e6e25-32f4-ea11-b882-24ee9a37d45c",-73805866,40589220,"P.S. 183 - QUEENS","2-45 BEACH 79 STREET"
1,1,0,"e8c1392a-30f4-ea11-b882-24ee9a37d45c","Explore Charter School - K704 - K002 - 84K704 - 655 Parkside Avenue","dfc1392a-30f4-ea11-b882-24ee9a37d45c",-73951575,40656423,"I.S. 2 - BROOKLYN","655 Parkside Avenue"
3,2,1,"d456635c-33f4-ea11-b882-24ee9a37d45c","Claremont International HS - X564 - X410 - 09X564 - 240 EAST 172 STREET","c856635c-33f4-ea11-b882-24ee9a37d45c",-73911366,40839307,"WILLIAM H. TAFT HS - X","240 EAST 172 STREET"
4,2,2,"ced27c6d-30f4-ea11-b882-24ee9a37d45c","Brooklyn Collaborative Studies - K448 - K142 - 15K448 - 610 HENRY STREET","cfd27c6d-30f4-ea11-b882-24ee9a37d45c",-74002022,40679462,"J.H.S. 142 - BROOKLYN","610 HENRY STREET"
1,0,1,"1c005d7a-31f4-ea11-b882-24ee9a37d45c","Yorkville East Middle School - M177 - M158 - 02M177 - 1458 YORK AVENUE","1d005d7a-31f4-ea11-b882-24ee9a37d45c",-73950745,40770215,"P.S. 158 - MANHATTAN","1458 YORK AVENUE"
1,0,1,"1806003e-32f4-ea11-b882-24ee9a37d45c","Academy for New Americans - Q235 - Q234 - 30Q235 - 30-14 30 STREET","1506003e-32f4-ea11-b882-24ee9a37d45c",-73923044,40766898,"P.S. 234 - QUEENS","30-14 30 STREET"
