"TotalCases","StudentCases","EmployeeCases","nycsr_locationsiteid","nycsr_sitename","nycsr_building.nycsr_buildingid","nycsr_building.nycsr_longitude","nycsr_building.nycsr_latitude","nycsr_building.nycsr_buildingname","nycsr_building.nycsr_address"
5,5,0,"5de61462-31f4-ea11-b882-24ee9a37d45c","J.H.S. 104 Simon Baruch - M104 - M104 - 02M104 - 330 EAST  21 STREET","5ee61462-31f4-ea11-b882-24ee9a37d45c",-73981034,40735879,"I.S. 104 - MANHATTAN","330 EAST  21 STREET"
2,1,1,"e437fba4-31f4-ea11-b882-24ee9a37d45c","Urban Assembly Maker Academy - M282 - M520 - 02M282 - 411 PEARL STREET","e037fba4-31f4-ea11-b882-24ee9a37d45c",-74000851,40711441,"MURRY BERGTRAUM HS (ECF) - M","411 PEARL STREET"
4,2,2,"46b4977a-32f4-ea11-b882-24ee9a37d45c","Aviation Career & Technical Education High School - Q610 - Q610 - 24Q610 - 45-30 36 STREET","44b4977a-32f4-ea11-b882-24ee9a37d45c",-73929577,40743309,"AVIATION HS - Q","45-30 36 STREET"
2,2,0,"c3c88e4f-31f4-ea11-b882-24ee9a37d45c","The Anderson School - M334 - M044 - 03M334 - 100 WEST  77 STREET","bfc88e4f-31f4-ea11-b882-24ee9a37d45c",-73977602,40780536,"I.S. 44 - MANHATTAN","100 WEST  77 STREET"
1,1,0,"572b3eee-30f4-ea11-b882-24ee9a37d45c","Origins High School - K611 - K495 - 22K611 - 3000 AVENUE X","552b3eee-30f4-ea11-b882-24ee9a37d45c",-73936635,40593157,"Frank J. Macchiarola Educational Complex","3000 AVENUE X"
1,1,0,"b7ab074a-33f4-ea11-b882-24ee9a37d45c","P.S./M.S. 194 - X194 - X194 - 11X194 - 2365 WATERBURY AVENUE","b6ab074a-33f4-ea11-b882-24ee9a37d45c",-73846594,40835410,"P.S./I.S. 194 - BRONX","2365 WATERBURY AVENUE"
3,2,1,"cc2ff20c-32f4-ea11-b882-24ee9a37d45c","The James J. Ambrose School - Q115 - Q115 - 26Q115 - 80-51 261 STREET","cd2ff20c-32f4-ea11-b882-24ee9a37d45c",-73709404,40744201,"The James J. Ambrose School","80-51 261 STREET"
1,0,1,"d58a0044-33f4-ea11-b882-24ee9a37d45c","Women's Academy of Excellence - X282 - X174 - 08X282 - 456 WHITE PLAINS ROAD","2a2ed53d-33f4-ea11-b882-24ee9a37d45c",-73856070,40815043,"I.S. 174 - BRONX","456 WHITE PLAINS ROAD"
2,2,0,"7303194f-30f4-ea11-b882-24ee9a37d45c","P.S. 69 Vincent D. Grippo School - K069 - K069 - 20K069 - 6302 9TH AVENUE","7203194f-30f4-ea11-b882-24ee9a37d45c",-74009752,40632392,"P.S. 69 - BROOKLYN","6302 9TH AVENUE"
3,2,1,"8a34aa92-31f4-ea11-b882-24ee9a37d45c","Essex Street Academy - M294 - M445 - 02M294 - 350 GRAND STREET","8834aa92-31f4-ea11-b882-24ee9a37d45c",-73989329,40717329,"SEWARD PARK HS - MANHATTAN","350 GRAND STREET"
1,1,0,"8407e99e-31f4-ea11-b882-24ee9a37d45c","Manhattan / Hunter Science High School - M541 - M490 - 03M541 - 122 AMSTERDAM AVENUE","7c07e99e-31f4-ea11-b882-24ee9a37d45c",-73985608,40774891,"MARTIN LUTHER KING, JR. HS - M","122 AMSTERDAM AVENUE"
1,0,1,"fdd0de79-30f4-ea11-b882-24ee9a37d45c","P.S. 172 Beacon School of Excellence - K172 - K172 - 15K172 - 825 4 AVENUE","fed0de79-30f4-ea11-b882-24ee9a37d45c",-74000191,40657682,"P.S. 172 - BROOKLYN","825 4 AVENUE"
4,4,0,"fe77931f-33f4-ea11-b882-24ee9a37d45c","School of Performing Arts - X217 - X116 - 12X217 - 977 FOX STREET","fd77931f-33f4-ea11-b882-24ee9a37d45c",-73894368,40822056,"I.S. 216 - BRONX","977 FOX STREET"
1,0,1,"3fde5eb7-30f4-ea11-b882-24ee9a37d45c","P.S. 298 Dr. Betty Shabazz - K298 - K298 - 23K298 - 85 WATKINS STREET","3dde5eb7-30f4-ea11-b882-24ee9a37d45c",-73907718,40671015,"P.S. 298 - BROOKLYN","85 WATKINS STREET"
4,3,1,"86e657bd-30f4-ea11-b882-24ee9a37d45c","P.S. 312 Bergen Beach - K312 - K312 - 22K312 - 7103 Avenue T","87e657bd-30f4-ea11-b882-24ee9a37d45c",-73909554,40622442,"P.S. 312 - BROOKLYN","7103 Avenue T"
1,0,1,"10d1de79-30f4-ea11-b882-24ee9a37d45c","P.S. 178 Saint Clair Mckelway - K178 - K178 - 23K178 - 2163 DEAN STREET","0cd1de79-30f4-ea11-b882-24ee9a37d45c",-73915337,40675380,"P.S. 178 - BROOKLYN","2163 DEAN STREET"
5,0,5,"09d1de79-30f4-ea11-b882-24ee9a37d45c","P.S. 176 Ovington - K176 - K176 - 20K176 - 1225 69 STREET","08d1de79-30f4-ea11-b882-24ee9a37d45c",-74005205,40624835,"P.S. 176 - BROOKLYN","1225 69 STREET"
3,0,3,"3c2f7d06-31f4-ea11-b882-24ee9a37d45c","Liberation Diploma Plus - K728 - K728 - 21K728 - 2865 West 19th Street","3b2f7d06-31f4-ea11-b882-24ee9a37d45c",-73985413,40576976,"LIBERATION DIPLOMA PLUS H.S. - K","2865 West 19th Street"
2,2,0,"0c03cefa-32f4-ea11-b882-24ee9a37d45c","P.S. 179 - X179 - X040 - 07X179 - 468 EAST 140 STREET","0b03cefa-32f4-ea11-b882-24ee9a37d45c",-73919773,40809080,"P.S. 220 - BRONX","468 EAST 140 STREET"
3,2,1,"2645378b-4afb-ea11-b883-24ee9a37d459","RIVERDALE NEIGHBORHOOD HOUSE, INC - XAPA - XAPA -  - 5521 MOSHOLU AVENUE","2745378b-4afb-ea11-b883-24ee9a37d459",-73903843,40903491,"RIVERDALE NEIGHBORHOOD HOUSE, INC","5521 MOSHOLU AVENUE"
3,2,1,"d5e0838c-31f4-ea11-b882-24ee9a37d45c","Lower Manhattan Community Middle School - M896 - M282 - 02M896 - 26 BROADWAY","d1e0838c-31f4-ea11-b882-24ee9a37d45c",-74013303,40705688,"BROADWAY EDUCATION CAMPUS - M","26 BROADWAY"
4,3,1,"89977d2b-32f4-ea11-b882-24ee9a37d45c","J.H.S. 194 William Carr - Q194 - Q194 - 25Q194 - 154-60 17 AVENUE","8a977d2b-32f4-ea11-b882-24ee9a37d45c",-73806990,40783231,"J.H.S. 194 - QUEENS","154-60 17 AVENUE"
10,6,4,"60b50aa5-30f4-ea11-b882-24ee9a37d45c","J.H.S. 259 William McKinley - K259 - K259 - 20K259 - 7305 FT HAMILTON PARKWAY","61b50aa5-30f4-ea11-b882-24ee9a37d45c",-74014633,40626089,"I.S. 259 - BROOKLYN","7305 FT HAMILTON PARKWAY"
3,2,1,"668946f4-31f4-ea11-b882-24ee9a37d45c","P.S. 049 Dorothy Bonawit Kole - Q049 - Q049 - 24Q049 - 63-60 80th Street","678946f4-31f4-ea11-b882-24ee9a37d45c",-73875493,40719567,"P.S./I.S. 49 - QUEENS","63-60 80th Street"
1,0,1,"68f4a0ef-eaf6-ea11-b883-24ee9a37d459","P.S. K811 Connie Lekas School - K811 - K286 - 75K811 - 2525 HARING STREET","6e283fb1-30f4-ea11-b882-24ee9a37d45c",-73938610,40591132,"P.S. 811 (OLD P286) - BROOKLYN","2525 HARING STREET"
1,0,1,"76e2635c-32f4-ea11-b882-24ee9a37d45c","P.S. Q256 - Q256 - Q410 - 75Q256 - 100-00 BEACH CHANNEL DRIVE","71e2635c-32f4-ea11-b882-24ee9a37d45c",-73825317,40586012,"Beach Channel Educational Campus","100-00 BEACH CHANNEL DRIVE"
1,1,0,"29005d7a-31f4-ea11-b882-24ee9a37d45c","WHIN Music Community Charter School - M338 - M164 - 84M338 - 401 WEST 164 STREET","2a005d7a-31f4-ea11-b882-24ee9a37d45c",-73937263,40836982,"I.S. 164 - MANHATTAN","401 WEST 164 STREET"
5,1,4,"4f507380-31f4-ea11-b882-24ee9a37d45c","P.S. 180 Hugo Newman - M180 - M180 - 03M180 - 370 WEST 120TH STREET","50507380-31f4-ea11-b882-24ee9a37d45c",-73955861,40807570,"P.S. 180 - MANHATTAN","370 WEST 120TH STREET"
1,1,0,"1e06003e-32f4-ea11-b882-24ee9a37d45c","East-West School of International Studies - Q281 - Q237 - 25Q281 - 46-21 COLDEN STREET","1b06003e-32f4-ea11-b882-24ee9a37d45c",-73821402,40749430,"J.H.S. 237 - QUEENS","46-21 COLDEN STREET"
4,3,1,"d6689025-33f4-ea11-b882-24ee9a37d45c","P.S. 134 George F. Bristow - X134 - X134 - 12X134 - 1330 BRISTOW STREET","d7689025-33f4-ea11-b882-24ee9a37d45c",-73894241,40831613,"P.S. 134 - BRONX","1330 BRISTOW STREET"
6,5,1,"d1d27c6d-30f4-ea11-b882-24ee9a37d45c","The Brooklyn New School, P.S. 146 - K146 - K142 - 15K146 - 610 HENRY STREET","cfd27c6d-30f4-ea11-b882-24ee9a37d45c",-74002022,40679462,"J.H.S. 142 - BROOKLYN","610 HENRY STREET"
1,1,0,"f4201dab-30f4-ea11-b882-24ee9a37d45c","I.S. 281 Joseph B Cavallaro - K281 - K281 - 21K281 - 8787 24 AVENUE","f2201dab-30f4-ea11-b882-24ee9a37d45c",-73993565,40594648,"I.S. 281 - BROOKLYN","8787 24 AVENUE"
6,0,6,"3d3cbf01-ebf6-ea11-b883-24ee9a37d459","John F. Kennedy Jr. School - Q721 - Q722 - 75Q721 - 57-12 94 STREET","b172c880-32f4-ea11-b882-24ee9a37d45c",-73867882,40735613,"JOHN F. KENNEDY JR. SCHOOL - QUEENS","57-12 94 STREET"
1,1,0,"a369c231-32f4-ea11-b882-24ee9a37d45c","Energy Tech High School - Q258 - Q204 - 30Q258 - 36-41 28 STREET","9c69c231-32f4-ea11-b882-24ee9a37d45c",-73932628,40756471,"I.S. 204 - QUEENS","36-41 28 STREET"
4,4,0,"8c886843-31f4-ea11-b882-24ee9a37d45c","P.S. 006 Lillie D. Blake - M006 - M006 - 02M006 - 45 EAST  81 STREET","8d886843-31f4-ea11-b882-24ee9a37d45c",-73960427,40777737,"P.S. 6 - MANHATTAN","45 EAST  81 STREET"
1,1,0,"21b4977a-32f4-ea11-b882-24ee9a37d45c","International High School at LaGuardia Community College - Q530 - Q520 - 24Q530 - 45-35 VAN DAM STREET","22b4977a-32f4-ea11-b882-24ee9a37d45c",-73933316,40743253,"MIDDLE COLLEGE CAMPUS - QUEENS","45-35 VAN DAM STREET"
1,0,1,"e28442ee-31f4-ea11-b882-24ee9a37d45c","P.S. 040 Samuel Huntington - Q040 - Q040 - 28Q040 - 109-20 Union Hall Street","dd8442ee-31f4-ea11-b882-24ee9a37d45c",-73790975,40693559,"P.S. 40 (D28) - QUEENS","109-20 Union Hall Street"
2,2,0,"3a0410ca-32f4-ea11-b882-24ee9a37d45c","P.S. 055 Henry M. Boehm - R055 - R055 - 31R055 - 54 OSBORNE STREET","3b0410ca-32f4-ea11-b882-24ee9a37d45c",-74163037,40536625,"P.S. 55 - STATEN ISLAND","54 OSBORNE STREET"
1,0,1,"0e03cefa-32f4-ea11-b882-24ee9a37d45c","Young Leaders Elementary School - X369 - X040 - 07X369 - 468 EAST 140 STREET","0b03cefa-32f4-ea11-b882-24ee9a37d45c",-73919773,40809080,"P.S. 220 - BRONX","468 EAST 140 STREET"
1,0,1,"0ffc3df4-30f4-ea11-b882-24ee9a37d45c","All City Leadership Secondary School - K554 - K554 - 32K554 - 321 Palmetto Street","10fc3df4-30f4-ea11-b882-24ee9a37d45c",-73913172,40697378,"ALL CITY LEADERSHIP SECONDARY SCHOOL - BROOKLYN","321 Palmetto Street"
1,0,1,"bab36d80-30f4-ea11-b882-24ee9a37d45c","The SEEALL Academy - K180 - K180 - 20K180 - 5601 16 AVENUE","b8b36d80-30f4-ea11-b882-24ee9a37d45c",-73989250,40626454,"P.S. 180 - BROOKLYN","5601 16 AVENUE"
5,5,0,"f31aad3c-30f4-ea11-b882-24ee9a37d45c","P.S. 032 Samuel Mills Sprole - K032 - K032 - 15K032 - 317 Hoyt Street","f41aad3c-30f4-ea11-b882-24ee9a37d45c",-73991141,40680159,"P.S. 32 - BROOKLYN","317 Hoyt Street"
1,1,0,"1768ee1e-31f4-ea11-b882-24ee9a37d45c","EBC High School for Public Service - Bushwick - K545 - K913 - 32K545 - 1155 DEKALB AVENUE","1868ee1e-31f4-ea11-b882-24ee9a37d45c",-73929315,40694723,"EBC HS FOR PUBLIC SERV.-BUSHWICK-K","1155 DEKALB AVENUE"
1,1,0,"b269c231-32f4-ea11-b882-24ee9a37d45c","P.S./I.S. 208 - Q208 - Q208 - 29Q208 - 74-30 COMMONWEALTH BLVD","ab69c231-32f4-ea11-b882-24ee9a37d45c",-73727632,40744276,"P.S./I.S. 208 - QUEENS","74-30 COMMONWEALTH BLVD"
2,1,1,"60fdc1bd-32f4-ea11-b882-24ee9a37d45c","P.S. 019 The Curtis School - R019 - R019 - 31R019 - 780 POST AVENUE","61fdc1bd-32f4-ea11-b882-24ee9a37d45c",-74126851,40630563,"P.S. 19 - STATEN ISLAND","780 POST AVENUE"
5,3,2,"c98442ee-31f4-ea11-b882-24ee9a37d45c","P.S. 032 State Street - Q032 - Q032 - 25Q032 - 171-11 35 AVENUE","ca8442ee-31f4-ea11-b882-24ee9a37d45c",-73794323,40765459,"P.S. 32 - QUEENS","171-11 35 AVENUE"
1,1,0,"a2778cb8-ebf6-ea11-b883-24ee9a37d459","P.S. Q993 - Q993 - Q570 - 75Q993 - 35-12 35TH AVENUE","2eb4977a-32f4-ea11-b882-24ee9a37d45c",-73925182,40756099,"FRANK SINATRA HIGH SCHOOL-Q","35-12 35TH AVENUE"
1,0,1,"9241e65b-31f4-ea11-b882-24ee9a37d45c","Wadleigh Secondary School for the Performing & Visual Arts - M415 - M088 - 03M415 - 215 WEST 114 STREET","8841e65b-31f4-ea11-b882-24ee9a37d45c",-73954152,40802610,"I.S. 88 - MANHATTAN","215 WEST 114 STREET"
1,0,1,"7e8d8486-31f4-ea11-b882-24ee9a37d45c","P.S. 198 Isador E. Ida Straus - M198 - M198 - 02M198 - 1700 3 AVENUE","7f8d8486-31f4-ea11-b882-24ee9a37d45c",-73950420,40785018,"P.S. 198 - MANHATTAN","1700 3 AVENUE"
5,4,1,"eb8442ee-31f4-ea11-b882-24ee9a37d45c","P.S./M.S 042 R. Vernam - Q042 - Q042 - 27Q042 - 488 BEACH  66 STREET","ea8442ee-31f4-ea11-b882-24ee9a37d45c",-73794804,40594358,"P.S. 42 - QUEENS","488 BEACH  66 STREET"
4,3,1,"26767649-31f4-ea11-b882-24ee9a37d45c","P.S. 212 Midtown West - M212 - M017 - 02M212 - 328 WEST  48 STREET","aa886843-31f4-ea11-b882-24ee9a37d45c",-73988665,40761327,"I.S. 17 - MANHATTAN","328 WEST  48 STREET"
3,2,1,"3c9f4974-31f4-ea11-b882-24ee9a37d45c","P.S. 142 Amalia Castro - M142 - M142 - 01M142 - 100 ATTORNEY STREET","379f4974-31f4-ea11-b882-24ee9a37d45c",-73984116,40718121,"P.S. 142 - MANHATTAN","100 ATTORNEY STREET"
1,0,1,"1acf496e-31f4-ea11-b882-24ee9a37d45c","P.S. 134 Henrietta Szold - M134 - M134 - 01M134 - 293 EAST BROADWAY","1bcf496e-31f4-ea11-b882-24ee9a37d45c",-73983854,40714248,"P.S. 134 - MANHATTAN","293 EAST BROADWAY"
1,1,0,"81eb6056-32f4-ea11-b882-24ee9a37d45c","The Woodside Community School - Q361 - Q339 - 30Q361 - 39-07 57th Street","82eb6056-32f4-ea11-b882-24ee9a37d45c",-73906430,40747701,"P.S. 339 - Queens","39-07 57th Street"
1,0,1,"200b210d-33f4-ea11-b882-24ee9a37d45c","P.S. 75 School of Research and Discovery - X075 - X075 - 08X075 - 984 FAILE STREET","1f0b210d-33f4-ea11-b882-24ee9a37d45c",-73888948,40822314,"P.S. 75 - BRONX","984 FAILE STREET"
2,0,2,"2cff3d8d-33f4-ea11-b882-24ee9a37d45c","Health Opportunities High School - X670 - X884 - 07X670 - 350 Gerard Avenue","2dff3d8d-33f4-ea11-b882-24ee9a37d45c",-73929960,40815712,"HEALTH OPPORTUNITIES HS - X","350 Gerard Avenue"
1,0,1,"df8da2a3-4afb-ea11-b883-24ee9a37d459","New Life Child Development Center 2 - KBVB - KBSC -  - 406-408 GROVE STREET","42de261e-4afb-ea11-b883-24ee9a37d459",-73912224,40701464,"New Life Child Development Center 2-3","406-408 GROVE STREET"
5,2,3,"3e02fdd0-ebf6-ea11-b883-24ee9a37d459","The Michael J. Petrides School - R080 - R010 - 31R080 - 715 OCEAN TERRACE","4bfdc1bd-32f4-ea11-b882-24ee9a37d45c",-74105883,40607637,"P.S. 80 (PETRIDES COMPLEX) AF - STATEN ISLAND","715 OCEAN TERRACE"
1,0,1,"fc02cefa-32f4-ea11-b882-24ee9a37d45c","P.S. 035 Franz Siegel - X035 - X035 - 09X035 - 261 EAST 163 STREET","fd02cefa-32f4-ea11-b882-24ee9a37d45c",-73917705,40828009,"P.S. 35 - BRONX","261 EAST 163 STREET"
3,0,3,"069c4c1f-32f4-ea11-b882-24ee9a37d45c","P.S. 164 Queens Valley - Q164 - Q164 - 25Q164 - 138-01 77 AVENUE","ff9b4c1f-32f4-ea11-b882-24ee9a37d45c",-73823569,40721514,"P.S. 164 - QUEENS","138-01 77 AVENUE"
2,2,0,"2eebaa73-30f4-ea11-b882-24ee9a37d45c","P.S. 160 William T. Sampson - K160 - K160 - 20K160 - 5105 Fort Hamilton Parkway","27ebaa73-30f4-ea11-b882-24ee9a37d45c",-73999045,40636932,"P.S. 160 - BROOKLYN","5105 Fort Hamilton Parkway"
5,4,1,"8f0e6e25-32f4-ea11-b882-24ee9a37d45c","P.S. 173 Fresh Meadows - Q173 - Q173 - 26Q173 - 174-10 67 AVENUE","900e6e25-32f4-ea11-b882-24ee9a37d45c",-73795651,40734097,"P.S. 173 - QUEENS","174-10 67 AVENUE"
6,4,2,"5c2f77fa-31f4-ea11-b882-24ee9a37d45c","P.S. 060 Woodhaven - Q060 - Q060 - 27Q060 - 91-02 88 AVENUE","8e8946f4-31f4-ea11-b882-24ee9a37d45c",-73852792,40691467,"P.S. 60 - QUEENS","91-02 88 AVENUE"
1,0,1,"8ba87f90-5a04-ec11-b8b4-24ee9a37d45c","Hunters Point Elementary School - Q384 - Q375 - 30Q384 - 1-35 57 Avenue","8ca87f90-5a04-ec11-b8b4-24ee9a37d45c",-73960836,40738864,"Hunters Point","1-35 57 Avenue"
2,2,0,"8fe657bd-30f4-ea11-b882-24ee9a37d45c","P.S. 503: The School of Discovery - K503 - K314 - 20K503 - 330 59 STREET","8ee657bd-30f4-ea11-b882-24ee9a37d45c",-74019299,40641950,"P.S. 314 - BROOKLYN","330 59 STREET"
1,1,0,"8a41e65b-31f4-ea11-b882-24ee9a37d45c","P.S. 084 Lillian Weber - M084 - M084 - 03M084 - 32 WEST  92 STREET","8b41e65b-31f4-ea11-b882-24ee9a37d45c",-73968419,40789479,"P.S. 84 - MANHATTAN","32 WEST  92 STREET"
1,0,1,"e2e13320-ebf6-ea11-b883-24ee9a37d459","Sid Miller Academy - K396 - K181 - 75K396 - 1023 NEW YORK AVENUE","bdb36d80-30f4-ea11-b882-24ee9a37d45c",-73945883,40648217,"P.S. 181 - BROOKLYN","1023 NEW YORK AVENUE"
2,1,1,"78f4a0ef-eaf6-ea11-b883-24ee9a37d459","Sid Miller Academy - K396 - K396 - 75K396 - 110 CHESTER STREET","2d8dbfcf-30f4-ea11-b882-24ee9a37d45c",-73911788,40668232,"P.S. 396 (TANDEM K327-D23)-K","110 CHESTER STREET"
1,0,1,"2c30f69f-ebf6-ea11-b883-24ee9a37d459","P.S. Q255 - Q255 - Q247 - 75Q255 - 69-10 65th Drive","2ca10a44-32f4-ea11-b882-24ee9a37d45c",-73885974,40715005,"PS/IS 128","69-10 65th Drive"
1,0,1,"1530f69f-ebf6-ea11-b883-24ee9a37d459","P.S. Q993 - Q993 - Q208 - 75Q993 - 74-30 COMMONWEALTH BLVD","ab69c231-32f4-ea11-b882-24ee9a37d45c",-73727632,40744276,"P.S./I.S. 208 - QUEENS","74-30 COMMONWEALTH BLVD"
1,0,1,"d20d3c5b-30f4-ea11-b882-24ee9a37d45c","P.S. 100 The Coney Island School - K100 - K100 - 21K100 - 2951 WEST  3 STREET","ca0d3c5b-30f4-ea11-b882-24ee9a37d45c",-73970830,40577591,"P.S. 100 - BROOKLYN","2951 WEST  3 STREET"
1,0,1,"7dbc9674-32f4-ea11-b882-24ee9a37d45c","Benjamin Franklin High School for Finance & Information Technology - Q313 - Q490 - 29Q313 - 207- 01 116TH  AVENUE","7ebc9674-32f4-ea11-b882-24ee9a37d45c",-73746330,40698786,"CAMPUS MAGNET HS (JACKSON) - Q","207- 01 116TH  AVENUE"
3,2,1,"8453dd74-33f4-ea11-b882-24ee9a37d45c","Bronx Health Sciences High School - X249 - X455 - 11X249 - 750 BAYCHESTER AVENUE","8253dd74-33f4-ea11-b882-24ee9a37d45c",-73831669,40874035,"HARRY S. TRUMAN HS - X","750 BAYCHESTER AVENUE"
1,0,1,"45507380-31f4-ea11-b882-24ee9a37d45c","Muscota - M314 - M176 - 06M314 - 4862 BROADWAY","46507380-31f4-ea11-b882-24ee9a37d45c",-73923818,40866381,"P.S./I.S. 176 - MANHATTAN","4862 BROADWAY"
1,0,1,"b73aa668-33f4-ea11-b882-24ee9a37d45c","Fordham High School for the Arts - X437 - X435 - 10X437 - 500 EAST FORDHAM ROAD","b03aa668-33f4-ea11-b882-24ee9a37d45c",-73888625,40859466,"THEODORE ROOSEVELT EDUCATIONAL CAMPUS - X","500 EAST FORDHAM ROAD"
3,2,1,"7c8d8486-31f4-ea11-b882-24ee9a37d45c","P.S. 197 John B. Russwurm - M197 - M197 - 05M197 - 2230 5 AVENUE","7b8d8486-31f4-ea11-b882-24ee9a37d45c",-73938347,40813532,"P.S. 197 - MANHATTAN","2230 5 AVENUE"
1,1,0,"e4e0838c-31f4-ea11-b882-24ee9a37d45c","Sixth Avenue Elementary School - M340 - M340 - 02M340 - 64 WEST 17 STREET","e3e0838c-31f4-ea11-b882-24ee9a37d45c",-73995534,40739145,"THE SIXTH AVENUE EDUCATIONAL CAMPUS - MANHATTAN","64 WEST 17 STREET"
2,0,2,"71c280bd-31f4-ea11-b882-24ee9a37d45c","Eleanor Roosevelt High School - M416 - M855 - 02M416 - 411 EAST 76 STREET","72c280bd-31f4-ea11-b882-24ee9a37d45c",-73953276,40770288,"ELEANOR ROOSEVELT HS - MANHATTAN","411 EAST 76 STREET"
1,0,1,"460b210d-33f4-ea11-b882-24ee9a37d45c","Academy for Language and Technology - X365 - X082 - 09X365 - 1700 MACOMBS ROAD","3f0b210d-33f4-ea11-b882-24ee9a37d45c",-73915217,40849416,"I.S. 232 - BRONX","1700 MACOMBS ROAD"
4,2,2,"d479df48-30f4-ea11-b882-24ee9a37d45c","Community Roots Charter School - K536 - K067 - 84K536 - 51 SAINT EDWARDS STREET","d179df48-30f4-ea11-b882-24ee9a37d45c",-73977674,40695339,"P.S. 67 - BROOKLYN","51 SAINT EDWARDS STREET"
1,0,1,"1ee2abc9-30f4-ea11-b882-24ee9a37d45c","J.H.S. 383 Philippa Schuyler - K383 - K383 - 32K383 - 1300 GREENE AVENUE","1de2abc9-30f4-ea11-b882-24ee9a37d45c",-73919088,40697898,"I.S. 383 - BROOKLYN","1300 GREENE AVENUE"
1,1,0,"370410ca-32f4-ea11-b882-24ee9a37d45c","P.S. 054 Charles W. Leng - R054 - R054 - 31R054 - 1060 WILLOWBROOK ROAD","380410ca-32f4-ea11-b882-24ee9a37d45c",-74137259,40602779,"P.S. 54 - STATEN ISLAND","1060 WILLOWBROOK ROAD"
1,1,0,"e9e0a4fb-ebf6-ea11-b883-24ee9a37d459","P.S. X721 - Stephen McSweeney School - X721 - X368 - 75X721 - 2975 TIBBETT AVENUE","74e03d56-33f4-ea11-b882-24ee9a37d45c",-73913694,40877935,"M.S./H.S. 368 - BRONX","2975 TIBBETT AVENUE"
1,0,1,"df8fd20d-ebf6-ea11-b883-24ee9a37d459","P.S. K140 - K140 - K026 - 75K140 - 1014 LAFAYETTE AVENUE","f2968d36-30f4-ea11-b882-24ee9a37d45c",-73931700,40692100,"P.S. 26 - BROOKLYN","1014 LAFAYETTE AVENUE"
2,0,2,"553cbf01-ebf6-ea11-b883-24ee9a37d459","The David Marquis School of the Arts - R037 - R840 - 75R037 - 15 Fairfield Street","81be7adc-32f4-ea11-b882-24ee9a37d45c",-74151368,40564100,"P.S. 37 ( OLD I24X)-STATEN ISLAND","15 Fairfield Street"
1,0,1,"c2fc24e8-31f4-ea11-b882-24ee9a37d45c","World Journalism Preparatory: A College Board School - Q285 - Q025 - 25Q285 - 34-65 192 STREET","befc24e8-31f4-ea11-b882-24ee9a37d45c",-73789365,40764884,"J.H.S. 25 - QUEENS","34-65 192 STREET"
5,5,0,"d4f57030-30f4-ea11-b882-24ee9a37d45c","The Emily Warren Roebling School - K008 - K008 - 13K008 - 37 HICKS STREET","d5f57030-30f4-ea11-b882-24ee9a37d45c",-73992841,40700709,"P.S. 8 - BROOKLYN","37 HICKS STREET"
4,4,0,"e60d3c5b-30f4-ea11-b882-24ee9a37d45c","P.S. 107 John W. Kimball - K107 - K107 - 15K107 - 1301 8 AVENUE","e70d3c5b-30f4-ea11-b882-24ee9a37d45c",-73981181,40662945,"P.S. 107 - BROOKLYN","1301 8 AVENUE"
1,0,1,"e237fba4-31f4-ea11-b882-24ee9a37d45c","The Urban Assembly School for Emergency Management - M135 - M520 - 02M135 - 411 PEARL STREET","e037fba4-31f4-ea11-b882-24ee9a37d45c",-74000851,40711441,"MURRY BERGTRAUM HS (ECF) - M","411 PEARL STREET"
4,2,2,"7e34aa92-31f4-ea11-b882-24ee9a37d45c","Quest to Learn - M422 - M440 - 02M422 - 351 WEST  18 STREET","7834aa92-31f4-ea11-b882-24ee9a37d45c",-74002540,40743407,"BAYARD RUSTIN EDUCATIONAL COMP-M","351 WEST  18 STREET"
1,0,1,"58de5eb7-30f4-ea11-b882-24ee9a37d45c","Achievement First Aspire Charter School - K680 - K306 - 84K680 - 970 VERMONT STREET","59de5eb7-30f4-ea11-b882-24ee9a37d45c",-73886620,40655340,"P.S. 306 - BROOKLYN","970 VERMONT STREET"
5,1,4,"35ebaa73-30f4-ea11-b882-24ee9a37d45c","P.S. 164 Caesar Rodney - K164 - K164 - 20K164 - 4211 14 AVENUE","36ebaa73-30f4-ea11-b882-24ee9a37d45c",-73985739,40637101,"P.S. 164 - BROOKLYN","4211 14 AVENUE"
2,2,0,"ad9c11e8-30f4-ea11-b882-24ee9a37d45c","High School for Public Service: Heroes of Tomorrow - K546 - K470 - 17K546 - 600 KINGSTON AVENUE","aa9c11e8-30f4-ea11-b882-24ee9a37d45c",-73943839,40658671,"GEORGE W. WINGATE HS - K","600 KINGSTON AVENUE"
1,1,0,"2f275a30-4afb-ea11-b883-24ee9a37d459","Magic Years Daycare Center corp. - QBEG - QBEG -  - 90-20 55th Avenue","30275a30-4afb-ea11-b883-24ee9a37d459",-73872609,40736843,"Magic Years Daycare Center Corp.","90-20 55th Avenue"
1,1,0,"b7fc24e8-31f4-ea11-b882-24ee9a37d45c","Queens Academy High School - Q540 - Q023 - 25Q540 - 138-11 35 AVENUE","b8fc24e8-31f4-ea11-b882-24ee9a37d45c",-73828279,40765624,"QUEENS ACADEMY HS - QUEENS","138-11 35 AVENUE"
3,1,2,"d60d3c5b-30f4-ea11-b882-24ee9a37d45c","P.S. 101 The Verrazano - K101 - K101 - 21K101 - 8696 24 Avenue","d70d3c5b-30f4-ea11-b882-24ee9a37d45c",-73991962,40597379,"P.S. 101 - BROOKLYN","8696 24 Avenue"
1,1,0,"80eb0e7b-33f4-ea11-b882-24ee9a37d45c","Icahn Charter School 2 - X378 - X498 - 84X378 - 1640 BRONXDALE AVE","7eeb0e7b-33f4-ea11-b882-24ee9a37d45c",-73857989,40845023,"THE LT. CURTIS MEYRAN AND JOHN BELLEW ED COMPLEX","1640 BRONXDALE AVE"
3,0,3,"692f77fa-31f4-ea11-b882-24ee9a37d45c","P.S. 063 Old South - Q063 - Q063 - 27Q063 - 90-15 SUTTER AVENUE","6a2f77fa-31f4-ea11-b882-24ee9a37d45c",-73846796,40676978,"P.S. 63 - QUEENS","90-15 SUTTER AVENUE"
1,0,1,"37a6ba98-31f4-ea11-b882-24ee9a37d45c","Innovation Diploma Plus - M404 - M470 - 03M404 - 145 WEST  84 STREET","33a6ba98-31f4-ea11-b882-24ee9a37d45c",-73974483,40786134,"LOUIS D. BRANDEIS HS - MANHATTAN","145 WEST  84 STREET"
1,1,0,"a7778cb8-ebf6-ea11-b883-24ee9a37d459","The Ezra Jack Keats Pre-K Center - Q335 - Q608 - 28Q335 - 83-30 KEW GARDENS ROAD","3fb4977a-32f4-ea11-b882-24ee9a37d45c",-73830193,40713425,"PRE-K CENTER @KEW GARDENS ROAD - QUEENS","83-30 KEW GARDENS ROAD"
1,0,1,"56f92a2a-4afb-ea11-b883-24ee9a37d459","CHILDREN'S BIG APPLE, INC. - QASX - QASX -  - 41-26 CASE STREET","57f92a2a-4afb-ea11-b883-24ee9a37d459",-73873674,40746683,"CHILDREN'S BIG APPLE, INC.","41-26 CASE STREET"
1,1,0,"26025a42-4afb-ea11-b883-24ee9a37d459","CHILDREN'S BIG APPLE, INC. - QASW - QASW -  - 37-03 94TH STREET","27025a42-4afb-ea11-b883-24ee9a37d459",-73872822,40750698,"CHILDREN'S BIG APPLE, INC.","37-03 94TH STREET"
2,1,1,"d72db265-f6fe-eb11-b8b3-24ee9a37d45c","DIKI'S DAY CARE CENTER, INC.-STEINWAY STREET - QBLC - QBLC -  - 30-81 STEINWAY STREET","d82db265-f6fe-eb11-b8b3-24ee9a37d45c",-73916499,40762041,"DIKI'S DAYCARE CENTER, INC.","30-81 STEINWAY STREET"
4,4,0,"399f4974-31f4-ea11-b882-24ee9a37d45c","P.S. 140 Nathan Straus - M140 - M140 - 01M140 - 123 RIDGE STREET","3a9f4974-31f4-ea11-b882-24ee9a37d45c",-73983769,40719148,"P.S. 140 - MANHATTAN","123 RIDGE STREET"
1,0,1,"b332c3fb-eaf6-ea11-b883-24ee9a37d459","Mosaic Pre-K Center - Q331 - Q392 - 24Q331 - 68-20 Myrtle Avenue","a2eb6056-32f4-ea11-b882-24ee9a37d45c",-73883878,40701694,"PRE-K CENTER @ 68-20 MYRTLE AVENUE - QUEENS","68-20 Myrtle Avenue"
1,1,0,"1c6e3d68-31f4-ea11-b882-24ee9a37d45c","P.S. 116 Mary Lindley Murray - M116 - M116 - 02M116 - 210 East  33 Street","1d6e3d68-31f4-ea11-b882-24ee9a37d45c",-73977906,40744511,"P.S. 116 - MANHATTAN","210 East  33 Street"
3,0,3,"307c21b7-32f4-ea11-b882-24ee9a37d45c","I.S. R002 George L. Egbert - R002 - R002 - 31R002 - 333 Midland Avenue","2b7c21b7-32f4-ea11-b882-24ee9a37d45c",-74099685,40576728,"I.S. 2 - STATEN ISLAND","333 Midland Avenue"
1,0,1,"0ea198c3-30f4-ea11-b882-24ee9a37d45c","P.S. 328 Phyllis Wheatley - K328 - K328 - 19K328 - 330 ALABAMA AVENUE","0ca198c3-30f4-ea11-b882-24ee9a37d45c",-73898249,40667985,"P.S. 328 - BROOKLYN","330 ALABAMA AVENUE"
5,3,2,"8734aa92-31f4-ea11-b882-24ee9a37d45c","Urban Assembly Academy of Government and Law, The - M305 - M445 - 02M305 - 350 GRAND STREET","8834aa92-31f4-ea11-b882-24ee9a37d45c",-73989329,40717329,"SEWARD PARK HS - MANHATTAN","350 GRAND STREET"
1,1,0,"0fa6ba98-31f4-ea11-b882-24ee9a37d45c","University Neighborhood High School - M448 - M446 - 01M448 - 200 Monroe Street","10a6ba98-31f4-ea11-b882-24ee9a37d45c",-73984128,40712269,"UNIVERSITY NEIGHBORHOOD - M","200 Monroe Street"
2,2,0,"5c275a30-4afb-ea11-b883-24ee9a37d459","OUR SAVIOUR'S LUTHERAN PRESCHOOL - KBPU - KBPU -  - 414-420 80TH STREET","5d275a30-4afb-ea11-b883-24ee9a37d459",-74026215,40626746,"OUR SAVIOUR'S LUTHERAN PRESCHOOL","414-420 80TH STREET"
1,1,0,"107eed06-32f4-ea11-b882-24ee9a37d45c","P.S. Q086 - Q086 - Q086 - 28Q086 - 87-41 PARSONS BOULEVARD","117eed06-32f4-ea11-b882-24ee9a37d45c",-73803001,40709461,"P.S. 86 - QUEENS","87-41 PARSONS BOULEVARD"
1,1,0,"35767649-31f4-ea11-b882-24ee9a37d45c","Lower East Side Preparatory High School - M515 - M025 - 01M515 - 145 STANTON STREET","29767649-31f4-ea11-b882-24ee9a37d45c",-73986038,40720040,"J.H.S. 25 - MANHATTAN","145 STANTON STREET"
1,1,0,"a472c880-32f4-ea11-b882-24ee9a37d45c","Metropolitan Expeditionary Learning School - Q167 - Q686 - 28Q167 - 91-30 METROPOLITAN AVENUE","a372c880-32f4-ea11-b882-24ee9a37d45c",-73855543,40708431,"METROPOLITAN AVENUE CAMPUS - QUEENS","91-30 METROPOLITAN AVENUE"
1,1,0,"cfc88e4f-31f4-ea11-b882-24ee9a37d45c","47 The American Sign Language and English Secondary School - M047 - M047 - 02M047 - 223 EAST 23 STREET","d0c88e4f-31f4-ea11-b882-24ee9a37d45c",-73981329,40738374,"J.H.S. 47 (SCH FOR THE DEAF) - M","223 EAST 23 STREET"
1,1,0,"f6f57030-30f4-ea11-b882-24ee9a37d45c","P.S. 015 Patrick F. Daly - K015 - K015 - 15K015 - 71 SULLIVAN STREET","f5f57030-30f4-ea11-b882-24ee9a37d45c",-74011864,40677085,"P.S. 15 - BROOKLYN","71 SULLIVAN STREET"
1,1,0,"920e6e25-32f4-ea11-b882-24ee9a37d45c","P.S. 174 William Sidney Mount - Q174 - Q174 - 28Q174 - 65-10 DIETERLE CRESCENT","930e6e25-32f4-ea11-b882-24ee9a37d45c",-73861462,40720583,"P.S. 174 - QUEENS","65-10 DIETERLE CRESCENT"
2,2,0,"950e6e25-32f4-ea11-b882-24ee9a37d45c","P.S. 175 The Lynn Gross Discovery School - Q175 - Q175 - 28Q175 - 64-35 102 STREET","960e6e25-32f4-ea11-b882-24ee9a37d45c",-73852210,40731016,"P.S. 175 - QUEENS","64-35 102 STREET"
3,2,1,"4788e6db-30f4-ea11-b882-24ee9a37d45c","M.S. 839 - K839 - K437 - 15K839 - 713 CATON AVENUE","4488e6db-30f4-ea11-b882-24ee9a37d45c",-73973363,40647598,"P.S./I.S. 437 - BROOKLYN","713 CATON AVENUE"
2,2,0,"e0e0838c-31f4-ea11-b882-24ee9a37d45c","P.S. 051 Elias Howe - M051 - M338 - 02M051 - 525 WEST 44TH STREET","dfe0838c-31f4-ea11-b882-24ee9a37d45c",-73995825,40761487,"P.S. 51 ELIAS HOWE - MANHATTAN","525 WEST 44TH STREET"
2,2,0,"75d92255-30f4-ea11-b882-24ee9a37d45c","J.H.S. 088 Peter Rouget - K088 - K088 - 15K088 - 544 7TH AVENUE","76d92255-30f4-ea11-b882-24ee9a37d45c",-73988743,40660805,"I.S. 88 - BROOKLYN","544 7TH AVENUE"
2,1,1,"4c7becf3-49fb-ea11-b883-24ee9a37d459","BROOKLYN FREE SPACE - KBMN - KBMN -  - 298 SIXTH AVENUE","4d7becf3-49fb-ea11-b883-24ee9a37d459",-73980800,40672201,"BROOKLYN FREE SPACE","298 SIXTH AVENUE"
3,3,0,"06b7c337-32f4-ea11-b882-24ee9a37d45c","J.H.S. 217 Robert A. Van Wyck - Q217 - Q217 - 28Q217 - 85-05 144 STREET","fcb6c337-32f4-ea11-b882-24ee9a37d45c",-73811461,40710384,"I.S. 217 - QUEENS","85-05 144 STREET"
3,3,0,"cd315367-30f4-ea11-b882-24ee9a37d45c","P.S. 127 Mckinley Park - K127 - K127 - 20K127 - 7805 7 Avenue","ce315367-30f4-ea11-b882-24ee9a37d45c",-74018429,40623687,"P.S. 127 - BROOKLYN","7805 7 Avenue"
1,1,0,"d3315367-30f4-ea11-b882-24ee9a37d45c","P.S. 130 The Parkside - K130 - K130 - 15K130 - 70 Ocean Parkway","cc315367-30f4-ea11-b882-24ee9a37d45c",-73976053,40648924,"P.S. 130 - BROOKLYN","70 Ocean Parkway"
1,1,0,"d8315367-30f4-ea11-b882-24ee9a37d45c","P.S. 131 Brooklyn - K131 - K131 - 15K131 - 4305 FT HAMILTON PARKWAY","d9315367-30f4-ea11-b882-24ee9a37d45c",-73993247,40640728,"P.S. 131 - BROOKLYN","4305 FT HAMILTON PARKWAY"
1,1,0,"c3e0838c-31f4-ea11-b882-24ee9a37d45c","P.S./I.S. 217 Roosevelt Island - M217 - M271 - 02M217 - 645 MAIN STREET","b8e0838c-31f4-ea11-b882-24ee9a37d45c",-73956435,40753598,"P.S./I.S. 217 - MANHATTAN","645 MAIN STREET"
1,1,0,"d9454b50-32f4-ea11-b882-24ee9a37d45c","The Queens School for Leadership and Excellence - Q349 - Q314 - 28Q349 - 88-08 164TH STREET","d5454b50-32f4-ea11-b882-24ee9a37d45c",-73797981,40708698,"P.S./ I.S. 314 - Queens","88-08 164TH STREET"
1,1,0,"db454b50-32f4-ea11-b882-24ee9a37d45c","M.S. 358 - Q358 - Q314 - 28Q358 - 88-08 164TH STREET","d5454b50-32f4-ea11-b882-24ee9a37d45c",-73797981,40708698,"P.S./ I.S. 314 - Queens","88-08 164TH STREET"
1,1,0,"54ebaa73-30f4-ea11-b882-24ee9a37d45c","P.S. 169 Sunset Park - K169 - K169 - 15K169 - 4305 7 AVENUE","55ebaa73-30f4-ea11-b882-24ee9a37d45c",-74001700,40645825,"P.S. 169 - BROOKLYN","4305 7 AVENUE"
1,1,0,"a672c880-32f4-ea11-b882-24ee9a37d45c","Queens Metropolitan High School - Q686 - Q686 - 28Q686 - 91-30 METROPOLITAN AVENUE","a372c880-32f4-ea11-b882-24ee9a37d45c",-73855543,40708431,"METROPOLITAN AVENUE CAMPUS - QUEENS","91-30 METROPOLITAN AVENUE"
1,1,0,"da8442ee-31f4-ea11-b882-24ee9a37d45c","Cynthia Jenkins School - Q037 - Q037 - 29Q037 - 179-37 137 Avenue","d58442ee-31f4-ea11-b882-24ee9a37d45c",-73758778,40676201,"P.S. 37 - QUEENS","179-37 137 Avenue"
2,2,0,"77c280bd-31f4-ea11-b882-24ee9a37d45c","The Clinton School - M260 - M868 - 02M260 - 10 East 15th Street","78c280bd-31f4-ea11-b882-24ee9a37d45c",-73992727,40736526,"THE CLINTON SCHOOL - MANHATTAN","10 East 15th Street"
2,2,0,"ced27c6d-30f4-ea11-b882-24ee9a37d45c","Brooklyn Collaborative Studies - K448 - K142 - 15K448 - 610 HENRY STREET","cfd27c6d-30f4-ea11-b882-24ee9a37d45c",-74002022,40679462,"J.H.S. 142 - BROOKLYN","610 HENRY STREET"
1,1,0,"6f8946f4-31f4-ea11-b882-24ee9a37d45c","P.S. 052 Queens - Q052 - Q052 - 29Q052 - 178-37 146 TERRACE","708946f4-31f4-ea11-b882-24ee9a37d45c",-73767161,40661427,"P.S. 52 - QUEENS","178-37 146 TERRACE"
1,1,0,"d4c88e4f-31f4-ea11-b882-24ee9a37d45c","The 47 American Sign Language & English Lower School - M347 - M047 - 02M347 - 223 EAST 23 STREET","d0c88e4f-31f4-ea11-b882-24ee9a37d45c",-73981329,40738374,"J.H.S. 47 (SCH FOR THE DEAF) - M","223 EAST 23 STREET"
1,1,0,"2a7eed06-32f4-ea11-b882-24ee9a37d45c","P.S. 095 Eastwood - Q095 - Q095 - 29Q095 - 179-01 90 AVENUE","2b7eed06-32f4-ea11-b882-24ee9a37d45c",-73783283,40711295,"P.S. 95 - QUEENS","179-01 90 AVENUE"
1,1,0,"15a6ba98-31f4-ea11-b882-24ee9a37d45c","Gramercy Arts High School - M374 - M460 - 02M374 - 40 IRVING PLACE","16a6ba98-31f4-ea11-b882-24ee9a37d45c",-73987064,40735361,"WASHINGTON IRVING HS - MANHATTAN","40 IRVING PLACE"
1,1,0,"ffb98b86-30f4-ea11-b882-24ee9a37d45c","P.S. 200 Benson School - K200 - K200 - 20K200 - 1940 BENSON AVENUE","00ba8b86-30f4-ea11-b882-24ee9a37d45c",-74001915,40602809,"P.S. 200 - BROOKLYN","1940 BENSON AVENUE"
1,1,0,"17af0313-32f4-ea11-b882-24ee9a37d45c","P.S. 134 Hollis - Q134 - Q134 - 29Q134 - 203-02 109 Avenue","10af0313-32f4-ea11-b882-24ee9a37d45c",-73754747,40707535,"P.S. 134 - QUEENS","203-02 109 Avenue"
1,1,0,"26af0313-32f4-ea11-b882-24ee9a37d45c","P.S./M.S. 138 Sunrise - Q138 - Q138 - 29Q138 - 251-11 WELLER AVENUE","1aaf0313-32f4-ea11-b882-24ee9a37d45c",-73734342,40659876,"P.S. 138 - QUEENS","251-11 WELLER AVENUE"
4,4,0,"2306003e-32f4-ea11-b882-24ee9a37d45c","I.S. 238 - Susan B. Anthony Academy - Q238 - Q238 - 29Q238 - 88-15 182 Street","2106003e-32f4-ea11-b882-24ee9a37d45c",-73779653,40712743,"I.S. 238 - QUEENS","88-15 182 Street"
3,3,0,"02ba8b86-30f4-ea11-b882-24ee9a37d45c","J.H.S. 201 The Dyker Heights - K201 - K201 - 20K201 - 8010 12 AVENUE","03ba8b86-30f4-ea11-b882-24ee9a37d45c",-74013749,40619043,"I.S. 201 - BROOKLYN","8010 12 AVENUE"
4,3,1,"c0fc24e8-31f4-ea11-b882-24ee9a37d45c","I.S. 025 Adrien Block - Q025 - Q025 - 25Q025 - 34-65 192 STREET","befc24e8-31f4-ea11-b882-24ee9a37d45c",-73789365,40764884,"J.H.S. 25 - QUEENS","34-65 192 STREET"
2,2,0,"bae0838c-31f4-ea11-b882-24ee9a37d45c","P.S. 234 Independence School - M234 - M234 - 02M234 - 292 GREENWICH STREET","bbe0838c-31f4-ea11-b882-24ee9a37d45c",-74010880,40719530,"P.S. 234 - MANHATTAN","292 GREENWICH STREET"
1,1,0,"e59b4c1f-32f4-ea11-b882-24ee9a37d45c","Queens United Middle School - Q289 - Q156 - 29Q289 - 229-02 137 AVENUE","e69b4c1f-32f4-ea11-b882-24ee9a37d45c",-73743327,40672259,"P.S. 156 - QUEENS","229-02 137 AVENUE"
1,1,0,"aefab455-31f4-ea11-b882-24ee9a37d45c","Orchard Collegiate Academy - M292 - M056 - 01M292 - 220 HENRY STREET","affab455-31f4-ea11-b882-24ee9a37d45c",-73986051,40713362,"J.H.S. 56 - MANHATTAN","220 HENRY STREET"
4,3,1,"6a5bc58c-30f4-ea11-b882-24ee9a37d45c","J.H.S. 220 John J. Pershing - K220 - K220 - 20K220 - 4812 9TH AVENUE","695bc58c-30f4-ea11-b882-24ee9a37d45c",-74001250,40640997,"I.S. 220 - BROOKLYN","4812 9TH AVENUE"
2,2,0,"347c21b7-32f4-ea11-b882-24ee9a37d45c","P.S. 003 The Margaret Gioiosa School - R003 - R003 - 31R003 - 80 SOUTH GOFF AVENUE","357c21b7-32f4-ea11-b882-24ee9a37d45c",-74211850,40520812,"P.S. 3 - STATEN ISLAND","80 SOUTH GOFF AVENUE"
1,1,0,"417c21b7-32f4-ea11-b882-24ee9a37d45c","P.S. 6 Corporal Allan F. Kivlehan School - R006 - R006 - 31R006 - 555 PAGE AVENUE","3c7c21b7-32f4-ea11-b882-24ee9a37d45c",-74230118,40510207,"P.S. 6 - STATEN ISLAND","555 PAGE AVENUE"
1,0,1,"3b0d6d19-33f4-ea11-b882-24ee9a37d45c","P.S. 106 Parkchester - X106 - X106 - 11X106 - 1514 OLMSTEAD AVENUE","3c0d6d19-33f4-ea11-b882-24ee9a37d45c",-73854823,40836974,"P.S. 106 - BRONX","1514 OLMSTEAD AVENUE"
4,4,0,"ed21d292-30f4-ea11-b882-24ee9a37d45c","J.H.S. 227 Edward B. Shallow - K227 - K227 - 20K227 - 6500 16 AVENUE","ee21d292-30f4-ea11-b882-24ee9a37d45c",-73995961,40622102,"I.S. 227 - BROOKLYN","6500 16 AVENUE"
1,0,1,"b6fab455-31f4-ea11-b882-24ee9a37d45c","University Neighborhood Middle School - M332 - M056 - 01M332 - 220 HENRY STREET","affab455-31f4-ea11-b882-24ee9a37d45c",-73986051,40713362,"J.H.S. 56 - MANHATTAN","220 HENRY STREET"
2,2,0,"6ca9d9c3-32f4-ea11-b882-24ee9a37d45c","I.S. 024 Myra S. Barnes - R024 - R024 - 31R024 - 750 DURANT AVENUE","5bfdc1bd-32f4-ea11-b882-24ee9a37d45c",-74145558,40545490,"I.S. 24 - STATEN ISLAND","750 DURANT AVENUE"
3,3,0,"88a9d9c3-32f4-ea11-b882-24ee9a37d45c","I.S. 034 Tottenville - R034 - R034 - 31R034 - 528 ACADEMY AVENUE","87a9d9c3-32f4-ea11-b882-24ee9a37d45c",-74243400,40508300,"I.S. 34 (OLD TOTTENVILLE) - S.I","528 ACADEMY AVENUE"
3,3,0,"5707e99e-31f4-ea11-b882-24ee9a37d45c","Institute for Collaborative Education - M407 - M475 - 02M407 - 345 East  15th Street","5607e99e-31f4-ea11-b882-24ee9a37d45c",-73982590,40732665,"HEALTH PROFESSIONS HS (OL STY) - M","345 East  15th Street"
1,1,0,"0baf0313-32f4-ea11-b882-24ee9a37d45c","P.S. 130 - Q130 - Q130 - 25Q130 - 200-01 42 AVENUE","04af0313-32f4-ea11-b882-24ee9a37d45c",-73784009,40760219,"P.S. 130 - QUEENS","200-01 42 AVENUE"
2,1,1,"0a9c4c1f-32f4-ea11-b882-24ee9a37d45c","P.S. 165 Edith K. Bergtraum - Q165 - Q165 - 25Q165 - 70-35 150 STREET","0b9c4c1f-32f4-ea11-b882-24ee9a37d45c",-73816966,40729746,"P.S. 165 - QUEENS","70-35 150 STREET"
1,1,0,"98a9d9c3-32f4-ea11-b882-24ee9a37d45c","P.S. 39 Francis J. Murphy Jr. - R039 - R039 - 31R039 - 99 Macfarland Avenue","99a9d9c3-32f4-ea11-b882-24ee9a37d45c",-74070610,40597824,"P.S. 39 - STATEN ISLAND","99 Macfarland Avenue"
3,2,1,"83e657bd-30f4-ea11-b882-24ee9a37d45c","The School For Future Leaders - K310 - K310 - 20K310 - 942 62ND STREET","84e657bd-30f4-ea11-b882-24ee9a37d45c",-74007533,40632143,"PS 310 THE SCHOOL FOR FUTURE LEADERS - BROOKLYN","942 62ND STREET"
2,2,0,"1b0410ca-32f4-ea11-b882-24ee9a37d45c","P.S. 044 Thomas C. Brown - R044 - R044 - 31R044 - 80 MAPLE PARKWAY","1c0410ca-32f4-ea11-b882-24ee9a37d45c",-74157303,40631689,"P.S. 44 - STATEN ISLAND","80 MAPLE PARKWAY"
6,3,3,"512b3eee-30f4-ea11-b882-24ee9a37d45c","Fort Hamilton High School - K490 - K490 - 20K490 - 8301 SHORE ROAD","522b3eee-30f4-ea11-b882-24ee9a37d45c",-74038103,40626827,"FORT HAMILTON HS - K","8301 SHORE ROAD"
1,1,0,"1e0410ca-32f4-ea11-b882-24ee9a37d45c","P.S. 045 John Tyler - R045 - R045 - 31R045 - 58 LAWRENCE AVENUE","1f0410ca-32f4-ea11-b882-24ee9a37d45c",-74107537,40628419,"P.S. 45 - STATEN ISLAND","58 LAWRENCE AVENUE"
1,1,0,"2e0410ca-32f4-ea11-b882-24ee9a37d45c","I.S. 051 Edwin Markham - R051 - R051 - 31R051 - 80 WILLOWBROOK ROAD","2f0410ca-32f4-ea11-b882-24ee9a37d45c",-74145522,40623077,"I.S. 51 - STATEN ISLAND","80 WILLOWBROOK ROAD"
1,0,1,"10b7c337-32f4-ea11-b882-24ee9a37d45c","P.S. 221 The North Hills School - Q221 - Q221 - 26Q221 - 57-40 MARATHON PARKWAY","11b7c337-32f4-ea11-b882-24ee9a37d45c",-73731518,40758808,"P.S. 221 - QUEENS","57-40 MARATHON PARKWAY"
1,0,1,"9669c231-32f4-ea11-b882-24ee9a37d45c","P.S. 201 The Discovery School for Inquiry and Research - Q201 - Q201 - 25Q201 - 65-11 155 STREET","9769c231-32f4-ea11-b882-24ee9a37d45c",-73813011,40736541,"P.S. 201 - QUEENS","65-11 155 STREET"
2,2,0,"ca8521d0-32f4-ea11-b882-24ee9a37d45c","P.S. 060 Alice Austen - R060 - R060 - 31R060 - 55 Merrill Avenue","cb8521d0-32f4-ea11-b882-24ee9a37d45c",-74162634,40610604,"P.S. 60 - STATEN ISLAND","55 Merrill Avenue"
3,3,0,"d38521d0-32f4-ea11-b882-24ee9a37d45c","The Kathleen Grimm School for Leadership and Sustainability - R062 - R062 - 31R062 - 644 Bloomingdale Road","d48521d0-32f4-ea11-b882-24ee9a37d45c",-74217934,40541563,"K.GRIMM SCL FOR LDRSHP&SUSTAINABLTY@SANDY GR -S.I.","644 Bloomingdale Road"
1,1,0,"96d91731-31f4-ea11-b882-24ee9a37d45c","Brooklyn Urban Garden Charter School - K758 - KBNU - 84K758 - 500 19 Street","97d91731-31f4-ea11-b882-24ee9a37d45c",-73982624,40656202,"STANLEY LAMM INSTITUE PRE-SCHOOL OF LONGISLAND HO","500 19 Street"
4,4,0,"515bc58c-30f4-ea11-b882-24ee9a37d45c","P.S. 215 Morris H. Weiss - K215 - K215 - 21K215 - 415 AVENUE S","505bc58c-30f4-ea11-b882-24ee9a37d45c",-73970171,40602722,"P.S. 215 - BROOKLYN","415 AVENUE S"
4,4,0,"82be7adc-32f4-ea11-b882-24ee9a37d45c","P.S. 65 The Academy of Innovative Learning - R065 - R829 - 31R065 - 98 GRANT STREET","83be7adc-32f4-ea11-b882-24ee9a37d45c",-74078337,40633666,"ARTHUR D. PHILLIPS SCHOOL - S.I.","98 GRANT STREET"
1,1,0,"ea21d292-30f4-ea11-b882-24ee9a37d45c","P.S. 226 Alfred De B. Mason - K226 - K226 - 21K226 - 6006 23 AVENUE","eb21d292-30f4-ea11-b882-24ee9a37d45c",-73977099,40615405,"P.S. 226 - BROOKLYN","6006 23 AVENUE"
1,1,0,"5907e99e-31f4-ea11-b882-24ee9a37d45c","High School for Health Professions and Human Services - M420 - M475 - 02M420 - 345 East  15th Street","5607e99e-31f4-ea11-b882-24ee9a37d45c",-73982590,40732665,"HEALTH PROFESSIONS HS (OL STY) - M","345 East  15th Street"
3,3,0,"e68521d0-32f4-ea11-b882-24ee9a37d45c","I.S. 075 Frank D. Paulo - R075 - R075 - 31R075 - 455 HUGUENOT AVENUE","e28521d0-32f4-ea11-b882-24ee9a37d45c",-74197033,40544535,"I.S. 75 - STATEN ISLAND","455 HUGUENOT AVENUE"
1,1,0,"d0ed94c3-31f4-ea11-b882-24ee9a37d45c","Leadership and Public Service High School - M425 - M894 - 02M425 - 90 TRINITY PLACE","d1ed94c3-31f4-ea11-b882-24ee9a37d45c",-74012465,40708971,"HS FOR LEADERSHIP & PUBLIC SER - M","90 TRINITY PLACE"
1,1,0,"6707e99e-31f4-ea11-b882-24ee9a37d45c","Talent Unlimited High School - M519 - M480 - 02M519 - 317 EAST  67 STREET","6007e99e-31f4-ea11-b882-24ee9a37d45c",-73959777,40765638,"JULIA RICHMAN ED. COMPLEX - M","317 EAST  67 STREET"
1,1,0,"555b4cd6-32f4-ea11-b882-24ee9a37d45c","Port Richmond High School - R445 - R445 - 31R445 - 85 ST JOSEPHS AVENUE","515b4cd6-32f4-ea11-b882-24ee9a37d45c",-74141924,40635562,"PORT RICHMOND HS - S. I.","85 ST JOSEPHS AVENUE"
1,1,0,"90c280bd-31f4-ea11-b882-24ee9a37d45c","Harvest Collegiate High School - M534 - M883 - 02M534 - 34 WEST  14 STREET","8fc280bd-31f4-ea11-b882-24ee9a37d45c",-73995731,40736416,"LEGACY HS FOR INTEGR. STUDIES - M","34 WEST  14 STREET"
1,1,0,"a183ff9e-30f4-ea11-b882-24ee9a37d45c","P.S. 253 - K253 - K253 - 21K253 - 601 OCEANVIEW AVENUE","a283ff9e-30f4-ea11-b882-24ee9a37d45c",-73961962,40580237,"P.S. 253 - BROOKLYN","601 OCEANVIEW AVENUE"
1,0,1,"20a6ba98-31f4-ea11-b882-24ee9a37d45c","Academy for Software Engineering - M546 - M460 - 02M546 - 40 IRVING PLACE","16a6ba98-31f4-ea11-b882-24ee9a37d45c",-73987064,40735361,"WASHINGTON IRVING HS - MANHATTAN","40 IRVING PLACE"
1,1,0,"6c41e65b-31f4-ea11-b882-24ee9a37d45c","The Lexington Academy - M072 - M072 - 04M072 - 131 EAST 104 STREET","6d41e65b-31f4-ea11-b882-24ee9a37d45c",-73947450,40791444,"P.S. 72 - MANHATTAN","131 EAST 104 STREET"
1,1,0,"9083ff9e-30f4-ea11-b882-24ee9a37d45c","P.S. 249 The Caton - K249 - K249 - 17K249 - 18 MARLBOROUGH ROAD","9183ff9e-30f4-ea11-b882-24ee9a37d45c",-73966456,40649509,"P.S. 249 - BROOKLYN","18 MARLBOROUGH ROAD"
9,9,0,"29b7c337-32f4-ea11-b882-24ee9a37d45c","I.S. 227 Louis Armstrong - Q227 - Q227 - 30Q227 - 32-02 JUNCTION BOULEVARD","27b7c337-32f4-ea11-b882-24ee9a37d45c",-73874614,40757567,"I.S. 227 - QUEENS","32-02 JUNCTION BOULEVARD"
1,1,0,"4febaa73-30f4-ea11-b882-24ee9a37d45c","New Bridges Elementary - K532 - K167 - 17K532 - 1025 EASTERN PARKWAY","4cebaa73-30f4-ea11-b882-24ee9a37d45c",-73934316,40669557,"P.S. 167 - BROOKLYN","1025 EASTERN PARKWAY"
1,1,0,"d1f57030-30f4-ea11-b882-24ee9a37d45c","P.S. 007 Abraham Lincoln - K007 - K007 - 19K007 - 858 JAMAICA AVENUE","fcc1392a-30f4-ea11-b882-24ee9a37d45c",-73872983,40689213,"P.S. 7 - BROOKLYN","858 JAMAICA AVENUE"
3,3,0,"66e2635c-32f4-ea11-b882-24ee9a37d45c","Hunters Point Community Middle School - Q291 - Q404 - 30Q291 - 1-50 51ST AVENUE","65e2635c-32f4-ea11-b882-24ee9a37d45c",-73959183,40742964,"HUNTERS POINT CAMPUS - QUEENS","1-50 51ST AVENUE"
1,1,0,"f8d0de79-30f4-ea11-b882-24ee9a37d45c","Highland Park Community School - K760 - K171 - 19K760 - 528 RIDGEWOOD AVENUE","53ebaa73-30f4-ea11-b882-24ee9a37d45c",-73869434,40685852,"I.S. 171 - BROOKLYN","528 RIDGEWOOD AVENUE"
3,3,0,"01f32ce2-31f4-ea11-b882-24ee9a37d45c","P.S. 012 James B. Colgate - Q012 - Q012 - 24Q012 - 42-00 72 STREET","02f32ce2-31f4-ea11-b882-24ee9a37d45c",-73893466,40742284,"P.S. 12 - QUEENS","42-00 72 STREET"
1,1,0,"68e2635c-32f4-ea11-b882-24ee9a37d45c","Academy for Careers in Television and Film - Q301 - Q404 - 30Q301 - 1-50 51ST AVENUE","65e2635c-32f4-ea11-b882-24ee9a37d45c",-73959183,40742964,"HUNTERS POINT CAMPUS - QUEENS","1-50 51ST AVENUE"
2,2,0,"f1454b50-32f4-ea11-b882-24ee9a37d45c","East Elmhurst Community School - Q329 - Q329 - 30Q329 - 26-25 97th Street","f0454b50-32f4-ea11-b882-24ee9a37d45c",-73872244,40761573,"EAST ELMHURST COMMUNITY SCHOOL - QUEENS","26-25 97th Street"
1,0,1,"309f4974-31f4-ea11-b882-24ee9a37d45c","Eagle Academy for Young Men of Harlem - M148 - M136 - 05M148 - 6 EDGECOMBE AVENUE","15cf496e-31f4-ea11-b882-24ee9a37d45c",-73947151,40817228,"I.S. 136 - MANHATTAN","6 EDGECOMBE AVENUE"
3,3,0,"41005d7a-31f4-ea11-b882-24ee9a37d45c","P.S. 171 Patrick Henry - M171 - M171 - 04M171 - 19 EAST 103 STREET","42005d7a-31f4-ea11-b882-24ee9a37d45c",-73951425,40792302,"P.S. 171 - MANHATTAN","19 EAST 103 STREET"
4,4,0,"10ba8b86-30f4-ea11-b882-24ee9a37d45c","P.S. 205 Clarion - K205 - K205 - 20K205 - 6701 20 AVENUE","11ba8b86-30f4-ea11-b882-24ee9a37d45c",-73986792,40614737,"P.S. 205 - BROOKLYN","6701 20 AVENUE"
2,2,0,"07f32ce2-31f4-ea11-b882-24ee9a37d45c","P.S. 014 Fairview - Q014 - Q014 - 24Q014 - 107-01 OTIS AVENUE","faf22ce2-31f4-ea11-b882-24ee9a37d45c",-73854570,40741020,"P.S. 14 - QUEENS","107-01 OTIS AVENUE"
1,1,0,"ed2d6c32-ebf6-ea11-b883-24ee9a37d459","P.S. K053 - K053 - K384 - 75K053 - 242 COOPER STREET","21e2abc9-30f4-ea11-b882-24ee9a37d45c",-73904695,40689883,"P.S. 384 - BROOKLYN","242 COOPER STREET"
2,1,1,"4e2b3eee-30f4-ea11-b882-24ee9a37d45c","The Christa McAuliffe School\I.S. 187 - K187 - K486 - 20K187 - 1171 65 STREET","4f2b3eee-30f4-ea11-b882-24ee9a37d45c",-74003883,40627929,"I.S. 187 - BROOKLYN","1171 65 STREET"
3,3,0,"c50d3c5b-30f4-ea11-b882-24ee9a37d45c","I.S. 096 Seth Low - K096 - K096 - 21K096 - 99 AVENUE P","c10d3c5b-30f4-ea11-b882-24ee9a37d45c",-73984985,40608135,"I.S. 96 - BROOKLYN","99 AVENUE P"
1,1,0,"822f77fa-31f4-ea11-b882-24ee9a37d45c","P.S. 071 Forest - Q071 - Q071 - 24Q071 - 62-85 FOREST AVENUE","802f77fa-31f4-ea11-b882-24ee9a37d45c",-73904798,40711388,"P.S. 71 - QUEENS","62-85 FOREST AVENUE"
1,1,0,"4bde5eb7-30f4-ea11-b882-24ee9a37d45c","Rachel Carson High School for Coastal Studies - K344 - K303 - 21K344 - 521 WEST AVENUE","4cde5eb7-30f4-ea11-b882-24ee9a37d45c",-73972009,40582518,"I.S. 303 - BROOKLYN","521 WEST AVENUE"
2,1,1,"ff02cefa-32f4-ea11-b882-24ee9a37d45c","P.S. 036 Unionport - X036 - X036 - 08X036 - 1070 Castle Hill Avenue","0c18b7f4-32f4-ea11-b882-24ee9a37d45c",-73849791,40829480,"P.S. 36 - BRONX","1070 Castle Hill Avenue"
1,0,1,"cbe8ce00-32f4-ea11-b882-24ee9a37d45c","I.S. 73 - The Frank Sansivieri Intermediate School - Q073 - Q073 - 24Q073 - 70-02 54 AVENUE","cce8ce00-32f4-ea11-b882-24ee9a37d45c",-73893318,40728558,"I.S. 73 - QUEENS","70-02 54 AVENUE"
1,1,0,"70977d2b-32f4-ea11-b882-24ee9a37d45c","J.H.S. 189 Daniel Carter Beard - Q189 - Q189 - 25Q189 - 144-80 BARCLAY AVENUE","6b977d2b-32f4-ea11-b882-24ee9a37d45c",-73818399,40759963,"J.H.S. 189 - QUEENS","144-80 BARCLAY AVENUE"
1,0,1,"a5edf392-32f4-ea11-b882-24ee9a37d45c","Joseph F. Quinn Intermediate School 77 - Q077 - Q849 - 24Q077 - 976 Seneca Avenue","a4edf392-32f4-ea11-b882-24ee9a37d45c",-73902147,40699101,"I.S. 77 - QUEENS","976 Seneca Avenue"
4,4,0,"1c06003e-32f4-ea11-b882-24ee9a37d45c","I.S. 237 - Q237 - Q237 - 25Q237 - 46-21 COLDEN STREET","1b06003e-32f4-ea11-b882-24ee9a37d45c",-73821402,40749430,"J.H.S. 237 - QUEENS","46-21 COLDEN STREET"
1,1,0,"d82ff20c-32f4-ea11-b882-24ee9a37d45c","P.S./I.S. 119 The Glendale - Q119 - Q119 - 24Q119 - 74-01 78 AVENUE","d92ff20c-32f4-ea11-b882-24ee9a37d45c",-73875073,40705187,"I.S. 119 - QUEENS","74-01 78 AVENUE"
3,2,1,"2da10a44-32f4-ea11-b882-24ee9a37d45c","P.S. 128 The Lorraine Tuzzo, Juniper Valley Elementary School - Q128 - Q247 - 24Q128 - 69-10 65th Drive","2ca10a44-32f4-ea11-b882-24ee9a37d45c",-73885974,40715005,"PS/IS 128","69-10 65th Drive"
2,1,1,"3e0d6d19-33f4-ea11-b882-24ee9a37d45c","P.S. 107 - X107 - X107 - 08X107 - 1695 SEWARD AVENUE","340d6d19-33f4-ea11-b882-24ee9a37d45c",-73868735,40819221,"P.S. 107 - BRONX","1695 SEWARD AVENUE"
1,1,0,"d9883319-32f4-ea11-b882-24ee9a37d45c","P.S. 143 Louis Armstrong - Q143 - Q143 - 24Q143 - 34-74 113 Street","d7883319-32f4-ea11-b882-24ee9a37d45c",-73855715,40755393,"P.S. 143 - QUEENS","34-74 113 Street"
3,3,0,"16a198c3-30f4-ea11-b882-24ee9a37d45c","P.S./I.S. 30 Mary White Ovington - K030 - K331 - 20K030 - 7002 4TH AVENUE","15a198c3-30f4-ea11-b882-24ee9a37d45c",-74023950,40633598,"P.S./I.S.30 MARY WHITE OVINGTON - BROOKLYN","7002 4TH AVENUE"
2,2,0,"e09b4c1f-32f4-ea11-b882-24ee9a37d45c","P.S. 153 Maspeth Elem - Q153 - Q153 - 24Q153 - 60-02 60 LANE","e19b4c1f-32f4-ea11-b882-24ee9a37d45c",-73904463,40716296,"P.S. 153 - QUEENS","60-02 60 LANE"
1,1,0,"d78a0044-33f4-ea11-b882-24ee9a37d45c","Archimedes Academy for Math, Science and Technology Applications - X367 - X174 - 08X367 - 456 WHITE PLAINS ROAD","2a2ed53d-33f4-ea11-b882-24ee9a37d45c",-73856070,40815043,"I.S. 174 - BRONX","456 WHITE PLAINS ROAD"
1,1,0,"e7f22ce2-31f4-ea11-b882-24ee9a37d45c","I.S. 5 - The Walter Crowley Intermediate School - Q005 - Q005 - 24Q005 - 50-40 JACOBUS STREET","9adc32dc-31f4-ea11-b882-24ee9a37d45c",-73888133,40737405,"I.S. 5 - QUEENS","50-40 JACOBUS STREET"
1,1,0,"26c73b4a-32f4-ea11-b882-24ee9a37d45c","A.C.E. Academy for Scholars at the Geraldine Ferraro Campus - Q290 - Q290 - 24Q290 - 55-20 METROPOLITAN AVENUE","24c73b4a-32f4-ea11-b882-24ee9a37d45c",-73908307,40713030,"THE GERALDINE FERRARO CAMPUS - QUEENS","55-20 METROPOLITAN AVENUE"
3,3,0,"07fc3df4-30f4-ea11-b882-24ee9a37d45c","John Dewey High School - K540 - K540 - 21K540 - 50 AVENUE X","05fc3df4-30f4-ea11-b882-24ee9a37d45c",-73981925,40588070,"JOHN DEWEY HS - K","50 AVENUE X"
1,1,0,"75bc9674-32f4-ea11-b882-24ee9a37d45c","Grover Cleveland High School - Q485 - Q485 - 24Q485 - 21-27 HIMROD STREET","74bc9674-32f4-ea11-b882-24ee9a37d45c",-73909202,40711881,"GROVER CLEVELAND HS - Q","21-27 HIMROD STREET"
1,1,0,"b2689025-33f4-ea11-b882-24ee9a37d45c","Blueprint Middle School - X562 - X125 - 08X562 - 1111 Pugsley Avenue","af689025-33f4-ea11-b882-24ee9a37d45c",-73857882,40829153,"I.S. 125 - BRONX","1111 Pugsley Avenue"
1,0,1,"e92ece86-32f4-ea11-b882-24ee9a37d45c","VOYAGES Preparatory - Q744 - Q744 - 24Q744 - 45-10 94th Street","e22ece86-32f4-ea11-b882-24ee9a37d45c",-73871505,40743228,"ELMHURST EDUCATIONAL CAMPUS - Q","45-10 94th Street"
1,1,0,"d8e8ce00-32f4-ea11-b882-24ee9a37d45c","P.S. 079 Francis Lewis - Q079 - Q079 - 25Q079 - 147-27 15 DRIVE","d7e8ce00-32f4-ea11-b882-24ee9a37d45c",-73817338,40786201,"P.S. 79 - QUEENS","147-27 15 DRIVE"
1,1,0,"86977d2b-32f4-ea11-b882-24ee9a37d45c","P.S. 193 Alfred J. Kennedy - Q193 - Q193 - 25Q193 - 152-20 11 AVENUE","87977d2b-32f4-ea11-b882-24ee9a37d45c",-73808987,40792053,"P.S. 193 - QUEENS","152-20 11 AVENUE"
1,1,0,"ef77bb9f-33f4-ea11-b882-24ee9a37d45c","East Bronx Academy for the Future - X271 - X973 - 12X271 - 1716 SOUTHERN BOULEVARD","ed77bb9f-33f4-ea11-b882-24ee9a37d45c",-73887688,40836821,"M.S./H.S. 270 - BRONX","1716 SOUTHERN BOULEVARD"
1,1,0,"2b0d6d19-33f4-ea11-b882-24ee9a37d45c","Archer Elementary School - X531 - X102 - 12X531 - 1827 ARCHER STREET","290d6d19-33f4-ea11-b882-24ee9a37d45c",-73866038,40838151,"P.S. 102 - BRONX","1827 ARCHER STREET"
1,0,1,"2b23f4ed-49fb-ea11-b883-24ee9a37d459","Athena Scholars 815 - KCUF - KCUF -  - 815 54 STREET","2c23f4ed-49fb-ea11-b883-24ee9a37d459",-74005416,40638774,"Athena Scholars 815","815 54 STREET"
2,1,1,"7e0e6e25-32f4-ea11-b882-24ee9a37d45c","Queens School of Inquiry, The - Q252 - Q168 - 25Q252 - 158-40 76 ROAD","099c4c1f-32f4-ea11-b882-24ee9a37d45c",-73809380,40724195,"J.H.S. 168 - QUEENS","158-40 76 ROAD"
1,1,0,"e4ba3c50-33f4-ea11-b882-24ee9a37d45c","P.S. 583 - X583 - X317 - 08X583 - 1028 WHITE PLAINS ROAD","e5ba3c50-33f4-ea11-b882-24ee9a37d45c",-73859622,40826949,"P.S. 317 - BRONX","1028 WHITE PLAINS ROAD"
1,1,0,"1aeabc42-30f4-ea11-b882-24ee9a37d45c","The Williamsburg High School of Art and Technology - K454 - K049 - 14K454 - 223 GRAHAM AVENUE","14eabc42-30f4-ea11-b882-24ee9a37d45c",-73944463,40709765,"I.S. 49 - BROOKLYN","223 GRAHAM AVENUE"
1,0,1,"b9b66262-32f4-ea11-b882-24ee9a37d45c","John Bowne High School - Q425 - Q425 - 25Q425 - 63-25 MAIN STREET","bab66262-32f4-ea11-b882-24ee9a37d45c",-73823841,40737448,"JOHN BOWNE HS - QUEENS","63-25 MAIN STREET"
1,1,0,"31005d7a-31f4-ea11-b882-24ee9a37d45c","P.S. 165 Robert E. Simon - M165 - M165 - 03M165 - 234 West 109 Street","2f005d7a-31f4-ea11-b882-24ee9a37d45c",-73965949,40802653,"P.S. 165 - MANHATTAN","234 West 109 Street"
1,1,0,"92dc32dc-31f4-ea11-b882-24ee9a37d45c","P.S. 002 Alfred Zimberg - Q002 - Q002 - 30Q002 - 75-10 21 Avenue","93dc32dc-31f4-ea11-b882-24ee9a37d45c",-73894108,40769798,"P.S. 2 - QUEENS","75-10 21 Avenue"
1,1,0,"f2ae0313-32f4-ea11-b882-24ee9a37d45c","P.S. 122 Mamie Fay - Q122 - Q122 - 30Q122 - 21-21 DITMARS BOULEVARD","cb2ff20c-32f4-ea11-b882-24ee9a37d45c",-73915785,40780507,"P.S. 122 - QUEENS","21-21 DITMARS BOULEVARD"
3,3,0,"f0883319-32f4-ea11-b882-24ee9a37d45c","P.S. 148 Queens - Q148 - Q148 - 30Q148 - 89-02 32 AVENUE","ef883319-32f4-ea11-b882-24ee9a37d45c",-73878638,40757629,"P.S. 148 - QUEENS","89-02 32 AVENUE"
3,2,1,"35005d7a-31f4-ea11-b882-24ee9a37d45c","P.S. 166 The Richard Rodgers School of The Arts and Technology - M166 - M166 - 03M166 - 132 WEST  89 STREET","36005d7a-31f4-ea11-b882-24ee9a37d45c",-73972557,40788925,"P.S. 166 - MANHATTAN","132 WEST  89 STREET"
1,1,0,"bd69c231-32f4-ea11-b882-24ee9a37d45c","P.S. 212 - Q212 - Q212 - 30Q212 - 34-25 82 STREET","b969c231-32f4-ea11-b882-24ee9a37d45c",-73884458,40753035,"P.S. 212 - QUEENS","34-25 82 STREET"
2,1,1,"a5dab801-ecf6-ea11-b883-24ee9a37d459","Rose Hill Pre-K Center - X535 - X432 - 10X535 - 2490-2500 WEBSTER AVENUE","ae3aa668-33f4-ea11-b882-24ee9a37d45c",-73891838,40860601,"PRE-K CENTER @WEBSTER AVENUE - BRONX","2490-2500 WEBSTER AVENUE"
1,1,0,"e78442ee-31f4-ea11-b882-24ee9a37d45c","P.S. 041 Crocheron - Q041 - Q041 - 26Q041 - 214-43 35 AVENUE","e58442ee-31f4-ea11-b882-24ee9a37d45c",-73771225,40770155,"P.S. 41 - QUEENS","214-43 35 AVENUE"
1,1,0,"2e005d7a-31f4-ea11-b882-24ee9a37d45c","Mott Hall II - M862 - M165 - 03M862 - 234 West 109 Street","2f005d7a-31f4-ea11-b882-24ee9a37d45c",-73965949,40802653,"P.S. 165 - MANHATTAN","234 West 109 Street"
3,3,0,"cdc88e4f-31f4-ea11-b882-24ee9a37d45c","P.S. 046 Arthur Tappan - M046 - M046 - 05M046 - 2987 FREDERICK DOUGLASS BOULEVARD","ccc88e4f-31f4-ea11-b882-24ee9a37d45c",-73936300,40830400,"P.S. 46 - MANHATTAN","2987 FREDERICK DOUGLASS BOULEVARD"
2,1,1,"722f77fa-31f4-ea11-b882-24ee9a37d45c","J.H.S. 067 Louis Pasteur - Q067 - Q067 - 26Q067 - 51-60 MARATHON PARKWAY","732f77fa-31f4-ea11-b882-24ee9a37d45c",-73734832,40762241,"J.H.S. 67 - QUEENS","51-60 MARATHON PARKWAY"
1,1,0,"c837fba4-31f4-ea11-b882-24ee9a37d45c","Park East High School - M495 - M495 - 04M495 - 230 EAST 105 STREET","c737fba4-31f4-ea11-b882-24ee9a37d45c",-73944092,40790191,"PARK EAST HS - MANHATTAN","230 EAST 105 STREET"
1,1,0,"f29b4c1f-32f4-ea11-b882-24ee9a37d45c","M.S. 158 Marie Curie - Q158 - Q158 - 26Q158 - 46-35 Oceania Street","f39b4c1f-32f4-ea11-b882-24ee9a37d45c",-73771878,40756562,"J.H.S. 158 - QUEENS","46-35 Oceania Street"
1,1,0,"9d69c231-32f4-ea11-b882-24ee9a37d45c","P.S. 203 Oakland Gardens - Q203 - Q203 - 26Q203 - 53-11 SPRINGFIELD BOULEVARD","9e69c231-32f4-ea11-b882-24ee9a37d45c",-73759822,40753606,"P.S. 203 - QUEENS","53-11 SPRINGFIELD BOULEVARD"
1,1,0,"888d8486-31f4-ea11-b882-24ee9a37d45c","P.S. 200- The James McCune Smith School - M200 - M200 - 05M200 - 2589 7 AVENUE","848d8486-31f4-ea11-b882-24ee9a37d45c",-73935746,40823988,"P.S. 200 (TANDEM M010) - MANHATTAN","2589 7 AVENUE"
1,1,0,"ecce496e-31f4-ea11-b882-24ee9a37d45c","Columbia Secondary School - M362 - M125 - 05M362 - 425 WEST 123 STREET","edce496e-31f4-ea11-b882-24ee9a37d45c",-73955722,40810793,"P.S. 125 - MANHATTAN","425 WEST 123 STREET"
3,3,0,"03b7c337-32f4-ea11-b882-24ee9a37d45c","J.H.S. 216 George J. Ryan - Q216 - Q216 - 26Q216 - 64-20 175 Street","04b7c337-32f4-ea11-b882-24ee9a37d45c",-73794501,40737188,"J.H.S. 216 - QUEENS","64-20 175 Street"
1,1,0,"410d6d19-33f4-ea11-b882-24ee9a37d45c","Mott Hall III - X128 - X110 - 09X128 - 580 CROTONA PARK SOUTH","420d6d19-33f4-ea11-b882-24ee9a37d45c",-73900654,40834470,"P.S. 110 - BRONX","580 CROTONA PARK SOUTH"
1,0,1,"30b4977a-32f4-ea11-b882-24ee9a37d45c","Frank Sinatra School of the Arts High School - Q501 - Q570 - 30Q501 - 35-12 35TH AVENUE","2eb4977a-32f4-ea11-b882-24ee9a37d45c",-73925182,40756099,"FRANK SINATRA HIGH SCHOOL-Q","35-12 35TH AVENUE"
1,0,1,"daab074a-33f4-ea11-b882-24ee9a37d45c","P.S./I.S. 218 Rafael Hernandez Dual Language Magnet School - X218 - X235 - 09X218 - 1220 GERARD AVENUE","d8ab074a-33f4-ea11-b882-24ee9a37d45c",-73919571,40835681,"P.S./I.S. 218 - BRONX","1220 GERARD AVENUE"
1,1,0,"59be7adc-32f4-ea11-b882-24ee9a37d45c","Susan E. Wagner High School - R460 - R460 - 31R460 - 1200 MANOR ROAD","5abe7adc-32f4-ea11-b882-24ee9a37d45c",-74130819,40588985,"SUSAN E. WAGNER HS - S. I.","1200 MANOR ROAD"
2,2,0,"d3d10307-33f4-ea11-b882-24ee9a37d45c","Lucero Elementary School - X311 - X064 - 09X311 - 1425 WALTON AVENUE","d4d10307-33f4-ea11-b882-24ee9a37d45c",-73915879,40840400,"P.S. 64 - BRONX","1425 WALTON AVENUE"
1,1,0,"d6d27c6d-30f4-ea11-b882-24ee9a37d45c","P.S. 145 Andrew Jackson - K145 - K145 - 32K145 - 100 NOLL STREET","d7d27c6d-30f4-ea11-b882-24ee9a37d45c",-73932388,40701107,"P.S. 145 - BROOKLYN","100 NOLL STREET"
2,1,1,"9d48b1f5-eaf6-ea11-b883-24ee9a37d459","P.S. K077 - K077 - K902 - 75K077 - 62 PARK PLACE","2604d718-31f4-ea11-b882-24ee9a37d45c",-73976648,40678809,"P.S. 77 ANNEX - BROOKLYN","62 PARK PLACE"
3,3,0,"7836d900-33f4-ea11-b882-24ee9a37d45c","P.S. 059 The Community School of Technology - X059 - X059 - 10X059 - 2185 BATHGATE AVENUE","7936d900-33f4-ea11-b882-24ee9a37d45c",-73893639,40853141,"P.S. 59 - BRONX","2185 BATHGATE AVENUE"
1,1,0,"6c2f77fa-31f4-ea11-b882-24ee9a37d45c","P.S. 064 Joseph P. Addabbo - Q064 - Q064 - 27Q064 - 82-01 101 AVENUE","6d2f77fa-31f4-ea11-b882-24ee9a37d45c",-73856956,40681901,"P.S. 64 - QUEENS","82-01 101 AVENUE"
2,1,1,"410b210d-33f4-ea11-b882-24ee9a37d45c","P.S. 081 Robert J. Christen - X081 - X081 - 10X081 - 5550 RIVERDALE AVENUE","420b210d-33f4-ea11-b882-24ee9a37d45c",-73904657,40903275,"P.S. 81 - BRONX","5550 RIVERDALE AVENUE"
1,1,0,"0c78931f-33f4-ea11-b882-24ee9a37d45c","J.H.S. 118 William W. Niles - X118 - X118 - 10X118 - 577 EAST 179 STREET","0b78931f-33f4-ea11-b882-24ee9a37d45c",-73892482,40848702,"I.S. 118 - BRONX","577 EAST 179 STREET"
1,0,1,"37767649-31f4-ea11-b882-24ee9a37d45c","P.S. 138 - M138 - M030 - 75M138 - 144-176 EAST 128 STREET","38767649-31f4-ea11-b882-24ee9a37d45c",-73935461,40805653,"P.S. 30 - MANHATTAN","144-176 EAST 128 STREET"
1,1,0,"6f2f77fa-31f4-ea11-b882-24ee9a37d45c","P.S. 066 Jacqueline Kennedy Onassis - Q066 - Q066 - 27Q066 - 85-11 102 Street","702f77fa-31f4-ea11-b882-24ee9a37d45c",-73846135,40697941,"P.S. 66 - QUEENS","85-11 102 Street"
1,1,0,"c1ab074a-33f4-ea11-b882-24ee9a37d45c","P.S. 205 Fiorello LaGuardia - X205 - X205 - 10X205 - 2475 Southern Boulevard","c2ab074a-33f4-ea11-b882-24ee9a37d45c",-73881753,40855759,"P.S. 205A (ECF) - BRONX","2475 Southern Boulevard"
1,1,0,"b13aa668-33f4-ea11-b882-24ee9a37d45c","West Bronx Academy for the Future - X243 - X435 - 10X243 - 500 EAST FORDHAM ROAD","b03aa668-33f4-ea11-b882-24ee9a37d45c",-73888625,40859466,"THEODORE ROOSEVELT EDUCATIONAL CAMPUS - X","500 EAST FORDHAM ROAD"
1,0,1,"9f32c3fb-eaf6-ea11-b883-24ee9a37d459","Robert E. Peary School - Q075 - Q075 - 75Q075 - 16-66 HANCOCK STREET","cae8ce00-32f4-ea11-b882-24ee9a37d45c",-73904888,40698699,"P.S. 75 (R PERRY SCHOOL)-QUEENS","16-66 HANCOCK STREET"
1,1,0,"76e03d56-33f4-ea11-b882-24ee9a37d45c","In-Tech Academy (M.S. / High School 368) - X368 - X368 - 10X368 - 2975 TIBBETT AVENUE","74e03d56-33f4-ea11-b882-24ee9a37d45c",-73913694,40877935,"M.S./H.S. 368 - BRONX","2975 TIBBETT AVENUE"
1,1,0,"b53aa668-33f4-ea11-b882-24ee9a37d45c","Belmont Preparatory High School - X434 - X435 - 10X434 - 500 EAST FORDHAM ROAD","b03aa668-33f4-ea11-b882-24ee9a37d45c",-73888625,40859466,"THEODORE ROOSEVELT EDUCATIONAL CAMPUS - X","500 EAST FORDHAM ROAD"
2,2,0,"4b0b210d-33f4-ea11-b882-24ee9a37d45c","P.S. 083 Donald Hertz - X083 - X083 - 11X083 - 950 RHINELANDER AVENUE","4c0b210d-33f4-ea11-b882-24ee9a37d45c",-73858769,40849176,"P.S. 83 - BRONX","950 RHINELANDER AVENUE"
1,1,0,"a532c3fb-eaf6-ea11-b883-24ee9a37d459","P.S. Q255 - Q255 - Q168 - 75Q255 - 158-40 76 ROAD","099c4c1f-32f4-ea11-b882-24ee9a37d45c",-73809380,40724195,"J.H.S. 168 - QUEENS","158-40 76 ROAD"
2,0,2,"c9689025-33f4-ea11-b882-24ee9a37d45c","J.H.S. 131 Albert Einstein - X131 - X131 - 08X131 - 885 Bolton Avenue","c8689025-33f4-ea11-b882-24ee9a37d45c",-73859998,40822925,"I.S. 131 - BRONX","885 Bolton Avenue"
1,1,0,"ba8a894e-4afb-ea11-b883-24ee9a37d459","SI YMCA NURSERY - SOUTH - RAGG - RAGG -  - 3939 RICHMOND AVENUE","bb8a894e-4afb-ea11-b883-24ee9a37d459",-74162666,40542316,"SI YMCA NURSERY - SOUTH","3939 RICHMOND AVENUE"
1,1,0,"ec9319d7-ebf6-ea11-b883-24ee9a37d459","South Richmond High School I.S./P.S. 25 - R025 - R445 - 75R025 - 85 ST JOSEPHS AVENUE","515b4cd6-32f4-ea11-b882-24ee9a37d45c",-74141924,40635562,"PORT RICHMOND HS - S. I.","85 ST JOSEPHS AVENUE"
1,1,0,"307eed06-32f4-ea11-b882-24ee9a37d45c","P.S. 097 Forest Park - Q097 - Q097 - 27Q097 - 85-52 85 STREET","317eed06-32f4-ea11-b882-24ee9a37d45c",-73860031,40694232,"P.S. 97 - QUEENS","85-52 85 STREET"
1,1,0,"d59319d7-ebf6-ea11-b883-24ee9a37d459","P.S. R373 - R373 - R058 - 75R373 - 77 MARSH AVENUE","2a0410ca-32f4-ea11-b882-24ee9a37d45c",-74160867,40582791,"P.S. 58 - STATEN ISLAND","77 MARSH AVENUE"
1,0,1,"e622f4ed-49fb-ea11-b883-24ee9a37d459","Strong Place for Hope Day Care Center/DBA Strong Place for Hope Day Care - KBFN - KBIY -  - 333 2 STREET","e722f4ed-49fb-ea11-b883-24ee9a37d459",-73983488,40673996,"ALONZO A. DAUGHTRY MEMORIAL DAY CARE CENTER SITE 2","333 2 STREET"
1,1,0,"4f0d6d19-33f4-ea11-b882-24ee9a37d45c","P.S. 111 Seton Falls - X111 - X111 - 11X111 - 3740 BAYCHESTER AVENUE","4d0d6d19-33f4-ea11-b882-24ee9a37d45c",-73839288,40884371,"P.S. 111 - BRONX","3740 BAYCHESTER AVENUE"
2,0,2,"882aa42b-33f4-ea11-b882-24ee9a37d45c","P186X Walter J. Damrosch School - X186 - X136 - 75X186 - 750 Jennings Street","892aa42b-33f4-ea11-b882-24ee9a37d45c",-73897797,40831388,"P.S. 186 (OLD J136) - BRONX","750 Jennings Street"
3,3,0,"530d6d19-33f4-ea11-b882-24ee9a37d45c","P.S. 112 Bronxwood - X112 - X112 - 11X112 - 1925 SCHIEFFELIN AVENUE","540d6d19-33f4-ea11-b882-24ee9a37d45c",-73843977,40884940,"P.S. 112 - BRONX","1925 SCHIEFFELIN AVENUE"
1,1,0,"bc315367-30f4-ea11-b882-24ee9a37d45c","P.S. 121 Nelson A. Rockefeller - K121 - K121 - 21K121 - 5301 20 AVENUE","bd315367-30f4-ea11-b882-24ee9a37d45c",-73978472,40622671,"P.S. 121 - BROOKLYN","5301 20 AVENUE"
1,1,0,"9601ce37-33f4-ea11-b882-24ee9a37d45c","P.S. 160 Walt Disney - X160 - X160 - 11X160 - 4140 HUTCHINSON RIVER PKWAY EA","9501ce37-33f4-ea11-b882-24ee9a37d45c",-73823816,40864073,"P.S. 160 - BRONX","4140 HUTCHINSON RIVER PKWAY EA"
1,1,0,"81593c87-33f4-ea11-b882-24ee9a37d45c","Bronx High School for the Visual Arts - X418 - X839 - 11X418 - 2040 ANTIN PL","80593c87-33f4-ea11-b882-24ee9a37d45c",-73864438,40851577,"BRONX HIGH SCHOOL FOR THE VISUAL ARTS","2040 ANTIN PL"
2,2,0,"bd0d3c5b-30f4-ea11-b882-24ee9a37d45c","P.S. 094 The Henry Longfellow - K094 - K094 - 15K094 - 5010 6 AVENUE","8fd92255-30f4-ea11-b882-24ee9a37d45c",-74008795,40643730,"P.S. 94 - BROOKLYN","5010 6 AVENUE"
1,1,0,"362f7d06-31f4-ea11-b882-24ee9a37d45c","Brooklyn Studio Secondary School - K690 - K721 - 21K690 - 8310 21ST AVENUE","56416e00-31f4-ea11-b882-24ee9a37d45c",-73995084,40604980,"BROOKLYN STUDIO  (TANDEM K128) - K","8310 21ST AVENUE"
1,1,0,"b68442ee-31f4-ea11-b882-24ee9a37d45c","P.S. 026 Rufus King - Q026 - Q026 - 26Q026 - 195-02 69 AVENUE","c5fc24e8-31f4-ea11-b882-24ee9a37d45c",-73777607,40735935,"P.S. 26 - QUEENS","195-02 69 AVENUE"
3,3,0,"f59b4c1f-32f4-ea11-b882-24ee9a37d45c","P.S. 159 - Q159 - Q159 - 26Q159 - 205-01 33 AVENUE","f69b4c1f-32f4-ea11-b882-24ee9a37d45c",-73783973,40770108,"P.S. 159 - QUEENS","205-01 33 AVENUE"
1,1,0,"96d810ab-31f4-ea11-b882-24ee9a37d45c","The High School of Fashion Industries - M600 - M600 - 02M600 - 225 WEST  24 STREET","94d810ab-31f4-ea11-b882-24ee9a37d45c",-73996354,40745677,"FASHION INDUSTRIES VOC HS - M","225 WEST  24 STREET"
1,1,0,"bbfab455-31f4-ea11-b882-24ee9a37d45c","James Weldon Johnson - M057 - M057 - 04M057 - 176 EAST 115 STREET","bcfab455-31f4-ea11-b882-24ee9a37d45c",-73941598,40797205,"P.S. 57 - MANHATTAN","176 EAST 115 STREET"
3,0,3,"197eed06-32f4-ea11-b882-24ee9a37d45c","P.S. 089 Elmhurst - Q089 - Q089 - 24Q089 - 85-28 BRITTON AVENUE","1a7eed06-32f4-ea11-b882-24ee9a37d45c",-73879641,40745963,"P.S. 89 - QUEENS","85-28 BRITTON AVENUE"
3,3,0,"dd2ece86-32f4-ea11-b882-24ee9a37d45c","Academy of Finance and Enterprise - Q264 - Q735 - 24Q264 - 30-20 THOMSON AVENUE","db2ece86-32f4-ea11-b882-24ee9a37d45c",-73937004,40744175,"QUEENS HIGH SCHOOL COMPLEX - Q","30-20 THOMSON AVENUE"
1,0,1,"1f70f999-ebf6-ea11-b883-24ee9a37d459","P.S. Q255 - Q255 - Q154 - 75Q255 - 75-02 162 Street","d69b4c1f-32f4-ea11-b882-24ee9a37d45c",-73807750,40726473,"P.S. 154 - QUEENS","75-02 162 Street"
1,1,0,"3ea10a44-32f4-ea11-b882-24ee9a37d45c","Pioneer Academy - Q307 - Q260 - 24Q307 - 40-20 100TH STREET","3da10a44-32f4-ea11-b882-24ee9a37d45c",-73865787,40749175,"P.S. 307- QUEENS","40-20 100TH STREET"
1,1,0,"fa11a0be-ebf6-ea11-b883-24ee9a37d459","P.S. Q224 - Q224 - Q809 - 75Q224 - 221-21 Corbett Road","febdf08c-32f4-ea11-b882-24ee9a37d45c",-73763295,40770666,"P.S. 224 ANNEX - QUEENS","221-21 Corbett Road"
1,0,1,"04f32ce2-31f4-ea11-b882-24ee9a37d45c","P.S. 013 Clement C. Moore - Q013 - Q013 - 24Q013 - 55-01 94 STREET","05f32ce2-31f4-ea11-b882-24ee9a37d45c",-73867662,40737441,"P.S. 13 - QUEENS","55-01 94 STREET"
1,0,1,"0a6e3d68-31f4-ea11-b882-24ee9a37d45c","P.S. 112 Jose Celso Barbosa - M112 - M112 - 04M112 - 535 EAST 119 STREET","0b6e3d68-31f4-ea11-b882-24ee9a37d45c",-73930528,40796889,"P.S. 112 (TANDEM M206) - MANHATTAN","535 EAST 119 STREET"
1,0,1,"31c73b4a-32f4-ea11-b882-24ee9a37d45c","Elm Tree Elementary School - Q211 - Q298 - 24Q211 - 50-51 98th Street","30c73b4a-32f4-ea11-b882-24ee9a37d45c",-73863408,40741139,"Marie M. Daly Educational Building","50-51 98th Street"
1,0,1,"fe17b7f4-32f4-ea11-b882-24ee9a37d45c","P.S. 277 - X277 - X027 - 07X277 - 519 ST ANNS AVENUE","fc17b7f4-32f4-ea11-b882-24ee9a37d45c",-73913872,40813385,"P.S. 277 - BRONX","519 ST ANNS AVENUE"
1,0,1,"310410ca-32f4-ea11-b882-24ee9a37d45c","P.S. 052 John C. Thompson - R052 - R052 - 31R052 - 450 BUEL AVENUE","320410ca-32f4-ea11-b882-24ee9a37d45c",-74089012,40582550,"P.S. 52 - STATEN ISLAND","450 BUEL AVENUE"
2,2,0,"9d0e6e25-32f4-ea11-b882-24ee9a37d45c","P.S./ IS 178 Holliswood - Q178 - Q178 - 26Q178 - 189-10 RADNOR ROAD","9e0e6e25-32f4-ea11-b882-24ee9a37d45c",-73777314,40724061,"P.S. 178 - QUEENS","189-10 RADNOR ROAD"
2,2,0,"f58a0044-33f4-ea11-b882-24ee9a37d45c","The Urban Assembly Bronx Academy of Letters - X551 - X183 - 07X551 - 339 MORRIS AVENUE","ef8a0044-33f4-ea11-b882-24ee9a37d45c",-73925995,40813681,"J.H.S. 203 - BRONX","339 MORRIS AVENUE"
1,1,0,"a6bfa431-33f4-ea11-b882-24ee9a37d45c","P.S. 146 Edward Collins - X146 - X146 - 08X146 - 968 CAULDWELL AVENUE","a5bfa431-33f4-ea11-b882-24ee9a37d45c",-73905734,40824717,"P.S. 146 - BRONX","968 CAULDWELL AVENUE"
2,2,0,"4ba10a44-32f4-ea11-b882-24ee9a37d45c","P.S./I.S. 266 - Q266 - Q266 - 26Q266 - 74-10 COMMONWEALTH BOULEVARD","4aa10a44-32f4-ea11-b882-24ee9a37d45c",-73728415,40746128,"P.S./I.S. 266 - QUEENS","74-10 COMMONWEALTH BOULEVARD"
1,1,0,"7136d900-33f4-ea11-b882-24ee9a37d45c","P.S. 057 Crescent - X057 - X057 - 12X057 - 2111 CROTONA AVENUE","6c36d900-33f4-ea11-b882-24ee9a37d45c",-73888987,40848748,"P.S. 57 - BRONX","2111 CROTONA AVENUE"
1,1,0,"aeab074a-33f4-ea11-b882-24ee9a37d45c","P.S. 211 - X211 - X193 - 12X211 - 1919 PROSPECT AVENUE","afab074a-33f4-ea11-b882-24ee9a37d45c",-73890145,40843705,"P.S. 211 - BRONX","1919 PROSPECT AVENUE"
1,1,0,"652f77fa-31f4-ea11-b882-24ee9a37d45c","P. S. 62 - Chester Park School - Q062 - Q062 - 27Q062 - 97-25 108 STREET","642f77fa-31f4-ea11-b882-24ee9a37d45c",-73835567,40688359,"P.S. 62 - QUEENS","97-25 108 STREET"
1,1,0,"db11f898-32f4-ea11-b882-24ee9a37d45c","Robert F. Wagner, Jr. Secondary School for Arts and Technology - Q560 - Q891 - 24Q560 - 47-07 30th Place","d911f898-32f4-ea11-b882-24ee9a37d45c",-73936442,40742217,"R. F. WAGNER SEC SCL ARTS & TECH-Q","47-07 30th Place"
2,2,0,"e7883319-32f4-ea11-b882-24ee9a37d45c","P.S. 146 Howard Beach - Q146 - Q146 - 27Q146 - 98-01 159 AVENUE","e8883319-32f4-ea11-b882-24ee9a37d45c",-73834896,40660531,"P.S. 146 - QUEENS","98-01 159 AVENUE"
1,1,0,"16e2abc9-30f4-ea11-b882-24ee9a37d45c","P.S. 377 Alejandrina B. De Gautier - K377 - K377 - 32K377 - 200 WOODBINE STREET","11e2abc9-30f4-ea11-b882-24ee9a37d45c",-73915159,40693542,"P.S. 377 - BROOKLYN","200 WOODBINE STREET"
1,1,0,"5a36d900-33f4-ea11-b882-24ee9a37d45c","Fairmont Neighborhood School - X314 - X050 - 12X314 - 1550 VYSE AVENUE","5836d900-33f4-ea11-b882-24ee9a37d45c",-73886995,40834188,"P.S. 50 - BRONX","1550 VYSE AVENUE"
1,0,1,"cb689025-33f4-ea11-b882-24ee9a37d45c","Soundview Academy for Culture and Scholarship - X448 - X131 - 08X448 - 885 Bolton Avenue","c8689025-33f4-ea11-b882-24ee9a37d45c",-73859998,40822925,"I.S. 131 - BRONX","885 Bolton Avenue"
1,0,1,"f18052e9-ebf6-ea11-b883-24ee9a37d459","P469X - The Bronx School for Continuous Learners - X469 - X027 - 75X469 - 519 ST ANNS AVENUE","fc17b7f4-32f4-ea11-b882-24ee9a37d45c",-73913872,40813385,"P.S. 277 - BRONX","519 ST ANNS AVENUE"
2,1,1,"42a10a44-32f4-ea11-b882-24ee9a37d45c","New York City Academy for Discovery - Q306 - Q262 - 27Q306 - 95-16 89TH AVENUE","43a10a44-32f4-ea11-b882-24ee9a37d45c",-73848577,40691482,"P.S. 262 - QUEENS","95-16 89TH AVENUE"
1,1,0,"419587f5-ebf6-ea11-b883-24ee9a37d459","P.S. X596 - X596 - X153 - 75X596 - 650 BAYCHESTER AVENUE","6801ce37-33f4-ea11-b882-24ee9a37d45c",-73831669,40874035,"P.S. 153 - BRONX","650 BAYCHESTER AVENUE"
1,1,0,"9372c880-32f4-ea11-b882-24ee9a37d45c","Epic High School - North - Q334 - Q636 - 27Q334 - 94-25 117th Street","9472c880-32f4-ea11-b882-24ee9a37d45c",-73829409,40693013,"RICHMOND HILL HIGH SCHOOL ANNEX - QUEENS","94-25 117th Street"
1,1,0,"d78fd20d-ebf6-ea11-b883-24ee9a37d459","P.S. K004 - K004 - K007 - 75K004 - 858 JAMAICA AVENUE","fcc1392a-30f4-ea11-b882-24ee9a37d45c",-73872983,40689213,"P.S. 7 - BROOKLYN","858 JAMAICA AVENUE"
1,1,0,"64bc9674-32f4-ea11-b882-24ee9a37d45c","Richmond Hill High School - Q475 - Q475 - 27Q475 - 89-30 114 Street","3002926e-32f4-ea11-b882-24ee9a37d45c",-73833815,40695171,"RICHMOND HILL HS - Q","89-30 114 Street"
1,1,0,"c617ab87-ebf6-ea11-b883-24ee9a37d459","P.S. Q233 - Q233 - Q025 - 75Q233 - 34-65 192 STREET","befc24e8-31f4-ea11-b882-24ee9a37d45c",-73789365,40764884,"J.H.S. 25 - QUEENS","34-65 192 STREET"
1,1,0,"9672c880-32f4-ea11-b882-24ee9a37d45c","High School for Construction Trades, Engineering and Architecture - Q650 - Q650 - 27Q650 - 94-06 104TH STREET","8f72c880-32f4-ea11-b882-24ee9a37d45c",-73841475,40689177,"HS FOR CONST.TRADES,ENGG.,& ARCH-Q","94-06 104TH STREET"
1,1,0,"3c02fdd0-ebf6-ea11-b883-24ee9a37d459","P.S. R373 - R373 - R006 - 75R373 - 555 PAGE AVENUE","3c7c21b7-32f4-ea11-b882-24ee9a37d45c",-74230118,40510207,"P.S. 6 - STATEN ISLAND","555 PAGE AVENUE"
1,1,0,"dce8ce00-32f4-ea11-b882-24ee9a37d45c","PS 80  The Thurgood Marshall Magnet School of Multimedia and Communication - Q080 - Q080 - 28Q080 - 171-05 137TH AVENUE","dde8ce00-32f4-ea11-b882-24ee9a37d45c",-73769119,40673483,"P.S. 80 - QUEENS","171-05 137TH AVENUE"
3,2,1,"b7b36d80-30f4-ea11-b882-24ee9a37d45c","P.S. K231 - K231 - K180 - 75K231 - 5601 16 AVENUE","b8b36d80-30f4-ea11-b882-24ee9a37d45c",-73989250,40626454,"P.S. 180 - BROOKLYN","5601 16 AVENUE"
1,0,1,"9f476368-32f4-ea11-b882-24ee9a37d45c","Flushing High School - Q460 - Q460 - 25Q460 - 35-01 UNION STREET","97476368-32f4-ea11-b882-24ee9a37d45c",-73826811,40764892,"FLUSHING HS - Q","35-01 UNION STREET"
1,1,0,"0aaf1f69-ebf6-ea11-b883-24ee9a37d459","District 2 Pre-K Center - M391 - M444 - 02M391 - 606 W. 57th Street","8634aa92-31f4-ea11-b882-24ee9a37d45c",-73992072,40770185,"PRE-K CENTER @ 606 W. 57TH STREET - MANHATTAN","606 W. 57th Street"
1,0,1,"48005d7a-31f4-ea11-b882-24ee9a37d45c","P.S. 175 Henry H Garnet - M175 - M175 - 05M175 - 175 WEST 134 STREET","47005d7a-31f4-ea11-b882-24ee9a37d45c",-73942706,40814388,"P.S. 175 - MANHATTAN","175 WEST 134 STREET"
3,1,2,"6c977d2b-32f4-ea11-b882-24ee9a37d45c","P.S. 188 Kingsbury - Q188 - Q188 - 26Q188 - 218-12 HARTLAND AVENUE","6d977d2b-32f4-ea11-b882-24ee9a37d45c",-73753985,40736063,"P.S. 188 - QUEENS","218-12 HARTLAND AVENUE"
1,1,0,"aeedf392-32f4-ea11-b882-24ee9a37d45c","P.S. 188 Kingsbury - Q188 - Q858 - 26Q188 - 216-15 Peck Avenue","afedf392-32f4-ea11-b882-24ee9a37d45c",-73754390,40734924,"PS 188 Annex","216-15 Peck Avenue"
1,0,1,"28474313-33f4-ea11-b882-24ee9a37d45c","P.S. 091 Bronx - X091 - X091 - 10X091 - 2200 AQUEDUCT AVENUE","29474313-33f4-ea11-b882-24ee9a37d45c",-73907494,40858286,"P.S. 91 - BRONX","2200 AQUEDUCT AVENUE"
1,0,1,"5fde261e-4afb-ea11-b883-24ee9a37d459","New Age Family Day Care - KBKX - KBKX -  - 546 JAMAICA AVENUE","60de261e-4afb-ea11-b883-24ee9a37d459",-73883260,40684640,"New Age Family Day Care","546 JAMAICA AVENUE"
1,1,0,"125d0a12-4afb-ea11-b883-24ee9a37d459","Angel Early Childhood Development Center - KCJY - KCJY -  - 1436 67th Street 1st floor","135d0a12-4afb-ea11-b883-24ee9a37d459",-73999645,40622950,"Angel Early Childhood Development Center","1436 67th Street 1st floor"
2,2,0,"ec201dab-30f4-ea11-b882-24ee9a37d45c","Pre-K Center at Bishop Ford School Site - K863 - K280 - 15K863 - 500 19 STREET","ed201dab-30f4-ea11-b882-24ee9a37d45c",-73983116,40656952,"PRE-K CENTER @ 500 19TH STREET - BROOKLYN","500 19 STREET"
1,0,1,"28a6ba98-31f4-ea11-b882-24ee9a37d45c","The College Academy - M462 - M465 - 06M462 - 549 AUDUBON AVENUE","25a6ba98-31f4-ea11-b882-24ee9a37d45c",-73926060,40856532,"G. WASHINGTON HS EDUC. CAMPUS - M","549 AUDUBON AVENUE"
1,0,1,"33ceb75a-4afb-ea11-b883-24ee9a37d459","YMCA OF GREATER NEW YORK - CROSS ISLAND - QAJX - QAJX -  - 238-10 HILLSIDE AVENUE","34ceb75a-4afb-ea11-b883-24ee9a37d459",-73727533,40732259,"YMCA OF GREATER NEW YORK - CROSS ISLAND","238-10 HILLSIDE AVENUE"
1,1,0,"65507380-31f4-ea11-b882-24ee9a37d45c","P.S. 290 Manhattan New School - M290 - M190 - 02M290 - 311 EAST  82 STREET","66507380-31f4-ea11-b882-24ee9a37d45c",-73952777,40775181,"P.S. 290 - MANHATTAN","311 EAST  82 STREET"
4,4,0,"818d8486-31f4-ea11-b882-24ee9a37d45c","P.S. 77 Lower Lab School - M077 - M198 - 02M077 - 1700 3 AVENUE","7f8d8486-31f4-ea11-b882-24ee9a37d45c",-73950420,40785018,"P.S. 198 - MANHATTAN","1700 3 AVENUE"
2,0,2,"c7c88e4f-31f4-ea11-b882-24ee9a37d45c","River East Elementary - M037 - M045 - 04M037 - 2351 FIRST AVENUE","c6c88e4f-31f4-ea11-b882-24ee9a37d45c",-73933740,40799265,"I.S. 45 - MANHATTAN","2351 FIRST AVENUE"
1,0,1,"cab36d80-30f4-ea11-b882-24ee9a37d45c","P.S. 184 Newport - K184 - K184 - 23K184 - 273 NEWPORT STREET","c8b36d80-30f4-ea11-b882-24ee9a37d45c",-73905004,40660385,"P.S. 184 - BROOKLYN","273 NEWPORT STREET"
2,2,0,"7de2635c-32f4-ea11-b882-24ee9a37d45c","New Visions Charter High School for the Humanities IV - Q373 - Q410 - 84Q373 - 100-00 BEACH CHANNEL DRIVE","71e2635c-32f4-ea11-b882-24ee9a37d45c",-73825317,40586012,"Beach Channel Educational Campus","100-00 BEACH CHANNEL DRIVE"
2,1,1,"0f68ee1e-31f4-ea11-b882-24ee9a37d45c","P.S. 230 Doris L. Cohen - K230 - K908 - 15K230 - 425 Mcdonald Avenue","1068ee1e-31f4-ea11-b882-24ee9a37d45c",-73979161,40643512,"P.S. 230 ANNEX - BROOKLYN","425 Mcdonald Avenue"
1,1,0,"e217b7f4-32f4-ea11-b882-24ee9a37d45c","J.H.S. 022 Jordan L. Mott - X022 - X022 - 09X022 - 270 EAST 167 STREET","de17b7f4-32f4-ea11-b882-24ee9a37d45c",-73914350,40832022,"I.S. 22 - BRONX","270 EAST 167 STREET"
2,0,2,"f721d292-30f4-ea11-b882-24ee9a37d45c","P.S. 230 Doris L. Cohen - K230 - K230 - 15K230 - 1 ALBEMARLE ROAD","f321d292-30f4-ea11-b882-24ee9a37d45c",-73980515,40645609,"P.S. 230 - BROOKLYN","1 ALBEMARLE ROAD"
1,0,1,"430410ca-32f4-ea11-b882-24ee9a37d45c","Space Shuttle Columbia School - R058 - R058 - 31R058 - 77 MARSH AVENUE","2a0410ca-32f4-ea11-b882-24ee9a37d45c",-74160867,40582791,"P.S. 58 - STATEN ISLAND","77 MARSH AVENUE"
3,3,0,"9ae657bd-30f4-ea11-b882-24ee9a37d45c","P.S. 133 William A. Butler - K133 - K317 - 13K133 - 610 BALTIC STREET","99e657bd-30f4-ea11-b882-24ee9a37d45c",-73980455,40679916,"P.S. 133 WILLIAM A. BUTLER - BROOKLYN","610 BALTIC STREET"
1,0,1,"3cde5eb7-30f4-ea11-b882-24ee9a37d45c","Brownsville Collaborative Middle School - K363 - K298 - 23K363 - 85 WATKINS STREET","3dde5eb7-30f4-ea11-b882-24ee9a37d45c",-73907718,40671015,"P.S. 298 - BROOKLYN","85 WATKINS STREET"
1,0,1,"66b50aa5-30f4-ea11-b882-24ee9a37d45c","P.S. 261 Philip Livingston - K261 - K261 - 15K261 - 314 PACIFIC STREET","5fb50aa5-30f4-ea11-b882-24ee9a37d45c",-73988667,40687218,"P.S. 261 - BROOKLYN","314 PACIFIC STREET"
1,0,1,"b572c880-32f4-ea11-b882-24ee9a37d45c","P.S. Q016 The Nancy DeBenedittis School - Q016 - Q721 - 24Q016 - 41-15 104 STREET","b672c880-32f4-ea11-b882-24ee9a37d45c",-73860547,40748996,"P.S. 16 (OLD Q721 SPED) - QUEENS","41-15 104 STREET"
1,1,0,"91d810ab-31f4-ea11-b882-24ee9a37d45c","A. Philip Randolph Campus High School - M540 - M540 - 06M540 - 443 WEST 135 STREET","90d810ab-31f4-ea11-b882-24ee9a37d45c",-73949929,40818500,"A. PHILLIP RANDOLPH HS - MANHATTAN","443 WEST 135 STREET"
2,1,1,"47a10a44-32f4-ea11-b882-24ee9a37d45c","P.S./I.S. 295 - Q295 - Q263 - 29Q295 - 222-14 JAMAICA AVENUE","41a10a44-32f4-ea11-b882-24ee9a37d45c",-73731398,40720617,"P.S. /I.S 295 - QUEENS","222-14 JAMAICA AVENUE"
1,0,1,"d0e0838c-31f4-ea11-b882-24ee9a37d45c","Richard R. Green High School of Teaching - M580 - M282 - 02M580 - 7 BEAVER STREET","d1e0838c-31f4-ea11-b882-24ee9a37d45c",-74013303,40705688,"BROADWAY EDUCATION CAMPUS - M","26 BROADWAY"
1,0,1,"2806003e-32f4-ea11-b882-24ee9a37d45c","P.S. 239 - Q239 - Q239 - 24Q239 - 17-15 WEIRFIELD STREET","2606003e-32f4-ea11-b882-24ee9a37d45c",-73903838,40699431,"P.S. 239 - QUEENS","17-15 WEIRFIELD STREET"
1,0,1,"4a416e00-31f4-ea11-b882-24ee9a37d45c","Brooklyn's Daily Discovery Pre-K Center - K840 - K687 - 21K840 - 10 BOUCK COURT","4b416e00-31f4-ea11-b882-24ee9a37d45c",-73973728,40588759,"PRE-K CENTER @BOUCK COURT - BROOKLYN","10 BOUCK COURT"
2,2,0,"4e767649-31f4-ea11-b882-24ee9a37d45c","P.S. 040 Augustus Saint-Gaudens - M040 - M040 - 02M040 - 320 EAST 20TH STREET","46767649-31f4-ea11-b882-24ee9a37d45c",-73981536,40735328,"P.S. 40 - MANHATTAN","320 EAST 20TH STREET"
1,0,1,"47fdc1bd-32f4-ea11-b882-24ee9a37d45c","P.S. 8 Shirlee Solomon - R008 - R008 - 31R008 - 112 LINDENWOOD ROAD","48fdc1bd-32f4-ea11-b882-24ee9a37d45c",-74152212,40547567,"P.S. 8 - STATEN ISLAND","112 LINDENWOOD ROAD"
1,0,1,"84b50aa5-30f4-ea11-b882-24ee9a37d45c","P.S. 361 East Flatbush Early Childhood School - K361 - K269 - 22K361 - 1957 NOSTRAND AVENUE","80b50aa5-30f4-ea11-b882-24ee9a37d45c",-73947672,40637625,"P.S. 269 - BROOKLYN","1957 NOSTRAND AVENUE"
1,0,1,"8f8d8486-31f4-ea11-b882-24ee9a37d45c","P.S. 206 Jose Celso Barbosa - M206 - M206 - 04M206 - 508 EAST 120 STREET","908d8486-31f4-ea11-b882-24ee9a37d45c",-73930528,40796889,"P.S. 206 (TANDEM M112) - MANHATTAN","508 EAST 120 STREET"
1,1,0,"cdfab455-31f4-ea11-b882-24ee9a37d45c","Neighborhood School - M363 - M063 - 01M363 - 121 EAST  3 STREET","cefab455-31f4-ea11-b882-24ee9a37d45c",-73986214,40724440,"P.S. 63 - MANHATTAN","121 EAST  3 STREET"
1,0,1,"1e9ebaee-32f4-ea11-b882-24ee9a37d45c","P.S. 9 Ryer Avenue Elementary School - X009 - X009 - 10X009 - 230 EAST 183 STREET","169ebaee-32f4-ea11-b882-24ee9a37d45c",-73898821,40856440,"P.S. 9 (OLD 115) - BRONX","230 EAST 183 STREET"
