"TotalCases","StudentCases","EmployeeCases","nycsr_locationsiteid","nycsr_sitename","nycsr_building.nycsr_buildingid","nycsr_building.nycsr_longitude","nycsr_building.nycsr_latitude","nycsr_building.nycsr_buildingname","nycsr_building.nycsr_address"
1,0,1,"82be7adc-32f4-ea11-b882-24ee9a37d45c","P.S. 65 The Academy of Innovative Learning - R065 - R829 - 31R065 - 98 GRANT STREET","83be7adc-32f4-ea11-b882-24ee9a37d45c",-74078337,40633666,"ARTHUR D. PHILLIPS SCHOOL - S.I.","98 GRANT STREET"
9,7,2,"989c11e8-30f4-ea11-b882-24ee9a37d45c","Millennium Brooklyn HS - K684 - K460 - 15K684 - 237 7 AVENUE","929c11e8-30f4-ea11-b882-24ee9a37d45c",-73978580,40669255,"John Jay Educational Campus","237 7 AVENUE"
3,3,0,"d479df48-30f4-ea11-b882-24ee9a37d45c","Community Roots Charter School - K536 - K067 - 84K536 - 51 SAINT EDWARDS STREET","d179df48-30f4-ea11-b882-24ee9a37d45c",-73977674,40695339,"P.S. 67 - BROOKLYN","51 SAINT EDWARDS STREET"
3,3,0,"5b5b4cd6-32f4-ea11-b882-24ee9a37d45c","Curtis High School - R450 - R450 - 31R450 - 105 HAMILTON AVENUE","5a5b4cd6-32f4-ea11-b882-24ee9a37d45c",-74082149,40645436,"CURTIS HS - S. I.","105 HAMILTON AVENUE"
3,0,3,"a732c3fb-eaf6-ea11-b883-24ee9a37d459","P.S. Q177 - Q177 - Q177 - 75Q177 - 56-37 188 STREET","8b0e6e25-32f4-ea11-b882-24ee9a37d45c",-73787419,40743400,"P.S. 177 - QUEENS","56-37 188 STREET"
2,1,1,"e880b5c9-df1e-eb11-b885-24ee9a37d45c","MS 936 Arts Off 3rd - K936 - K746 - 20K936 - 270 59th Street","e980b5c9-df1e-eb11-b885-24ee9a37d45c",-74020748,40642914,"P.S. @ 270 59TH STREET- BROOKLYN","270 59th Street"
3,3,0,"237eed06-32f4-ea11-b882-24ee9a37d45c","I.S. 093 Ridgewood - Q093 - Q093 - 24Q093 - 66-56 FOREST AVENUE","0f7eed06-32f4-ea11-b882-24ee9a37d45c",-73903057,40705609,"I.S. 93 - QUEENS","66-56 FOREST AVENUE"
1,1,0,"cc0d3c5b-30f4-ea11-b882-24ee9a37d45c","P.S. 97 The Highlawn - K097 - K097 - 21K097 - 1846 West 13 Street","cd0d3c5b-30f4-ea11-b882-24ee9a37d45c",-73985570,40601191,"P.S. 97 - BROOKLYN","1846 West 13 Street"
2,2,0,"c98442ee-31f4-ea11-b882-24ee9a37d45c","P.S. 032 State Street - Q032 - Q032 - 25Q032 - 171-11 35 AVENUE","ca8442ee-31f4-ea11-b882-24ee9a37d45c",-73794323,40765459,"P.S. 32 - QUEENS","171-11 35 AVENUE"
4,2,2,"4a9d7c62-33f4-ea11-b882-24ee9a37d45c","Bronxdale High School - X508 - X415 - 11X508 - 925 ASTOR AVENUE","439d7c62-33f4-ea11-b882-24ee9a37d45c",-73860729,40860443,"CHRISTOPHER COLUMBUS HS - X","925 ASTOR AVENUE"
1,1,0,"aeedf392-32f4-ea11-b882-24ee9a37d45c","P.S. 188 Kingsbury - Q188 - Q858 - 26Q188 - 216-15 Peck Avenue","afedf392-32f4-ea11-b882-24ee9a37d45c",-73754390,40734924,"PS 188 Annex","216-15 Peck Avenue"
3,0,3,"fe77931f-33f4-ea11-b882-24ee9a37d45c","School of Performing Arts - X217 - X116 - 12X217 - 977 FOX STREET","fd77931f-33f4-ea11-b882-24ee9a37d45c",-73894368,40822056,"I.S. 216 - BRONX","977 FOX STREET"
5,4,1,"0ffc3df4-30f4-ea11-b882-24ee9a37d45c","All City Leadership Secondary School - K554 - K554 - 32K554 - 321 Palmetto Street","10fc3df4-30f4-ea11-b882-24ee9a37d45c",-73913172,40697378,"ALL CITY LEADERSHIP SECONDARY SCHOOL - BROOKLYN","321 Palmetto Street"
8,8,0,"e8ed94c3-31f4-ea11-b882-24ee9a37d45c","Beacon High School - M479 - M912 - 03M479 - 522 WEST 44TH STREET","e7ed94c3-31f4-ea11-b882-24ee9a37d45c",-73996262,40760858,"BEACON HIGH SCHOOL - MANHATTAN","522 WEST 44TH STREET"
1,0,1,"949c11e8-30f4-ea11-b882-24ee9a37d45c","John Jay School for Law - K462 - K460 - 15K462 - 237 7 AVENUE","929c11e8-30f4-ea11-b882-24ee9a37d45c",-73978580,40669255,"John Jay Educational Campus","237 7 AVENUE"
1,0,1,"e4454b50-32f4-ea11-b882-24ee9a37d45c","Learners and Leaders - Q305 - Q320 - 24Q305 - 360 SENECA AVENUE","e5454b50-32f4-ea11-b882-24ee9a37d45c",-73915359,40707343,"P.S. 320 - QUEENS","360 SENECA AVENUE"
1,0,1,"29a10a44-32f4-ea11-b882-24ee9a37d45c","Learners and Leaders - Q305 - Q245 - 24Q305 - 378 Seneca Avenue","26a10a44-32f4-ea11-b882-24ee9a37d45c",-73914990,40706837,"P.S. 245 ECC - QUEENS","378 Seneca Avenue"
5,5,0,"c7e0838c-31f4-ea11-b882-24ee9a37d45c","Battery Park City School - M276 - M276 - 02M276 - 55 BATTERY PLACE","c6e0838c-31f4-ea11-b882-24ee9a37d45c",-74017456,40706384,"P.S./I.S. 276 - MANHATTAN","55 BATTERY PLACE"
2,0,2,"b5b36d80-30f4-ea11-b882-24ee9a37d45c","P.S. 179 Kensington - K179 - K179 - 20K179 - 202 AVENUE C","13d1de79-30f4-ea11-b882-24ee9a37d45c",-73977260,40640127,"P.S. 179 - BROOKLYN","202 AVENUE C"
1,0,1,"e1b012b5-254f-ed11-b0b5-088e901ef405","Mott Hall IV - K522 - K041 - 23K522 - 411 Thatford Avenue","0f1bad3c-30f4-ea11-b882-24ee9a37d45c",-73906925,40660455,"P.S. 41 - BROOKLYN","225 Newport Street"
3,2,1,"54ebaa73-30f4-ea11-b882-24ee9a37d45c","P.S. 169 Sunset Park - K169 - K169 - 15K169 - 4305 7 AVENUE","55ebaa73-30f4-ea11-b882-24ee9a37d45c",-74001700,40645825,"P.S. 169 - BROOKLYN","4305 7 AVENUE"
1,1,0,"26767649-31f4-ea11-b882-24ee9a37d45c","P.S. 212 Midtown West - M212 - M017 - 02M212 - 328 WEST 48 STREET","aa886843-31f4-ea11-b882-24ee9a37d45c",-73988665,40761327,"I.S. 17 - MANHATTAN","328 WEST 48 STREET"
6,1,5,"e621d292-30f4-ea11-b882-24ee9a37d45c","P.S. K225 - The Eileen E. Zaglin - K225 - K225 - 21K225 - 1075 OCEAN VIEW AVENUE","e521d292-30f4-ea11-b882-24ee9a37d45c",-73955856,40580260,"P.S. 225 - BROOKLYN","1075 OCEAN VIEW AVENUE"
2,1,1,"07ca024b-84ef-eb11-b8b1-24ee9a37d45c","P.S. Q177 - Q177 - Q435 - 75Q177 - 230-17 HILLSIDE AVENUE","c4b66262-32f4-ea11-b882-24ee9a37d45c",-73739726,40733888,"MARTIN VAN BUREN HS - QUEENS","230-17 HILLSIDE AVENUE"
1,0,1,"46b4977a-32f4-ea11-b882-24ee9a37d45c","Aviation Career & Technical Education High School - Q610 - Q610 - 24Q610 - 45-30 36 STREET","44b4977a-32f4-ea11-b882-24ee9a37d45c",-73929577,40743309,"AVIATION HS - Q","45-30 36 STREET"
1,0,1,"538dbfcf-30f4-ea11-b882-24ee9a37d45c","Abraham Lincoln High School - K410 - K410 - 21K410 - 2800 OCEAN PARKWAY","518dbfcf-30f4-ea11-b882-24ee9a37d45c",-73968733,40582627,"ABRAHAM LINCOLN HS - K","2800 OCEAN PARKWAY"
1,0,1,"d08521d0-32f4-ea11-b882-24ee9a37d45c","Port Richmond School for Visionary Learning - R068 - R066 - 31R068 - 1625 FOREST AVENUE","d18521d0-32f4-ea11-b882-24ee9a37d45c",-74142526,40624781,"ECC @1625 FOREST AVENUE - STATEN ISLAND","1625 FOREST AVENUE"
2,2,0,"9b53dd74-33f4-ea11-b882-24ee9a37d45c","Bronx School of Law and Finance - X284 - X475 - 10X284 - 99 TERRACE VIEW AVENUE","9853dd74-33f4-ea11-b882-24ee9a37d45c",-73912686,40877379,"JOHN F. KENNEDY HS - X","99 TERRACE VIEW AVENUE"
2,0,2,"ac2aa42b-33f4-ea11-b882-24ee9a37d45c","The New School for Leadership and Journalism - X244 - X143 - 10X244 - 120 WEST 231 STREET","ad2aa42b-33f4-ea11-b882-24ee9a37d45c",-73901565,40875636,"I.S. 143 - BRONX","120 WEST 231 STREET"
2,2,0,"44ff3d8d-33f4-ea11-b882-24ee9a37d45c","High School of American Studies at Lehman College - X696 - X905 - 10X696 - 2925 Goulden Avenue","45ff3d8d-33f4-ea11-b882-24ee9a37d45c",-73895543,40874725,"HS OF AMERICAN STUDIES - BRONX","2925 Goulden Avenue"
1,0,1,"1e0b210d-33f4-ea11-b882-24ee9a37d45c","The Vida Bogart School for All Children - X352 - X075 - 75X352 - 984 FAILE STREET","1f0b210d-33f4-ea11-b882-24ee9a37d45c",-73888948,40822314,"P.S. 75 - BRONX","984 FAILE STREET"
4,4,0,"722f77fa-31f4-ea11-b882-24ee9a37d45c","J.H.S. 067 Louis Pasteur - Q067 - Q067 - 26Q067 - 51-60 MARATHON PARKWAY","732f77fa-31f4-ea11-b882-24ee9a37d45c",-73734832,40762241,"J.H.S. 67 - QUEENS","51-60 MARATHON PARKWAY"
2,0,2,"f58052e9-ebf6-ea11-b883-24ee9a37d459","The Bronx School for Continuous Learners - X469 - X042 - 75X469 - 1537 WASHINGTON AVENUE","1103cefa-32f4-ea11-b882-24ee9a37d45c",-73903243,40838636,"P.S. 42 - BRONX","1537 WASHINGTON AVENUE"
4,4,0,"4c8dbfcf-30f4-ea11-b882-24ee9a37d45c","Midwood High School - K405 - K405 - 22K405 - 2839 BEDFORD AVENUE","4d8dbfcf-30f4-ea11-b882-24ee9a37d45c",-73952356,40632829,"MIDWOOD HS - K","2839 BEDFORD AVENUE"
1,0,1,"3a9587f5-ebf6-ea11-b883-24ee9a37d459","The Bronx School for Continuous Learners - X469 - X147 - 75X469 - 1600 WEBSTER AVENUE","a9bfa431-33f4-ea11-b882-24ee9a37d45c",-73904353,40840536,"I.S. 339 (OLD 147) - BRONX","1600 WEBSTER AVENUE"
1,0,1,"f18052e9-ebf6-ea11-b883-24ee9a37d459","The Bronx School for Continuous Learners - X469 - X027 - 75X469 - 519 ST ANNS AVENUE","fc17b7f4-32f4-ea11-b882-24ee9a37d45c",-73913872,40813385,"P.S. 277 - BRONX","519 ST ANNS AVENUE"
4,0,4,"cb689025-33f4-ea11-b882-24ee9a37d45c","Soundview Academy for Culture and Scholarship - X448 - X131 - 08X448 - 885 Bolton Avenue","c8689025-33f4-ea11-b882-24ee9a37d45c",-73859998,40822925,"I.S. 131 - BRONX","885 Bolton Avenue"
1,0,1,"8128a20c-31f4-ea11-b882-24ee9a37d45c","Achievement First Endeavor Charter School - K508 - K784 - 84K508 - 510 WAVERLY AVENUE","8228a20c-31f4-ea11-b882-24ee9a37d45c",-73965928,40682422,"ACHIEVEMENT FIRST ENDEAVOR CHARTER SCHOOL - K","510 WAVERLY AVENUE"
3,2,1,"039c4c1f-32f4-ea11-b882-24ee9a37d45c","P.S. 163 Flushing Heights - Q163 - Q163 - 25Q163 - 159-01 59 AVENUE","049c4c1f-32f4-ea11-b882-24ee9a37d45c",-73808765,40741107,"P.S. 163 - QUEENS","159-01 59 AVENUE"
3,0,3,"5236d900-33f4-ea11-b882-24ee9a37d45c","P.S. 048 Joseph R. Drake - X048 - X048 - 08X048 - 1290 SPOFFORD AVENUE","5336d900-33f4-ea11-b882-24ee9a37d45c",-73886834,40814034,"P.S. 48 - BRONX","1290 SPOFFORD AVENUE"
7,4,3,"512b3eee-30f4-ea11-b882-24ee9a37d45c","Fort Hamilton High School - K490 - K490 - 20K490 - 8301 SHORE ROAD","522b3eee-30f4-ea11-b882-24ee9a37d45c",-74038103,40626827,"FORT HAMILTON HS - K","8301 SHORE ROAD"
2,1,1,"35a10a44-32f4-ea11-b882-24ee9a37d45c","The Randolph Holder School for Social Justice - Q253 - Q253 - 27Q253 - 1307 CENTRAL AVENUE","30a10a44-32f4-ea11-b882-24ee9a37d45c",-73748799,40607247,"P.S. 253 -QUEENS","1307 CENTRAL AVENUE"
3,0,3,"553cbf01-ebf6-ea11-b883-24ee9a37d459","The David Marquis School of the Arts - R037 - R840 - 75R037 - 15 Fairfield Street","81be7adc-32f4-ea11-b882-24ee9a37d45c",-74151368,40564100,"P.S. 37 ( OLD I24X)-STATEN ISLAND","15 Fairfield Street"
1,0,1,"48507380-31f4-ea11-b882-24ee9a37d45c","Amistad Dual Language School - M311 - M176 - 06M311 - 4862 BROADWAY","46507380-31f4-ea11-b882-24ee9a37d45c",-73923818,40866381,"P.S./I.S. 176 - MANHATTAN","4862 BROADWAY"
1,0,1,"3b0d6d19-33f4-ea11-b882-24ee9a37d45c","P.S. 106 Parkchester - X106 - X106 - 11X106 - 1514 OLMSTEAD AVENUE","3c0d6d19-33f4-ea11-b882-24ee9a37d45c",-73854823,40836974,"P.S. 106 - BRONX","1514 OLMSTEAD AVENUE"
1,0,1,"ebb98b86-30f4-ea11-b882-24ee9a37d45c","P.S. 194 Raoul Wallenberg - K194 - K194 - 22K194 - 3117 AVENUE W","ecb98b86-30f4-ea11-b882-24ee9a37d45c",-73934163,40598069,"P.S. 194 - BROOKLYN","3117 AVENUE W"
4,2,2,"e292e6d5-30f4-ea11-b882-24ee9a37d45c","James Madison High School - K425 - K425 - 22K425 - 3787 BEDFORD AVENUE","e092e6d5-30f4-ea11-b882-24ee9a37d45c",-73947661,40610499,"JAMES MADISON HS - K","3787 BEDFORD AVENUE"
1,0,1,"b332c3fb-eaf6-ea11-b883-24ee9a37d459","Mosaic Pre-K Center - Q331 - Q392 - 24Q331 - 68-20 Myrtle Avenue","a2eb6056-32f4-ea11-b882-24ee9a37d45c",-73883878,40701694,"PRE-K CENTER @ 68-20 MYRTLE AVENUE - QUEENS","68-20 Myrtle Avenue"
2,2,0,"00b7c337-32f4-ea11-b882-24ee9a37d45c","Wave Preparatory Elementary School - Q362 - Q215 - 27Q362 - 535 BRIAR PLACE","01b7c337-32f4-ea11-b882-24ee9a37d45c",-73758587,40599467,"P.S. 215 - QUEENS","535 BRIAR PLACE"
2,1,1,"a32ff20c-32f4-ea11-b882-24ee9a37d45c","P.S. 101 School in the Gardens - Q101 - Q101 - 28Q101 - 2 RUSSELL PLACE","a42ff20c-32f4-ea11-b882-24ee9a37d45c",-73843400,40715543,"P.S. 101 - QUEENS","2 RUSSELL PLACE"
1,0,1,"76b50aa5-30f4-ea11-b882-24ee9a37d45c","P.S. 264 Bay Ridge Elementary School For The Arts - K264 - K264 - 20K264 - 371 89th Street","74b50aa5-30f4-ea11-b882-24ee9a37d45c",-74029444,40621025,"PS 264 BAY RIDGE ELEM SCL FOR THE ARTS - BROOKLYN","371 89th Street"
1,0,1,"e68a0044-33f4-ea11-b882-24ee9a37d45c","I.S. 181 Pablo Casals - X181 - X181 - 11X181 - 800 BAYCHESTER AVENUE","e78a0044-33f4-ea11-b882-24ee9a37d45c",-73831669,40874035,"I.S. 181 - BRONX","800 BAYCHESTER AVENUE"
6,4,2,"668946f4-31f4-ea11-b882-24ee9a37d45c","P.S. 049 Dorothy Bonawit Kole - Q049 - Q049 - 24Q049 - 63-60 80th Street","678946f4-31f4-ea11-b882-24ee9a37d45c",-73875493,40719567,"P.S./I.S. 49 - QUEENS","63-60 80th Street"
10,1,9,"aafc24e8-31f4-ea11-b882-24ee9a37d45c","P.S. 020 John Bowne - Q020 - Q020 - 25Q020 - 142-30 BARCLAY AVENUE","14f32ce2-31f4-ea11-b882-24ee9a37d45c",-73824388,40758347,"P.S. 20 - QUEENS","142-30 BARCLAY AVENUE"
3,1,2,"3ea10a44-32f4-ea11-b882-24ee9a37d45c","Pioneer Academy - Q307 - Q260 - 24Q307 - 40-20 100TH STREET","3da10a44-32f4-ea11-b882-24ee9a37d45c",-73865787,40749175,"P.S. 307- QUEENS","40-20 100TH STREET"
3,1,2,"0bcf496e-31f4-ea11-b882-24ee9a37d45c","M.S. 131 - M131 - M131 - 02M131 - 100 HESTER STREET","03cf496e-31f4-ea11-b882-24ee9a37d45c",-73993607,40716231,"I.S. 131 - MANHATTAN","100 HESTER STREET"
3,3,0,"3e02fdd0-ebf6-ea11-b883-24ee9a37d459","The Michael J. Petrides School - R080 - R010 - 31R080 - 715 OCEAN TERRACE","4bfdc1bd-32f4-ea11-b882-24ee9a37d45c",-74105883,40607637,"P.S. 80 (PETRIDES COMPLEX) AF - STATEN ISLAND","715 OCEAN TERRACE"
1,0,1,"9083ff9e-30f4-ea11-b882-24ee9a37d45c","P.S. 249 The Caton - K249 - K249 - 17K249 - 18 MARLBOROUGH ROAD","9183ff9e-30f4-ea11-b882-24ee9a37d45c",-73966456,40649509,"P.S. 249 - BROOKLYN","18 MARLBOROUGH ROAD"
2,2,0,"3d88e6db-30f4-ea11-b882-24ee9a37d45c","World Academy for Total Community Health High School - K510 - K435 - 19K510 - 400 PENNSYLVANIA AVENUE","3688e6db-30f4-ea11-b882-24ee9a37d45c",-73895122,40666868,"THOMAS JEFFERSON HS - K","400 PENNSYLVANIA AVENUE"
5,5,0,"cbd27c6d-30f4-ea11-b882-24ee9a37d45c","P.S. 139 Alexine A. Fenty - K139 - K139 - 22K139 - 330 RUGBY ROAD","cad27c6d-30f4-ea11-b882-24ee9a37d45c",-73965862,40641340,"P.S. 139 - BROOKLYN","330 RUGBY ROAD"
2,0,2,"e9e0a4fb-ebf6-ea11-b883-24ee9a37d459","P.S. X721 - Stephen McSweeney School - X721 - X368 - 75X721 - 2975 TIBBETT AVENUE","74e03d56-33f4-ea11-b882-24ee9a37d45c",-73913694,40877935,"M.S./H.S. 368 - BRONX","2975 TIBBETT AVENUE"
2,1,1,"fc454b50-32f4-ea11-b882-24ee9a37d45c","College Point Collaborative - Q379 - Q336 - 25Q379 - 12406 14TH AVENUE","fd454b50-32f4-ea11-b882-24ee9a37d45c",-73843504,40785129,"The College Point Collaborative Educational Buildi","12406 14TH AVENUE"
20,19,1,"5d07e99e-31f4-ea11-b882-24ee9a37d45c","Stuyvesant High School - M475 - M477 - 02M475 - 345 CHAMBERS STREET","5c07e99e-31f4-ea11-b882-24ee9a37d45c",-74013921,40718025,"STUYVESANT HS (NEW) - MANHATTAN","345 CHAMBERS STREET"
4,3,1,"2baf0313-32f4-ea11-b882-24ee9a37d45c","P.S. 139 Rego Park - Q139 - Q139 - 28Q139 - 93-06 63 DRIVE","29af0313-32f4-ea11-b882-24ee9a37d45c",-73862561,40728012,"P.S. 139 - QUEENS","93-06 63 DRIVE"
1,0,1,"e5ce496e-31f4-ea11-b882-24ee9a37d45c","P.S. 123 Mahalia Jackson - M123 - M123 - 05M123 - 301 WEST 140 STREET","e3ce496e-31f4-ea11-b882-24ee9a37d45c",-73944551,40820216,"P.S. 123 - MANHATTAN","301 WEST 140 STREET"
1,0,1,"c7ba3c50-33f4-ea11-b882-24ee9a37d45c","P.S. 279 Captain Manuel Rivera, Jr. - X279 - X279 - 10X279 - 2100 WALTON AVENUE","c8ba3c50-33f4-ea11-b882-24ee9a37d45c",-73904958,40854666,"P.S. 279 - BRONX","2100 WALTON AVENUE"
1,0,1,"8603194f-30f4-ea11-b882-24ee9a37d45c","Brooklyn Landmark Elementary School - K599 - K073 - 23K599 - 251 MAC DOUGAL STREET","8503194f-30f4-ea11-b882-24ee9a37d45c",-73910719,40680679,"P.S. 73 - BROOKLYN","251 MAC DOUGAL STREET"
1,1,0,"fcb98b86-30f4-ea11-b882-24ee9a37d45c","P.S. 199 Frederick Wachtel - K199 - K199 - 21K199 - 1100 ELM AVENUE","fdb98b86-30f4-ea11-b882-24ee9a37d45c",-73963026,40616310,"P.S. 199 - BROOKLYN","1100 ELM AVENUE"
4,2,2,"b03fce93-7c88-ec11-b8d0-24ee9a37d45c","Academy of American Studies - Q575 - Q575 - 30Q575 - 40-11 28th Street","b13fce93-7c88-ec11-b8d0-24ee9a37d45c",-73936596,40751839,"ACADEMY OF AMERICAN STUDIES - QUEENS","40-11 28th Street"
1,0,1,"a0dab801-ecf6-ea11-b883-24ee9a37d459","P.S. X721 - Stephen McSweeney School - X721 - X423 - 75X721 - 1551 EAST 172ND STREET","639d7c62-33f4-ea11-b882-24ee9a37d45c",-73878191,40832508,"JAMES MONROE HS CAMPUS ANNEX - BRONX","1551 EAST 172ND STREET"
4,1,3,"7c476368-32f4-ea11-b882-24ee9a37d45c","Newcomers High School - Q555 - Q450 - 30Q555 - 28-01 41 AVENUE","dab66262-32f4-ea11-b882-24ee9a37d45c",-73936592,40751838,"NEWCOMERS HIGH SCHOOL (OLD LIC)-Q","28-01 41 AVENUE"
3,0,3,"0a6e3d68-31f4-ea11-b882-24ee9a37d45c","P.S. 112 Jose Celso Barbosa - M112 - M112 - 04M112 - 535 EAST 119 STREET","0b6e3d68-31f4-ea11-b882-24ee9a37d45c",-73930528,40796889,"P.S. 112 (TANDEM M206) - MANHATTAN","535 EAST 119 STREET"
1,0,1,"7ef4a0ef-eaf6-ea11-b883-24ee9a37d459","P.S. K721 - Brooklyn Occupational Training Center - K721 - K722 - 75K721 - 64 AVENUE X","392f7d06-31f4-ea11-b882-24ee9a37d45c",-73981925,40588070,"P.S. 721 OTC - BROOKLYN","64 AVENUE X"
1,0,1,"fcae0313-32f4-ea11-b882-24ee9a37d45c","I.S. 125 Thom J. McCann Woodside - Q125 - Q125 - 24Q125 - 46-02 47 AVENUE","fdae0313-32f4-ea11-b882-24ee9a37d45c",-73918762,40740452,"I.S. 125 - QUEENS","46-02 47 AVENUE"
3,1,2,"42e61462-31f4-ea11-b882-24ee9a37d45c","P.S. 096 Joseph Lanzetta - M096 - M096 - 04M096 - 216 EAST 120 STREET","43e61462-31f4-ea11-b882-24ee9a37d45c",-73937179,40799690,"P.S. 96 - MANHATTAN","216 EAST 120 STREET"
2,1,1,"de2ff20c-32f4-ea11-b882-24ee9a37d45c","P.S. 121 Queens - Q121 - Q121 - 28Q121 - 126-10 109 AVENUE","df2ff20c-32f4-ea11-b882-24ee9a37d45c",-73815330,40683585,"P.S. 121 - QUEENS","126-10 109 AVENUE"
3,0,3,"fbce496e-31f4-ea11-b882-24ee9a37d45c","P.S. 128 Audubon - M128 - M128 - 06M128 - 560 WEST 169 STREET","f9ce496e-31f4-ea11-b882-24ee9a37d45c",-73938701,40841032,"P.S. 128 - MANHATTAN","560 WEST 169 STREET"
1,0,1,"310410ca-32f4-ea11-b882-24ee9a37d45c","P.S. 052 John C. Thompson - R052 - R052 - 31R052 - 450 BUEL AVENUE","320410ca-32f4-ea11-b882-24ee9a37d45c",-74089012,40582550,"P.S. 52 - STATEN ISLAND","450 BUEL AVENUE"
2,0,2,"97dab801-ecf6-ea11-b883-24ee9a37d459","P.S. X721 - Stephen McSweeney School - X721 - X405 - 75X721 - 3000 EAST TREMONT AVENUE","b556635c-33f4-ea11-b882-24ee9a37d45c",-73839583,40839775,"HERBERT H. LEHMAN HS - X","3000 EAST TREMONT AVENUE"
3,2,1,"7f283fb1-30f4-ea11-b882-24ee9a37d45c","P.S. 290 Juan Morel Campos - K290 - K290 - 19K290 - 135 Schenck Avenue","7e283fb1-30f4-ea11-b882-24ee9a37d45c",-73889375,40678182,"P.S. 290 - BROOKLYN","135 Schenck Avenue"
3,1,2,"ab0e6e25-32f4-ea11-b882-24ee9a37d45c","P.S. 183 Dr. Richard R. Green - Q183 - Q183 - 27Q183 - 2-45 BEACH 79 STREET","a30e6e25-32f4-ea11-b882-24ee9a37d45c",-73805866,40589220,"P.S. 183 - QUEENS","2-45 BEACH 79 STREET"
2,0,2,"56767649-31f4-ea11-b882-24ee9a37d45c","P.S. 042 Benjamin Altman - M042 - M042 - 02M042 - 71 HESTER STREET","51767649-31f4-ea11-b882-24ee9a37d45c",-73990826,40716126,"P.S. 42 - MANHATTAN","71 HESTER STREET"
1,0,1,"cf56635c-33f4-ea11-b882-24ee9a37d45c","Bronx High School of Business - X412 - X410 - 09X412 - 240 EAST 172 STREET","c856635c-33f4-ea11-b882-24ee9a37d45c",-73911366,40839307,"WILLIAM H. TAFT HS - X","240 EAST 172 STREET"
1,1,0,"f7d27c6d-30f4-ea11-b882-24ee9a37d45c","P.S. 153 Homecrest - K153 - K153 - 21K153 - 1970 HOMECREST AVENUE","f8d27c6d-30f4-ea11-b882-24ee9a37d45c",-73960027,40601179,"P.S. 153 - BROOKLYN","1970 HOMECREST AVENUE"
1,1,0,"337eed06-32f4-ea11-b882-24ee9a37d45c","P.S. 098 The Douglaston School - Q098 - Q098 - 26Q098 - 40-20 235 STREET","347eed06-32f4-ea11-b882-24ee9a37d45c",-73749998,40768906,"P.S. 98 - QUEENS","40-20 235 STREET"
2,0,2,"068b0044-33f4-ea11-b882-24ee9a37d45c","Bronx Delta School - X392 - X192 - 08X392 - 650 HOLLYWOOD AVENUE","078b0044-33f4-ea11-b882-24ee9a37d45c",-73818083,40826794,"I.S. 192 - BRONX","650 HOLLYWOOD AVENUE"
1,0,1,"c7c88e4f-31f4-ea11-b882-24ee9a37d45c","River East Elementary - M037 - M045 - 04M037 - 2351 FIRST AVENUE","c6c88e4f-31f4-ea11-b882-24ee9a37d45c",-73933740,40799265,"I.S. 45 - MANHATTAN","2351 FIRST AVENUE"
6,4,2,"6ce2635c-32f4-ea11-b882-24ee9a37d45c","Bayside High School - Q495 - Q405 - 26Q495 - 32-24 CORPORAL KENNEDY STREET","6be2635c-32f4-ea11-b882-24ee9a37d45c",-73781041,40771398,"BAYSIDE HS - Q","32-24 CORPORAL KENNEDY STREET"
1,0,1,"7de2635c-32f4-ea11-b882-24ee9a37d45c","New Visions Charter High School for the Humanities IV - Q373 - Q410 - 84Q373 - 100-00 BEACH CHANNEL DRIVE","71e2635c-32f4-ea11-b882-24ee9a37d45c",-73825317,40586012,"Beach Channel Educational Campus","100-00 BEACH CHANNEL DRIVE"
2,0,2,"419587f5-ebf6-ea11-b883-24ee9a37d459","P.S. X596 - X596 - X153 - 75X596 - 650 BAYCHESTER AVENUE","6801ce37-33f4-ea11-b882-24ee9a37d45c",-73831669,40874035,"P.S. 153 - BRONX","650 BAYCHESTER AVENUE"
1,0,1,"462f7d06-31f4-ea11-b882-24ee9a37d45c","District 20 Pre-K Center - K768 - K747 - 20K768 - 21 Bay 11th Street","472f7d06-31f4-ea11-b882-24ee9a37d45c",-74008608,40609976,"PRE-K CENTER @ 21 BAY 11TH STREET - BROOKLYN","21 Bay 11th Street"
1,0,1,"ec968d36-30f4-ea11-b882-24ee9a37d45c","P.S. 024 - K024 - K024 - 15K024 - 427 38 STREET","ed968d36-30f4-ea11-b882-24ee9a37d45c",-74004533,40652832,"P.S. 24 - BROOKLYN","427 38 STREET"
3,0,3,"0c78931f-33f4-ea11-b882-24ee9a37d45c","J.H.S. 118 William W. Niles - X118 - X118 - 10X118 - 577 EAST 179 STREET","0b78931f-33f4-ea11-b882-24ee9a37d45c",-73892482,40848702,"I.S. 118 - BRONX","577 EAST 179 STREET"
2,1,1,"f8454b50-32f4-ea11-b882-24ee9a37d45c","P.S. 377 - Q377 - Q335 - 27Q377 - 150-15 RALEIGH STREET","f4454b50-32f4-ea11-b882-24ee9a37d45c",-73836850,40668083,"Centreville Educational Building","150-15 RALEIGH STREET"
1,1,0,"26bef08c-32f4-ea11-b882-24ee9a37d45c","P.S. 199 Maurice A. Fitzgerald - Q199 - Q841 - 24Q199 - 48-25 37th Street","27bef08c-32f4-ea11-b882-24ee9a37d45c",-73928640,40739438,"P.S. 199 ANNEX - QUEENS","48-25 37th Street"
2,1,1,"56f4a0ef-eaf6-ea11-b883-24ee9a37d459","Achievement First Voyager Charter School - K876 - K092 - 84K876 - 601 PARKSIDE AVENUE","86d92255-30f4-ea11-b882-24ee9a37d45c",-73953810,40656276,"P.S. 92 - BROOKLYN","601 PARKSIDE AVENUE"
1,1,0,"920e6e25-32f4-ea11-b882-24ee9a37d45c","P.S. 174 William Sidney Mount - Q174 - Q174 - 28Q174 - 65-10 DIETERLE CRESCENT","930e6e25-32f4-ea11-b882-24ee9a37d45c",-73861462,40720583,"P.S. 174 - QUEENS","65-10 DIETERLE CRESCENT"
6,3,3,"f4201dab-30f4-ea11-b882-24ee9a37d45c","I.S. 281 Joseph B Cavallaro - K281 - K281 - 21K281 - 8787 24 AVENUE","f2201dab-30f4-ea11-b882-24ee9a37d45c",-73993565,40594648,"I.S. 281 - BROOKLYN","8787 24 AVENUE"
1,0,1,"4c5bc58c-30f4-ea11-b882-24ee9a37d45c","P.S. 214 Michael Friedsam - K214 - K214 - 19K214 - 2944 PITKIN AVENUE","4b5bc58c-30f4-ea11-b882-24ee9a37d45c",-73862961,40675881,"P.S. 214 - BROOKLYN","2944 PITKIN AVENUE"
5,5,0,"6ba5db98-30f4-ea11-b882-24ee9a37d45c","Mark Twain I.S. 239 for the Gifted & Talented - K239 - K239 - 21K239 - 2401 NEPTUNE AVENUE","6ca5db98-30f4-ea11-b882-24ee9a37d45c",-73992447,40578640,"I.S. 239 - BROOKLYN","2401 NEPTUNE AVENUE"
1,0,1,"bc689025-33f4-ea11-b882-24ee9a37d45c","Linden Tree Elementary School - X567 - X127 - 11X567 - 1560 PURDY STREET","b9689025-33f4-ea11-b882-24ee9a37d45c",-73853203,40838759,"I.S. 127 - BRONX","1560 PURDY STREET"
4,0,4,"1830f69f-ebf6-ea11-b883-24ee9a37d459","P.S. Q004 - Q004 - Q213 - 75Q004 - 231-02 67 AVENUE","f8b6c337-32f4-ea11-b882-24ee9a37d45c",-73745390,40747457,"P.S. 213 - QUEENS","231-02 67 AVENUE"
2,0,2,"61395a2c-ebf6-ea11-b883-24ee9a37d459","Sid Miller Academy - K396 - K289 - 75K396 - 900 ST MARKS AVENUE","77283fb1-30f4-ea11-b882-24ee9a37d45c",-73942401,40674244,"P.S. 289 - BROOKLYN","900 ST MARKS AVENUE"
2,0,2,"9b48b1f5-eaf6-ea11-b883-24ee9a37d459","P.S. 36 - K036 - K857 - 75K036 - 2045 Linden Boulevard","21d8cf12-31f4-ea11-b882-24ee9a37d45c",-73887195,40660465,"P.S. 36 ANNEX - BROOKLYN","2045 Linden Boulevard"
1,1,0,"370410ca-32f4-ea11-b882-24ee9a37d45c","P.S. 054 Charles W. Leng - R054 - R054 - 31R054 - 1060 WILLOWBROOK ROAD","380410ca-32f4-ea11-b882-24ee9a37d45c",-74137259,40602779,"P.S. 54 - STATEN ISLAND","1060 WILLOWBROOK ROAD"
3,1,2,"4e6e70b7-31f4-ea11-b882-24ee9a37d45c","Community Health Academy of the Heights - M346 - M814 - 06M346 - 504 WEST 158TH STREET","4f6e70b7-31f4-ea11-b882-24ee9a37d45c",-73942074,40833695,"THE COMMUNITY HEALTH ACADEMY OF THE HEIGHTS - M","504 WEST 158TH STREET"
1,0,1,"4fa10a44-32f4-ea11-b882-24ee9a37d45c","P.S./I.S. 268 - Q268 - Q268 - 29Q268 - 92-07 175 STREET","4ea10a44-32f4-ea11-b882-24ee9a37d45c",-73785210,40707648,"P.S. 268 - QUEENS","92-07 175 STREET"
1,0,1,"6a5bc58c-30f4-ea11-b882-24ee9a37d45c","J.H.S. 220 John J. Pershing - K220 - K220 - 20K220 - 4812 9TH AVENUE","695bc58c-30f4-ea11-b882-24ee9a37d45c",-74001250,40640997,"I.S. 220 - BROOKLYN","4812 9TH AVENUE"
2,1,1,"f917b7f4-32f4-ea11-b882-24ee9a37d45c","P.S. 396 - X396 - X026 - 10X396 - 1930 ANDREWS AVENUE","e917b7f4-32f4-ea11-b882-24ee9a37d45c",-73913016,40854335,"P.S. 396 - BRONX","1930 ANDREWS AVENUE"
1,1,0,"e79319d7-ebf6-ea11-b883-24ee9a37d459","The Richard H. Hungerford School - R721 - R435 - 75R721 - 465 NEW DORP LANE","fb8521d0-32f4-ea11-b882-24ee9a37d45c",-74105878,40570909,"NEW DORP HS (NEW) - S. I.","465 NEW DORP LANE"
1,0,1,"28bef08c-32f4-ea11-b882-24ee9a37d45c","P.S. 81Q Jean Paul Richter - Q081 - Q848 - 24Q081 - 511 SENECA AVENUE","29bef08c-32f4-ea11-b882-24ee9a37d45c",-73911483,40705322,"P.S. 81 ANNEX (OLD 75) - QUEENS","511 SENECA AVENUE"
3,0,3,"cc8442ee-31f4-ea11-b882-24ee9a37d45c","P.S. 033 Edward M. Funk - Q033 - Q033 - 29Q033 - 91-37 222 STREET","cd8442ee-31f4-ea11-b882-24ee9a37d45c",-73734102,40727172,"P.S. 33 - QUEENS","91-37 222 STREET"
1,1,0,"9d886843-31f4-ea11-b882-24ee9a37d45c","P.S. 011: The Sarah J. Garnet Elementary School - M011 - M011 - 02M011 - 320 WEST 21 STREET","9e886843-31f4-ea11-b882-24ee9a37d45c",-74000743,40744186,"P.S. 11 - MANHATTAN","320 WEST 21 STREET"
1,0,1,"fbf22ce2-31f4-ea11-b882-24ee9a37d45c","I.S. 010 Horace Greeley - Q010 - Q010 - 30Q010 - 45-11 31st Ave","fcf22ce2-31f4-ea11-b882-24ee9a37d45c",-73911962,40760122,"I.S. 10 - QUEENS","45-11 31st Ave"
1,0,1,"cb56635c-33f4-ea11-b882-24ee9a37d45c","DreamYard Preparatory School - X329 - X410 - 09X329 - 240 EAST 172 STREET","c856635c-33f4-ea11-b882-24ee9a37d45c",-73911366,40839307,"WILLIAM H. TAFT HS - X","240 EAST 172 STREET"
2,0,2,"b9bf14dd-ebf6-ea11-b883-24ee9a37d459","District 75 Secondary Site 75R037 (R844) - S057 - R844 -  - 200 Jefferson Blvd","8311b2e2-32f4-ea11-b882-24ee9a37d45c",-74182548,40543433,"P.S. 36 ANNEX - STATEN ISLAND","200 Jefferson Blvd"
1,0,1,"7f593c87-33f4-ea11-b882-24ee9a37d45c","P.S. X811 - X811 - X839 - 75X811 - 2040 ANTIN PL","80593c87-33f4-ea11-b882-24ee9a37d45c",-73864438,40851577,"BRONX HIGH SCHOOL FOR THE VISUAL ARTS","2040 ANTIN PL"
1,1,0,"4de61462-31f4-ea11-b882-24ee9a37d45c","Innovation Charter High School - M433 - M099 - 84M433 - 410 EAST 100 STREET","3de61462-31f4-ea11-b882-24ee9a37d45c",-73942154,40785107,"I.S. 99 - MANHATTAN","410 EAST 100 STREET"
4,0,4,"3a767649-31f4-ea11-b882-24ee9a37d45c","P.S. 028 Wright Brothers - M028 - M028 - 06M028 - 475 WEST 155 STREET","3b767649-31f4-ea11-b882-24ee9a37d45c",-73942023,40831630,"P.S. 28 - MANHATTAN","475 WEST 155 STREET"
2,0,2,"9969c231-32f4-ea11-b882-24ee9a37d45c","J.H.S. 202 Robert H. Goddard - Q202 - Q202 - 27Q202 - 138-30 LAFAYETTE STREET","9169c231-32f4-ea11-b882-24ee9a37d45c",-73845992,40670905,"I.S. 202 - QUEENS","138-30 LAFAYETTE STREET"
1,1,0,"492b3eee-30f4-ea11-b882-24ee9a37d45c","High School of Telecommunication Arts and Technology - K485 - K485 - 20K485 - 350 67 STREET","bf9c11e8-30f4-ea11-b882-24ee9a37d45c",-74023419,40636721,"TELECOM. ARTS & TECH. - K","350 67 STREET"
2,2,0,"399ebaee-32f4-ea11-b882-24ee9a37d45c","P.S. 019 Judith K. Weiss - X019 - X019 - 11X019 - 311 East 237 Street","319ebaee-32f4-ea11-b882-24ee9a37d45c",-73866949,40899351,"P.S. 19 - BRONX","311 East 237 Street"
2,2,0,"35ebaa73-30f4-ea11-b882-24ee9a37d45c","P.S. 164 Caesar Rodney - K164 - K164 - 20K164 - 4211 14 AVENUE","36ebaa73-30f4-ea11-b882-24ee9a37d45c",-73985739,40637101,"P.S. 164 - BROOKLYN","4211 14 AVENUE"
1,0,1,"76593c87-33f4-ea11-b882-24ee9a37d45c","P.S. 226 - X226 - X827 - 10X226 - 1910 Sedgwick Avenue","77593c87-33f4-ea11-b882-24ee9a37d45c",-73916076,40855822,"P.S. 226 (VAN CARPENTER) - X","1910 Sedgwick Avenue"
4,0,4,"51953aac-ebf6-ea11-b883-24ee9a37d459","The Riverview School - Q277 - Q404 - 75Q277 - 1-50 51ST AVENUE","65e2635c-32f4-ea11-b882-24ee9a37d45c",-73959183,40742964,"HUNTERS POINT CAMPUS - QUEENS","1-50 51ST AVENUE"
1,1,0,"76e2635c-32f4-ea11-b882-24ee9a37d45c","P.S. Q256 - Q256 - Q410 - 75Q256 - 100-00 BEACH CHANNEL DRIVE","71e2635c-32f4-ea11-b882-24ee9a37d45c",-73825317,40586012,"Beach Channel Educational Campus","100-00 BEACH CHANNEL DRIVE"
1,1,0,"15a6ba98-31f4-ea11-b882-24ee9a37d45c","Gramercy Arts High School - M374 - M460 - 02M374 - 40 IRVING PLACE","16a6ba98-31f4-ea11-b882-24ee9a37d45c",-73987064,40735361,"WASHINGTON IRVING HS - MANHATTAN","40 IRVING PLACE"
3,3,0,"1e06003e-32f4-ea11-b882-24ee9a37d45c","East-West School of International Studies - Q281 - Q237 - 25Q281 - 46-21 COLDEN STREET","1b06003e-32f4-ea11-b882-24ee9a37d45c",-73821402,40749430,"J.H.S. 237 - QUEENS","46-21 COLDEN STREET"
2,0,2,"100410ca-32f4-ea11-b882-24ee9a37d45c","P.S. 042 Eltingville - R042 - R042 - 31R042 - 380 GENESEE AVENUE","110410ca-32f4-ea11-b882-24ee9a37d45c",-74169038,40552213,"P.S. 42 - STATEN ISLAND","380 GENESEE AVENUE"
1,1,0,"36474313-33f4-ea11-b882-24ee9a37d45c","P.S. 094 Kings College School - X094 - X094 - 10X094 - 3530 KINGS COLLEGE PLACE","37474313-33f4-ea11-b882-24ee9a37d45c",-73875268,40880661,"P.S. 94 - BRONX","3530 KINGS COLLEGE PLACE"
2,1,1,"e09b4c1f-32f4-ea11-b882-24ee9a37d45c","P.S. 153 Maspeth Elem - Q153 - Q153 - 24Q153 - 60-02 60 LANE","e19b4c1f-32f4-ea11-b882-24ee9a37d45c",-73904463,40716296,"P.S. 153 - QUEENS","60-02 60 LANE"
1,1,0,"98a9d9c3-32f4-ea11-b882-24ee9a37d45c","P.S. 39 Francis J. Murphy Jr. - R039 - R039 - 31R039 - 99 Macfarland Avenue","99a9d9c3-32f4-ea11-b882-24ee9a37d45c",-74070610,40597824,"P.S. 39 - STATEN ISLAND","99 Macfarland Avenue"
3,1,2,"0f01adc5-83ef-eb11-b8b1-24ee9a37d45c","P.S. Q004 - Q004 - Q070 - 75Q004 - 30-44 43rd Street","7b2f77fa-31f4-ea11-b882-24ee9a37d45c",-73913964,40761762,"P.S. 70 - QUEENS","30-44 43rd Street"
1,0,1,"6034aa92-31f4-ea11-b882-24ee9a37d45c","P.S. 138 - M138 - M380 - 75M138 - 508 WEST 153RD STREET","6134aa92-31f4-ea11-b882-24ee9a37d45c",-73944846,40830415,"P.S. 380- MANHATTAN","508 WEST 153RD STREET"
1,0,1,"a932c3fb-eaf6-ea11-b883-24ee9a37d459","P.S. Q004 - Q004 - Q179 - 75Q004 - 196-25 Peck Avenue","9c0e6e25-32f4-ea11-b882-24ee9a37d45c",-73778118,40741700,"P.S. 179 - QUEENS","196-25 Peck Avenue"
1,0,1,"37767649-31f4-ea11-b882-24ee9a37d45c","P.S. 138 - M138 - M030 - 75M138 - 144-176 EAST 128 STREET","38767649-31f4-ea11-b882-24ee9a37d45c",-73935461,40805653,"P.S. 30 - MANHATTAN","144-176 EAST 128 STREET"
3,2,1,"db37fba4-31f4-ea11-b882-24ee9a37d45c","Cascades High School - M650 - M510 - 01M650 - 198 Forsyth Street","d737fba4-31f4-ea11-b882-24ee9a37d45c",-73990468,40722415,"FORSYTH HS (AUXSVC-OLD 91) - M","198 Forsyth Street"
1,0,1,"dc8521d0-32f4-ea11-b882-24ee9a37d45c","P.S. 069 Daniel D. Tompkins - R069 - R069 - 31R069 - 144 KEATING PLACE","dd8521d0-32f4-ea11-b882-24ee9a37d45c",-74157327,40591480,"P.S. 69 - STATEN ISLAND","144 KEATING PLACE"
4,2,2,"bb48b1f5-eaf6-ea11-b883-24ee9a37d459","School for Cooperative Technical Education - M645 - M646 - 79M645 - 321 East 96 Street","5e0c1bb1-31f4-ea11-b882-24ee9a37d45c",-73945647,40784112,"SCL COOP TECH ED (MNH VOC HS) - M","321 East 96 Street"
2,2,0,"6f8946f4-31f4-ea11-b882-24ee9a37d45c","P.S. 052 Queens - Q052 - Q052 - 29Q052 - 178-37 146 TERRACE","708946f4-31f4-ea11-b882-24ee9a37d45c",-73767161,40661427,"P.S. 52 - QUEENS","178-37 146 TERRACE"
1,0,1,"4d3cbf01-ebf6-ea11-b883-24ee9a37d459","P.S. R373 - R373 - R040 - 75R373 - 91 HENDERSON AVENUE","97a9d9c3-32f4-ea11-b882-24ee9a37d45c",-74095454,40641180,"P.S. 373 (OLD P40) - STATEN ISLAND","91 HENDERSON AVENUE"
2,2,0,"fa201dab-30f4-ea11-b882-24ee9a37d45c","P.S. 282 Park Slope - K282 - K282 - 13K282 - 180 6 Avenue","f8201dab-30f4-ea11-b882-24ee9a37d45c",-73977983,40676649,"P.S. 282 - BROOKLYN","180 6 Avenue"
3,1,2,"240b210d-33f4-ea11-b882-24ee9a37d45c","P.S. 076 The Bennington School - X076 - X076 - 11X076 - 900 ADEE AVENUE","250b210d-33f4-ea11-b882-24ee9a37d45c",-73860928,40869059,"P.S. 76 - BRONX","900 ADEE AVENUE"
1,0,1,"0206003e-32f4-ea11-b882-24ee9a37d45c","The Ivan Lafayette Early Childhood School of the Arts - Q228 - Q228 - 30Q228 - 32-63 93 STREET","0306003e-32f4-ea11-b882-24ee9a37d45c",-73874947,40756931,"P.S. 228 (ECC) - QUEENS","32-63 93 STREET"
1,0,1,"9201ce37-33f4-ea11-b882-24ee9a37d45c","P.S. 159 Luis Munoz Marin Biling - X159 - X159 - 10X159 - 2315 WASHINGTON AVENUE","9001ce37-33f4-ea11-b882-24ee9a37d45c",-73893136,40855680,"P.S. 159 - BRONX","2315 WASHINGTON AVENUE"
1,0,1,"6636d900-33f4-ea11-b882-24ee9a37d45c","P.S./I.S. 54 - X054 - X054 - 10X054 - 2703 WEBSTER AVENUE","6736d900-33f4-ea11-b882-24ee9a37d45c",-73887940,40864872,"P.S. 54 - BRONX","2703 WEBSTER AVENUE"
3,2,1,"340b210d-33f4-ea11-b882-24ee9a37d45c","Creston Academy - X447 - X079 - 10X447 - 125 EAST 181 STREET","2c0b210d-33f4-ea11-b882-24ee9a37d45c",-73903139,40855337,"P.S. 79 - BRONX","125 EAST 181 STREET"
1,0,1,"de21d292-30f4-ea11-b882-24ee9a37d45c","J.H.S. 223 The Montauk - K223 - K223 - 20K223 - 4200 16 AVENUE","735bc58c-30f4-ea11-b882-24ee9a37d45c",-73982424,40635100,"I.S. 223 - BROOKLYN","4200 16 AVENUE"
3,2,1,"ea21d292-30f4-ea11-b882-24ee9a37d45c","P.S. 226 Alfred De B. Mason - K226 - K226 - 21K226 - 6006 23 AVENUE","eb21d292-30f4-ea11-b882-24ee9a37d45c",-73977099,40615405,"P.S. 226 - BROOKLYN","6006 23 AVENUE"
1,0,1,"b669c231-32f4-ea11-b882-24ee9a37d45c","P.S. 209 Clearview Gardens - Q209 - Q209 - 25Q209 - 16-10 Utopia Parkway","b569c231-32f4-ea11-b882-24ee9a37d45c",-73795845,40783777,"P.S. 209 - QUEENS","16-10 Utopia Parkway"
5,3,2,"63ffcc6e-33f4-ea11-b882-24ee9a37d45c","The Bronx High School of Science - X445 - X445 - 10X445 - 75 WEST 205 STREET","64ffcc6e-33f4-ea11-b882-24ee9a37d45c",-73889011,40879958,"BRONX HS OF SCIENCE - X","75 WEST 205 STREET"
1,0,1,"e62d6c32-ebf6-ea11-b883-24ee9a37d459","P.S. K771 - K771 - K329 - 75K771 - 2929 WEST 30 STREET","11a198c3-30f4-ea11-b882-24ee9a37d45c",-73995770,40574666,"P.S. 329 - BROOKLYN","2929 WEST 30 STREET"
1,0,1,"ea77bb9f-33f4-ea11-b882-24ee9a37d45c","Bronx Arena High School - X537 - X972 - 08X537 - 1440 Story Avenue","e877bb9f-33f4-ea11-b882-24ee9a37d45c",-73881187,40820486,"SOUNDVIEW EDUCATIONAL CAMPUS - X","1440 Story Avenue"
1,0,1,"b732c3fb-eaf6-ea11-b883-24ee9a37d459","Curious Young Learners Pre-K Center - Q336 - Q473 - 27Q336 - 133-40 79TH STREET","2c02926e-32f4-ea11-b882-24ee9a37d45c",-73857176,0,"3K CENTER @ 133-40 79TH STREET - QUEENS","133-40 79TH STREET"
1,0,1,"840e6e25-32f4-ea11-b882-24ee9a37d45c","P.S. 169 Bay Terrace - Q169 - Q169 - 25Q169 - 18-25 212 STREET","820e6e25-32f4-ea11-b882-24ee9a37d45c",-73778430,40782331,"P.S. 169 - QUEENS","18-25 212 STREET"
1,1,0,"66e03d56-33f4-ea11-b882-24ee9a37d45c","P.S. 094 Kings College School - X094 - X361 - 10X094 - 268 EAST 211 STREET","67e03d56-33f4-ea11-b882-24ee9a37d45c",-73875268,40880661,"PS 94 ANNEX - BRONX","268 EAST 211 STREET"
4,3,1,"0dba8b86-30f4-ea11-b882-24ee9a37d45c","P.S. 204 Vince Lombardi - K204 - K204 - 20K204 - 8101 15 AVENUE","0eba8b86-30f4-ea11-b882-24ee9a37d45c",-74006137,40613535,"P.S. 204 - BROOKLYN","8101 15 AVENUE"
4,2,2,"418dbfcf-30f4-ea11-b882-24ee9a37d45c","Kingsborough Early College School - K468 - K400 - 21K468 - 2630 BENSON AVENUE","3a8dbfcf-30f4-ea11-b882-24ee9a37d45c",-73986313,40593028,"Lafayette Educational Campus","2630 BENSON AVENUE"
1,0,1,"2568ee1e-31f4-ea11-b882-24ee9a37d45c","P.S./I.S. 30 Mary White Ovington - K030 - K940 - 20K030 - 415 OVINGTON AVENUE","2668ee1e-31f4-ea11-b882-24ee9a37d45c",-74023036,40633710,"I.S. 30 - BROOKLYN","415 OVINGTON AVENUE"
1,0,1,"6329a44a-ebf6-ea11-b883-24ee9a37d459","Passages Academy - X695 - K932 - 79X695 - 619 BELMONT AVENUE","2368ee1e-31f4-ea11-b882-24ee9a37d45c",-73886750,40672292,"Belmont- K","619 BELMONT AVENUE"
2,0,2,"d917b7f4-32f4-ea11-b882-24ee9a37d45c","PS/MS 20 P.O.George J. Werdann, III - X020 - X020 - 10X020 - 3050 WEBSTER AVENUE","d817b7f4-32f4-ea11-b882-24ee9a37d45c",-73878731,40869482,"P.S. 20 - BRONX","3050 WEBSTER AVENUE"
3,2,1,"130410ca-32f4-ea11-b882-24ee9a37d45c","CSI High School for International Studies - R047 - R043 - 31R047 - 100 ESSEX DRIVE","a0a9d9c3-32f4-ea11-b882-24ee9a37d45c",-74159343,40581958,"JEROME PARKER CAMPUS - S.I.","100 ESSEX DRIVE"
1,1,0,"6c8946f4-31f4-ea11-b882-24ee9a37d45c","P.S. 051 - Q051 - Q051 - 27Q051 - 87-45 117 STREET","6d8946f4-31f4-ea11-b882-24ee9a37d45c",-73831532,40698286,"P.S. 51 (ECC) - QUEENS","87-45 117 STREET"
1,1,0,"e08a0044-33f4-ea11-b882-24ee9a37d45c","Bedford Park Elementary School - X077 - X177 - 10X077 - 3177 WEBSTER AVENUE","dc8a0044-33f4-ea11-b882-24ee9a37d45c",-73875375,40872559,"THE NORWOOD EAST CAMPUS - BRONX","3177 WEBSTER AVENUE"
3,2,1,"b22ff20c-32f4-ea11-b882-24ee9a37d45c","Lighthouse Elementary School - Q106 - Q106 - 27Q106 - 180 BEACH 35 STREET","b32ff20c-32f4-ea11-b882-24ee9a37d45c",-73766846,40594738,"P.S. 106 - QUEENS","180 BEACH 35 STREET"
3,3,0,"a93aa668-33f4-ea11-b882-24ee9a37d45c","Celia Cruz Bronx High School of Music, The - X442 - X430 - 10X442 - 2780 RESERVOIR AVENUE","a13aa668-33f4-ea11-b882-24ee9a37d45c",-73897066,40869061,"WALTON HS - X","2780 RESERVOIR AVENUE"
1,0,1,"aa28a20c-31f4-ea11-b882-24ee9a37d45c","P.S. 089 Cypress Hills - K089 - K814 - 19K089 - 265 WARWICK STREET","a928a20c-31f4-ea11-b882-24ee9a37d45c",-73886712,40677707,"CYPRESS HILLS COMMUNITY SCHOOL - BROOKLYN","265 WARWICK STREET"
1,1,0,"15f32ce2-31f4-ea11-b882-24ee9a37d45c","P.S. 018 Winchester - Q018 - Q018 - 26Q018 - 86-35 235 COURT","16f32ce2-31f4-ea11-b882-24ee9a37d45c",-73732290,40731853,"P.S. 18 - QUEENS","86-35 235 COURT"
3,0,3,"7d36d900-33f4-ea11-b882-24ee9a37d45c","E.S.M.T- I.S. 190 - X190 - X061 - 12X190 - 1550 CROTONA PARK EAST","7e36d900-33f4-ea11-b882-24ee9a37d45c",-73892784,40836156,"P.S. 61 - BRONX","1550 CROTONA PARK EAST"
3,3,0,"001bad3c-30f4-ea11-b882-24ee9a37d45c","Brooklyn Brownstone School - K628 - K035 - 16K628 - 272 Macdonough Street","fd1aad3c-30f4-ea11-b882-24ee9a37d45c",-73935891,40681528,"I.S. 35 - BROOKLYN","272 Macdonough Street"
2,0,2,"b348b1f5-eaf6-ea11-b883-24ee9a37d459","P.S. M094 - M094 - M276 - 75M094 - 55 BATTERY PLACE","c6e0838c-31f4-ea11-b882-24ee9a37d45c",-74017456,40706384,"P.S./I.S. 276 - MANHATTAN","55 BATTERY PLACE"
2,0,2,"91e657bd-30f4-ea11-b882-24ee9a37d45c","P.S. 506: The School of Journalism & Technology - K506 - K314 - 20K506 - 330 59 Street","8ee657bd-30f4-ea11-b882-24ee9a37d45c",-74019299,40641950,"P.S. 314 - BROOKLYN","330 59 Street"
1,1,0,"2e9ebaee-32f4-ea11-b882-24ee9a37d45c","P.S. 291 - X291 - X015 - 10X291 - 2195 ANDREWS AVENUE","219ebaee-32f4-ea11-b882-24ee9a37d45c",-73909763,40859243,"P.S. 15 - BRONX","2195 ANDREWS AVENUE"
1,0,1,"4a0d6d19-33f4-ea11-b882-24ee9a37d45c","P.S. 110 Theodore Schoenfeld - X110 - X110 - 09X110 - 580 CROTONA PARK SOUTH","420d6d19-33f4-ea11-b882-24ee9a37d45c",-73900654,40834470,"P.S. 110 - BRONX","580 CROTONA PARK SOUTH"
4,2,2,"dc0d3c5b-30f4-ea11-b882-24ee9a37d45c","P.S./I.S. 104 The Fort Hamilton School - K104 - K104 - 20K104 - 9115 5 AVENUE","dd0d3c5b-30f4-ea11-b882-24ee9a37d45c",-74028492,40618077,"P.S. 104 - BROOKLYN","9115 5 AVENUE"
3,1,2,"fb8ac007-ebf6-ea11-b883-24ee9a37d459","P.S. X721 - Stephen McSweeney School - X721 - X722 - 75X721 - 2697 WESTCHESTER AVENUE","06a31781-33f4-ea11-b882-24ee9a37d45c",-73839114,40842725,"P.S. 721 (OTC) - BRONX","2697 WESTCHESTER AVENUE"
1,0,1,"25e0d393-ebf6-ea11-b883-24ee9a37d459","P.S. Q993 - Q993 - Q130 - 75Q993 - 200-01 42 AVENUE","04af0313-32f4-ea11-b882-24ee9a37d45c",-73784009,40760219,"P.S. 130 - QUEENS","200-01 42 AVENUE"
2,2,0,"171bad3c-30f4-ea11-b882-24ee9a37d45c","P.S. 044 Marcus Garvey - K044 - K044 - 13K044 - 432 MONROE STREET","031bad3c-30f4-ea11-b882-24ee9a37d45c",-73940859,40686213,"P.S. 44 - BROOKLYN","432 MONROE STREET"
4,3,1,"01f32ce2-31f4-ea11-b882-24ee9a37d45c","P.S. 012 James B. Colgate - Q012 - Q012 - 24Q012 - 42-00 72 STREET","02f32ce2-31f4-ea11-b882-24ee9a37d45c",-73893466,40742284,"P.S. 12 - QUEENS","42-00 72 STREET"
1,0,1,"3f8dbfcf-30f4-ea11-b882-24ee9a37d45c","International High School at Lafayette - K337 - K400 - 21K337 - 2630 BENSON AVENUE","3a8dbfcf-30f4-ea11-b882-24ee9a37d45c",-73986313,40593028,"Lafayette Educational Campus","2630 BENSON AVENUE"
2,0,2,"559d7c62-33f4-ea11-b882-24ee9a37d45c","The Metropolitan Soundview High School - X521 - X420 - 12X521 - 1300 BOYNTON AVENUE","519d7c62-33f4-ea11-b882-24ee9a37d45c",-73878191,40832508,"JAMES MONROE EDUCATIONAL CAMPUS - X","1300 BOYNTON AVENUE"
1,1,0,"96d91731-31f4-ea11-b882-24ee9a37d45c","Brooklyn Urban Garden Charter School - K758 - KBNU - 84K758 - 500 19 Street","97d91731-31f4-ea11-b882-24ee9a37d45c",-73982624,40656202,"STANLEY LAMM INSTITUE PRE-SCHOOL OF LONGISLAND HO","500 19 Street"
1,1,0,"8c72c880-32f4-ea11-b882-24ee9a37d45c","Thomas A. Edison Career and Technical Education High School - Q620 - Q620 - 28Q620 - 165-65 84 AVENUE","49b4977a-32f4-ea11-b882-24ee9a37d45c",-73799692,40716071,"THOMAS A. EDISON VOC HS - Q","165-65 84 AVENUE"
1,1,0,"16ba8b86-30f4-ea11-b882-24ee9a37d45c","P.S. 207 Elizabeth G. Leary - K207 - K207 - 22K207 - 4011 FILLMORE AVENUE","17ba8b86-30f4-ea11-b882-24ee9a37d45c",-73930485,40613981,"P.S. 207 - BROOKLYN","4011 FILLMORE AVENUE"
1,0,1,"888d8486-31f4-ea11-b882-24ee9a37d45c","P.S. 200- The James McCune Smith School - M200 - M200 - 05M200 - 2589 7 AVENUE","848d8486-31f4-ea11-b882-24ee9a37d45c",-73935746,40823988,"P.S. 200 (TANDEM M010) - MANHATTAN","2589 7 AVENUE"
1,0,1,"8b11b2e2-32f4-ea11-b882-24ee9a37d45c","Staten Island School of Civic Leadership - R861 - R861 - 31R861 - 280 REGIS DRIVE","8a11b2e2-32f4-ea11-b882-24ee9a37d45c",-74164427,40620310,"ELIZABETH A. CONNELLY CAMPUS - S.I.","280 REGIS DRIVE"
1,0,1,"7ed92255-30f4-ea11-b882-24ee9a37d45c","P.S. 90 Edna Cohen School - K090 - K090 - 21K090 - 2840 WEST 12 STREET","7dd92255-30f4-ea11-b882-24ee9a37d45c",-73980387,40578192,"P.S. 90 - BROOKLYN","2840 WEST 12 STREET"
1,0,1,"ffae1f69-ebf6-ea11-b883-24ee9a37d459","P.S. M094 - M094 - M281 - 75M094 - 425 East 35 Street","cde0838c-31f4-ea11-b882-24ee9a37d45c",-73972592,40744288,"P.S. 281 - MANHATTAN","425 East 35 Street"
4,3,1,"bebfa431-33f4-ea11-b882-24ee9a37d45c","South Bronx Preparatory: A College Board School - X221 - X149 - 07X221 - 360 EAST 145 STREET","bcbfa431-33f4-ea11-b882-24ee9a37d45c",-73920851,40813612,"J.H.S. 149 - BRONX","360 EAST 145 STREET"
1,0,1,"48e61462-31f4-ea11-b882-24ee9a37d45c","P.S. 098 Shorac Kappock - M098 - M098 - 06M098 - 512 WEST 212 STREET","49e61462-31f4-ea11-b882-24ee9a37d45c",-73917814,40867741,"P.S. 98 - MANHATTAN","512 WEST 212 STREET"
2,1,1,"49953aac-ebf6-ea11-b883-24ee9a37d459","Mosaic Pre-K Center - Q331 - Q378 - 24Q331 - 46-16 76 STREET","91eb6056-32f4-ea11-b882-24ee9a37d45c",-73888242,40740084,"PRE-K CENTER @46-16 76 STREET - QUEENS","46-16 76 STREET"
1,1,0,"add810ab-31f4-ea11-b882-24ee9a37d45c","Business Of Sports School - M393 - M625 - 02M393 - 439 WEST 49TH STREET","a9d810ab-31f4-ea11-b882-24ee9a37d45c",-73990318,40763655,"HS OF GRAPHIC COMMUNICATION ARTS-M","439 WEST 49TH STREET"
3,2,1,"be56635c-33f4-ea11-b882-24ee9a37d45c","Bronx River High School - X349 - X405 - 08X349 - 3000 EAST TREMONT AVENUE","b556635c-33f4-ea11-b882-24ee9a37d45c",-73839583,40839775,"HERBERT H. LEHMAN HS - X","3000 EAST TREMONT AVENUE"
1,0,1,"4c5b4cd6-32f4-ea11-b882-24ee9a37d45c","Staten Island Technical High School - R605 - R440 - 31R605 - 485 CLAWSON STREET","4b5b4cd6-32f4-ea11-b882-24ee9a37d45c",-74117086,40568299,"STATEN ISLAND TECHNICAL HS - S.I.","485 CLAWSON STREET"
2,2,0,"bbbfa431-33f4-ea11-b882-24ee9a37d45c","The Laboratory School of Finance and Technology: X223 - X223 - X149 - 07X223 - 360 EAST 145 STREET","bcbfa431-33f4-ea11-b882-24ee9a37d45c",-73920851,40813612,"J.H.S. 149 - BRONX","360 EAST 145 STREET"
2,2,0,"f29b4c1f-32f4-ea11-b882-24ee9a37d45c","M.S. 158 Marie Curie - Q158 - Q158 - 26Q158 - 46-35 Oceania Street","f39b4c1f-32f4-ea11-b882-24ee9a37d45c",-73771878,40756562,"J.H.S. 158 - QUEENS","46-35 Oceania Street"
3,0,3,"ba56635c-33f4-ea11-b882-24ee9a37d45c","Pelham Lab High School - X320 - X405 - 08X320 - 3000 EAST TREMONT AVENUE","b556635c-33f4-ea11-b882-24ee9a37d45c",-73839583,40839775,"HERBERT H. LEHMAN HS - X","3000 EAST TREMONT AVENUE"
2,1,1,"e94356d0-48fb-ea11-b883-24ee9a37d459","Woodmere Day Care Center Inc - KCOH - KCOH -  - 927 McDonald Avenue","ea4356d0-48fb-ea11-b883-24ee9a37d459",-73977301,40631520,"Sweet Home Day Care Center","927 McDonald Avenue"
1,1,0,"bc56635c-33f4-ea11-b882-24ee9a37d45c","Schuylerville Preparatory High School - X348 - X405 - 08X348 - 3000 EAST TREMONT AVENUE","b556635c-33f4-ea11-b882-24ee9a37d45c",-73839583,40839775,"HERBERT H. LEHMAN HS - X","3000 EAST TREMONT AVENUE"
4,3,1,"c0fc24e8-31f4-ea11-b882-24ee9a37d45c","I.S. 025 Adrien Block - Q025 - Q025 - 25Q025 - 34-65 192 STREET","befc24e8-31f4-ea11-b882-24ee9a37d45c",-73789365,40764884,"J.H.S. 25 - QUEENS","34-65 192 STREET"
1,1,0,"8ba87f90-5a04-ec11-b8b4-24ee9a37d45c","Hunters Point Elementary School - Q384 - Q375 - 30Q384 - 1-35 57 Avenue","8ca87f90-5a04-ec11-b8b4-24ee9a37d45c",-73960836,40738864,"Hunters Point","1-35 57 Avenue"
1,0,1,"7a34aa92-31f4-ea11-b882-24ee9a37d45c","James Baldwin School, The: A School for Expeditionary Learning - M313 - M440 - 02M313 - 351 WEST 18 STREET","7834aa92-31f4-ea11-b882-24ee9a37d45c",-74002540,40743407,"BAYARD RUSTIN EDUCATIONAL COMP-M","351 WEST 18 STREET"
1,1,0,"45953aac-ebf6-ea11-b883-24ee9a37d459","Mosaic Pre-K Center - Q331 - Q348 - 24Q331 - 56-01 61st Street","fb454b50-32f4-ea11-b882-24ee9a37d45c",-73904289,40724967,"PRE-K CENTER @61ST STREET - QUEENS","56-01 61st Street"
2,2,0,"ddfab455-31f4-ea11-b882-24ee9a37d45c","N.Y.C. Lab School for Collaborative Studies - M412 - M070 - 02M412 - 333 WEST 17 STREET","defab455-31f4-ea11-b882-24ee9a37d45c",-74002222,40742512,"I.S. 70 - MANHATTAN","333 WEST 17 STREET"
1,1,0,"240410ca-32f4-ea11-b882-24ee9a37d45c","Naples Street Elementary School - R009 - R048 - 31R009 - 1055 Targee Street","250410ca-32f4-ea11-b882-24ee9a37d45c",-74090245,40602650,"P.S. 48 - STATEN ISLAND","1055 Targee Street"
4,1,3,"ab32c3fb-eaf6-ea11-b883-24ee9a37d459","P.S. Q224 - Q224 - Q186 - 75Q224 - 252-12 72 AVENUE","67977d2b-32f4-ea11-b882-24ee9a37d45c",-73721594,40749556,"P.S. 186 - QUEENS","252-12 72 AVENUE"
5,4,1,"b68442ee-31f4-ea11-b882-24ee9a37d45c","P.S. 026 Rufus King - Q026 - Q026 - 26Q026 - 195-02 69 AVENUE","c5fc24e8-31f4-ea11-b882-24ee9a37d45c",-73777607,40735935,"P.S. 26 - QUEENS","195-02 69 AVENUE"
3,3,0,"ff02cefa-32f4-ea11-b882-24ee9a37d45c","P.S. 036 Unionport - X036 - X036 - 08X036 - 1070 Castle Hill Avenue","0c18b7f4-32f4-ea11-b882-24ee9a37d45c",-73849791,40829480,"P.S. 36 - BRONX","1070 Castle Hill Avenue"
1,1,0,"4b6e70b7-31f4-ea11-b882-24ee9a37d45c","High School for Mathematics, Science and Engineering at City College - M692 - M812 - 05M692 - 240 CONVENT AVE","4c6e70b7-31f4-ea11-b882-24ee9a37d45c",-73950354,40820208,"HS FOR MATH, SCI & ENGINEERING-M","240 CONVENT AVE"
2,2,0,"c6b66262-32f4-ea11-b882-24ee9a37d45c","Business Technology Early College High School - Q315 - Q435 - 26Q315 - 230-17 HILLSIDE AVENUE","c4b66262-32f4-ea11-b882-24ee9a37d45c",-73739726,40733888,"MARTIN VAN BUREN HS - QUEENS","230-17 HILLSIDE AVENUE"
2,0,2,"f43159fa-30f4-ea11-b882-24ee9a37d45c","District 20 Pre-K Center - K768 - K613 - 20K768 - 369 93rd Street","f53159fa-30f4-ea11-b882-24ee9a37d45c",-74031046,40618135,"PRE-K CENTER @93RD STREET - BROOKLYN","369 93rd Street"
4,4,0,"d8e8ce00-32f4-ea11-b882-24ee9a37d45c","P.S. 079 Francis Lewis - Q079 - Q079 - 25Q079 - 147-27 15 DRIVE","d7e8ce00-32f4-ea11-b882-24ee9a37d45c",-73817338,40786201,"P.S. 79 - QUEENS","147-27 15 DRIVE"
1,0,1,"b272c880-32f4-ea11-b882-24ee9a37d45c","Robert F. Kennedy Community High School - Q670 - Q707 - 25Q670 - 75-40 PARSONS BOULEVARD","b372c880-32f4-ea11-b882-24ee9a37d45c",-73811408,40725280,"R. F. KENNEDY COMM. MIDDLE/HS-Q","75-40 PARSONS BOULEVARD"
1,0,1,"f58a0044-33f4-ea11-b882-24ee9a37d45c","The Urban Assembly Bronx Academy of Letters - X551 - X183 - 07X551 - 339 MORRIS AVENUE","ef8a0044-33f4-ea11-b882-24ee9a37d45c",-73925995,40813681,"J.H.S. 203 - BRONX","339 MORRIS AVENUE"
1,1,0,"062ed53d-33f4-ea11-b882-24ee9a37d45c","Hostos-Lincoln Academy of Science - X500 - X162 - 07X500 - 600 SAINT ANN'S AVENUE","032ed53d-33f4-ea11-b882-24ee9a37d45c",-73912038,40814857,"I.S. 162 - BRONX","600 SAINT ANN'S AVENUE"
2,1,1,"3b2682ef-ebf6-ea11-b883-24ee9a37d459","P.S. 723 - X723 - X099 - 75X723 - 1180 REV. J.A. POLITE AVE.","4a474313-33f4-ea11-b882-24ee9a37d45c",-73896925,40827539,"REV. J.A. POLITE AVE SCHOOL CAMPUS - BRONX","1180 REV. J.A. POLITE AVE."
2,2,0,"1de85c61-30f4-ea11-b882-24ee9a37d45c","Achievement First East New York Charter School - K358 - K111 - 84K358 - 35 STARR STREET","18e85c61-30f4-ea11-b882-24ee9a37d45c",-73927938,40700810,"I.S. 111 - BROOKLYN","35 STARR STREET"
1,1,0,"2bc73b4a-32f4-ea11-b882-24ee9a37d45c","P.S. 092 Harry T. Stewart Sr. - Q092 - Q292 - 30Q092 - 99-01 34 AVENUE","29c73b4a-32f4-ea11-b882-24ee9a37d45c",-73868773,40755983,"P.S. 92 - QUEENS","99-01 34 AVENUE"
3,2,1,"d60d3c5b-30f4-ea11-b882-24ee9a37d45c","P.S. 101 The Verrazano - K101 - K101 - 21K101 - 8696 24 Avenue","d70d3c5b-30f4-ea11-b882-24ee9a37d45c",-73991962,40597379,"P.S. 101 - BROOKLYN","8696 24 Avenue"
2,2,0,"47474313-33f4-ea11-b882-24ee9a37d45c","Bronx Envision Academy - X511 - X098 - 12X511 - 1619 BOSTON ROAD","3c474313-33f4-ea11-b882-24ee9a37d45c",-73890591,40836245,"I.S. 98 - BRONX","1619 BOSTON ROAD"
1,0,1,"cd8521d0-32f4-ea11-b882-24ee9a37d45c","I.S. 061 William A Morris - R061 - R061 - 31R061 - 445 CASTLETON AVENUE","460410ca-32f4-ea11-b882-24ee9a37d45c",-74097941,40634497,"I.S. 61 - STATEN ISLAND","445 CASTLETON AVENUE"
2,2,0,"fc02cefa-32f4-ea11-b882-24ee9a37d45c","P.S. 035 Franz Siegel - X035 - X035 - 09X035 - 261 EAST 163 STREET","fd02cefa-32f4-ea11-b882-24ee9a37d45c",-73917705,40828009,"P.S. 35 - BRONX","261 EAST 163 STREET"
5,3,2,"d39b4c1f-32f4-ea11-b882-24ee9a37d45c","P.S. 149 Christa McAuliffe - Q149 - Q149 - 30Q149 - 93-11 34 AVENUE","f3883319-32f4-ea11-b882-24ee9a37d45c",-73874505,40755759,"P.S. 149 - QUEENS","93-11 34 AVENUE"
1,1,0,"c979df48-30f4-ea11-b882-24ee9a37d45c","Achievement First East New York Charter School - K358 - K065 - 84K358 - 158 RICHMOND STREET","ca79df48-30f4-ea11-b882-24ee9a37d45c",-73877256,40683399,"P.S. 65 - BROOKLYN","158 RICHMOND STREET"
7,5,2,"435b4cd6-32f4-ea11-b882-24ee9a37d45c","New Dorp High School - R440 - R435 - 31R440 - 465 NEW DORP LANE","fb8521d0-32f4-ea11-b882-24ee9a37d45c",-74105878,40570909,"NEW DORP HS (NEW) - S. I.","465 NEW DORP LANE"
1,0,1,"21e85c61-30f4-ea11-b882-24ee9a37d45c","P.S. 112 Lefferts Park - K112 - K112 - 20K112 - 7115 15 AVENUE","22e85c61-30f4-ea11-b882-24ee9a37d45c",-74000565,40619417,"P.S. 112 - BROOKLYN","7115 15 AVENUE"
2,2,0,"818946f4-31f4-ea11-b882-24ee9a37d45c","P.S. 056 Harry Eichler - Q056 - Q056 - 27Q056 - 86-10 114 STREET","828946f4-31f4-ea11-b882-24ee9a37d45c",-73835735,40698989,"P.S. 56 (OLD R HILL AX) - QUEENS","86-10 114 STREET"
1,1,0,"db11f898-32f4-ea11-b882-24ee9a37d45c","Robert F. Wagner, Jr. Secondary School for Arts and Technology - Q560 - Q891 - 24Q560 - 47-07 30th Place","d911f898-32f4-ea11-b882-24ee9a37d45c",-73936442,40742217,"R. F. WAGNER SEC SCL ARTS & TECH-Q","47-07 30th Place"
1,0,1,"d3e0838c-31f4-ea11-b882-24ee9a37d45c","Urban Assembly School of Business for Young Women, the - M316 - M282 - 02M316 - 26 BROADWAY","d1e0838c-31f4-ea11-b882-24ee9a37d45c",-74013303,40705688,"BROADWAY EDUCATION CAMPUS - M","26 BROADWAY"
1,1,0,"019ebaee-32f4-ea11-b882-24ee9a37d45c","Eximius College Preparatory Academy: A College Board School - X250 - X002 - 09X250 - 1363 FULTON AVENUE","d974b6e8-32f4-ea11-b882-24ee9a37d45c",-73902794,40833884,"MORRISANIA SEC ED COMPLEX-X","1363 FULTON AVENUE"
2,0,2,"5a36d900-33f4-ea11-b882-24ee9a37d45c","Fairmont Neighborhood School - X314 - X050 - 12X314 - 1550 VYSE AVENUE","5836d900-33f4-ea11-b882-24ee9a37d45c",-73886995,40834188,"P.S. 50 - BRONX","1550 VYSE AVENUE"
2,2,0,"eace496e-31f4-ea11-b882-24ee9a37d45c","P.S. 124 Yung Wing - M124 - M124 - 02M124 - 40 DIVISION STREET","e8ce496e-31f4-ea11-b882-24ee9a37d45c",-73996017,40715097,"P.S. 124 (ECF) - MANHATTAN","40 DIVISION STREET"
3,0,3,"f89b4c1f-32f4-ea11-b882-24ee9a37d45c","P.S. 160 Walter Francis Bishop - Q160 - Q160 - 28Q160 - 109-59 INWOOD STREET","ee9b4c1f-32f4-ea11-b882-24ee9a37d45c",-73799685,40688373,"P.S. 160 - QUEENS","109-59 INWOOD STREET"
1,0,1,"d7e0a4fb-ebf6-ea11-b883-24ee9a37d459","P.S. X176 - X176 - X181 - 75X176 - 800 BAYCHESTER AVENUE","e78a0044-33f4-ea11-b882-24ee9a37d45c",-73831669,40874035,"I.S. 181 - BRONX","800 BAYCHESTER AVENUE"
3,3,0,"aefc24e8-31f4-ea11-b882-24ee9a37d45c","P.S. 021 Edward Hart - Q021 - Q021 - 25Q021 - 147-36 26 AVENUE","adfc24e8-31f4-ea11-b882-24ee9a37d45c",-73818581,40774134,"P.S. 21 - QUEENS","147-36 26 AVENUE"
2,1,1,"60b50aa5-30f4-ea11-b882-24ee9a37d45c","J.H.S. 259 William McKinley - K259 - K259 - 20K259 - 7305 Ft Hamilton Parkway","61b50aa5-30f4-ea11-b882-24ee9a37d45c",-74014633,40626089,"I.S. 259 - BROOKLYN","7305 Ft Hamilton Parkway"
1,0,1,"d3201dab-30f4-ea11-b882-24ee9a37d45c","P.S. 274 Kosciusko - K274 - K274 - 32K274 - 800 BUSHWICK AVENUE","d4201dab-30f4-ea11-b882-24ee9a37d45c",-73928180,40694179,"P.S. 274 - BROOKLYN","800 BUSHWICK AVENUE"
2,1,1,"1baf0313-32f4-ea11-b882-24ee9a37d45c","The Bellaire School - Q135 - Q135 - 29Q135 - 207-11 89 AVENUE","1caf0313-32f4-ea11-b882-24ee9a37d45c",-73757591,40720864,"P.S. 135 - QUEENS","207-11 89 AVENUE"
2,1,1,"307eed06-32f4-ea11-b882-24ee9a37d45c","P.S. 097 Forest Park - Q097 - Q097 - 27Q097 - 85-52 85 STREET","317eed06-32f4-ea11-b882-24ee9a37d45c",-73860031,40694232,"P.S. 97 - QUEENS","85-52 85 STREET"
2,2,0,"b52ff20c-32f4-ea11-b882-24ee9a37d45c","P.S. 107 Thomas A Dooley - Q107 - Q107 - 25Q107 - 167-02 45 AVENUE","b62ff20c-32f4-ea11-b882-24ee9a37d45c",-73799476,40755364,"P.S. 107 - QUEENS","167-02 45 AVENUE"
4,4,0,"7136d900-33f4-ea11-b882-24ee9a37d45c","P.S. 057 Crescent - X057 - X057 - 12X057 - 2111 CROTONA AVENUE","6c36d900-33f4-ea11-b882-24ee9a37d45c",-73888987,40848748,"P.S. 57 - BRONX","2111 CROTONA AVENUE"
3,2,1,"7407e99e-31f4-ea11-b882-24ee9a37d45c","Jacqueline Kennedy Onassis High School - M529 - M486 - 02M529 - 120 WEST 46 STREET","7507e99e-31f4-ea11-b882-24ee9a37d45c",-73983460,40757626,"J. K. ONASSIS HS FOR INT CAREERS-M","120 WEST 46 STREET"
3,1,2,"ec201dab-30f4-ea11-b882-24ee9a37d45c","Pre-K Center at Bishop Ford School Site - K863 - K280 - 15K863 - 500 19 STREET","ed201dab-30f4-ea11-b882-24ee9a37d45c",-73983116,40656952,"PRE-K CENTER @ 500 19TH STREET - BROOKLYN","500 19 STREET"
2,2,0,"83e03d56-33f4-ea11-b882-24ee9a37d45c","Morris Academy for Collaborative Studies - X297 - X400 - 09X297 - 1110 BOSTON ROAD","82e03d56-33f4-ea11-b882-24ee9a37d45c",-73903920,40827455,"MORRIS HS - X","1110 BOSTON ROAD"
1,1,0,"7c7e21a6-ebf6-ea11-b883-24ee9a37d459","P.S. Q255 - Q255 - Q260 - 75Q255 - 40-20 100TH STREET","3da10a44-32f4-ea11-b882-24ee9a37d45c",-73865787,40749175,"P.S. 307- QUEENS","40-20 100TH STREET"
3,1,2,"66e2635c-32f4-ea11-b882-24ee9a37d45c","Hunters Point Community Middle School - Q291 - Q404 - 30Q291 - 1-50 51ST AVENUE","65e2635c-32f4-ea11-b882-24ee9a37d45c",-73959183,40742964,"HUNTERS POINT CAMPUS - QUEENS","1-50 51ST AVENUE"
4,4,0,"725bc58c-30f4-ea11-b882-24ee9a37d45c","Urban Assembly School for Leadership and Empowerment - K609 - K223 - 20K609 - 4200 16 AVENUE","735bc58c-30f4-ea11-b882-24ee9a37d45c",-73982424,40635100,"I.S. 223 - BROOKLYN","4200 16 AVENUE"
2,2,0,"d90d3c5b-30f4-ea11-b882-24ee9a37d45c","P.S. 102 The Bayview - K102 - K102 - 20K102 - 211 72 STREET","da0d3c5b-30f4-ea11-b882-24ee9a37d45c",-74028758,40634318,"P.S. 102 - BROOKLYN","211 72 STREET"
6,5,1,"45e61462-31f4-ea11-b882-24ee9a37d45c","Bard High School Early College - M696 - M097 - 01M696 - 525 EAST HOUSTON STREET","46e61462-31f4-ea11-b882-24ee9a37d45c",-73976093,40718276,"BARD COLLEGE HS (OLD M097) - M","525 EAST HOUSTON STREET"
4,0,4,"9a2aa42b-33f4-ea11-b882-24ee9a37d45c","International Community High School - X334 - X139 - 07X334 - 345 BROOK AVENUE","942aa42b-33f4-ea11-b882-24ee9a37d45c",-73918774,40810314,"J.H.S. 222 - BRONX","345 BROOK AVENUE"
1,0,1,"740067b2-ebf6-ea11-b883-24ee9a37d459","Curious Young Learners Pre-K Center - Q336 - Q474 - 27Q336 - 101-20 105 STREET","2e02926e-32f4-ea11-b882-24ee9a37d45c",-73838321,40685662,"3K CENTER @ 104-06 101 AVENUE - QUEENS","101-20 105 STREET"
1,1,0,"b779df48-30f4-ea11-b882-24ee9a37d45c","P.S. 058 The Carroll - K058 - K058 - 15K058 - 330 SMITH STREET","b879df48-30f4-ea11-b882-24ee9a37d45c",-73995486,40680379,"P.S. 58 - BROOKLYN","330 SMITH STREET"
1,0,1,"ee8a0044-33f4-ea11-b882-24ee9a37d45c","P.S. 168 - X168 - X183 - 75X168 - 339 MORRIS AVENUE","ef8a0044-33f4-ea11-b882-24ee9a37d45c",-73925995,40813681,"J.H.S. 203 - BRONX","339 MORRIS AVENUE"
1,0,1,"af0e6e25-32f4-ea11-b882-24ee9a37d45c","P.S. 184 Flushing Manor - Q184 - Q184 - 25Q184 - 163-15 21 ROAD","b00e6e25-32f4-ea11-b882-24ee9a37d45c",-73799158,40778334,"P.S. 184 - QUEENS","163-15 21 ROAD"
1,0,1,"2803cefa-32f4-ea11-b882-24ee9a37d45c","P.S. 046 Edgar Allan Poe - X046 - X046 - 10X046 - 2760 BRIGGS AVENUE","2703cefa-32f4-ea11-b882-24ee9a37d45c",-73890402,40867169,"P.S. 46 - BRONX","279 EAST 196 STREET"
1,1,0,"09a198c3-30f4-ea11-b882-24ee9a37d45c","P.S. 327 Dr. Rose B. English - K327 - K327 - 23K327 - 111 BRISTOL STREET","08a198c3-30f4-ea11-b882-24ee9a37d45c",-73911788,40668232,"P.S. 327 (TANDEM K396-D75)-K","111 BRISTOL STREET"
3,3,0,"5588e6db-30f4-ea11-b882-24ee9a37d45c","New Utrecht High School - K445 - K445 - 20K445 - 1601 80 STREET","5488e6db-30f4-ea11-b882-24ee9a37d45c",-74002308,40613041,"NEW UTRECHT HS - K","1601 80 STREET"
1,0,1,"ab778cb8-ebf6-ea11-b883-24ee9a37d459","P.S. Q004 - Q004 - Q667 - 75Q004 - 24-30 SKILLMAN AVENUE","9972c880-32f4-ea11-b882-24ee9a37d45c",-73945269,40742107,"SKILLMAN HIGH SCHOOL - QUEENS","24-30 SKILLMAN AVENUE"
1,1,0,"87611579-4afb-ea11-b883-24ee9a37d459","Immanuel Genius - QBHM - QBHM -  - 253-01","88611579-4afb-ea11-b883-24ee9a37d459",-73735409,40770787,"Immanuel Genius","253-01"
1,0,1,"f717b7f4-32f4-ea11-b882-24ee9a37d45c","M.S. 390 - X390 - X026 - 10X390 - 1930 ANDREWS AVENUE","e917b7f4-32f4-ea11-b882-24ee9a37d45c",-73913016,40854335,"P.S. 396 - BRONX","1930 ANDREWS AVENUE"
3,2,1,"8c886843-31f4-ea11-b882-24ee9a37d45c","P.S. 006 Lillie D. Blake - M006 - M006 - 02M006 - 45 EAST 81 STREET","8d886843-31f4-ea11-b882-24ee9a37d45c",-73960427,40777737,"P.S. 6 - MANHATTAN","45 EAST 81 STREET"
1,1,0,"200b210d-33f4-ea11-b882-24ee9a37d45c","P.S. 75 School of Research and Discovery - X075 - X075 - 08X075 - 984 FAILE STREET","1f0b210d-33f4-ea11-b882-24ee9a37d45c",-73888948,40822314,"P.S. 75 - BRONX","984 FAILE STREET"
2,2,0,"515bc58c-30f4-ea11-b882-24ee9a37d45c","P.S. 215 Morris H. Weiss - K215 - K215 - 21K215 - 415 AVENUE S","505bc58c-30f4-ea11-b882-24ee9a37d45c",-73970171,40602722,"P.S. 215 - BROOKLYN","415 AVENUE S"
2,2,0,"ed1aad3c-30f4-ea11-b882-24ee9a37d45c","P.S. 029 John M. Harrigan - K029 - K029 - 15K029 - 425 HENRY STREET","ee1aad3c-30f4-ea11-b882-24ee9a37d45c",-73997447,40686843,"P.S. 29 - BROOKLYN","425 HENRY STREET"
5,2,3,"9eeb0e7b-33f4-ea11-b882-24ee9a37d45c","H.E.R.O. High (Health, Education, and Research Occupations High School) - X259 - X655 - 07X259 - 455 SOUTHERN BLVD","99eb0e7b-33f4-ea11-b882-24ee9a37d45c",-73907528,40810671,"SAMUEL GOMPERS VOC HS - X","455 SOUTHERN BLVD"
1,0,1,"00cf496e-31f4-ea11-b882-24ee9a37d45c","P.S. 129 John H. Finley - M129 - M129 - 05M129 - 425 WEST 130 STREET","fece496e-31f4-ea11-b882-24ee9a37d45c",-73952020,40814914,"P.S. 129 - MANHATTAN","425 WEST 130 STREET"
5,3,2,"8b01ce37-33f4-ea11-b882-24ee9a37d45c","Bronx Latin - X267 - X158 - 12X267 - 800 HOME STREET","8601ce37-33f4-ea11-b882-24ee9a37d45c",-73900593,40826933,"I.S. 158 - BRONX","800 HOME STREET"
2,1,1,"24e85c61-30f4-ea11-b882-24ee9a37d45c","M.S. 113 Ronald Edmonds Learning Center - K113 - K113 - 13K113 - 300 ADELPHI STREET","1fe85c61-30f4-ea11-b882-24ee9a37d45c",-73971474,40688769,"I.S. 113 - BROOKLYN","300 ADELPHI STREET"
1,1,0,"8f0e6e25-32f4-ea11-b882-24ee9a37d45c","P.S. 173 Fresh Meadows - Q173 - Q173 - 26Q173 - 174-10 67 AVENUE","900e6e25-32f4-ea11-b882-24ee9a37d45c",-73795651,40734097,"P.S. 173 - QUEENS","174-10 67 AVENUE"
1,1,0,"9d69c231-32f4-ea11-b882-24ee9a37d45c","P.S. 203 Oakland Gardens - Q203 - Q203 - 26Q203 - 53-11 SPRINGFIELD BOULEVARD","9e69c231-32f4-ea11-b882-24ee9a37d45c",-73759822,40753606,"P.S. 203 - QUEENS","53-11 SPRINGFIELD BOULEVARD"
5,3,2,"a53aa668-33f4-ea11-b882-24ee9a37d45c","International School for Liberal Arts - X342 - X430 - 10X342 - 2780 RESERVOIR AVENUE","a13aa668-33f4-ea11-b882-24ee9a37d45c",-73897066,40869061,"WALTON HS - X","2780 RESERVOIR AVENUE"
1,1,0,"c68442ee-31f4-ea11-b882-24ee9a37d45c","P.S. 031 Bayside - Q031 - Q031 - 26Q031 - 211-45 46 ROAD","c78442ee-31f4-ea11-b882-24ee9a37d45c",-73768994,40757701,"P.S. 31 - QUEENS","211-45 46 ROAD"
3,1,2,"2ca6ba98-31f4-ea11-b882-24ee9a37d45c","High School for Law and Public Service - M467 - M465 - 06M467 - 549 AUDUBON AVENUE","25a6ba98-31f4-ea11-b882-24ee9a37d45c",-73926060,40856532,"G. WASHINGTON HS EDUC. CAMPUS - M","549 AUDUBON AVENUE"
2,0,2,"c8bfa431-33f4-ea11-b882-24ee9a37d45c","KIPP Academy Charter School - X704 - X151 - 84X704 - 250 EAST 156 STREET","c1bfa431-33f4-ea11-b882-24ee9a37d45c",-73921140,40822574,"I.S. 151 - BRONX","250 EAST 156 STREET"
2,0,2,"11eabc42-30f4-ea11-b882-24ee9a37d45c","P.S. 046 Edward C. Blum - K046 - K046 - 13K046 - 100 CLERMONT AVENUE","1a1bad3c-30f4-ea11-b882-24ee9a37d45c",-73971644,40694530,"P.S. 46 - BROOKLYN","100 CLERMONT AVENUE"
1,0,1,"0db7c337-32f4-ea11-b882-24ee9a37d45c","P.S. 220 Edward Mandel - Q220 - Q220 - 28Q220 - 62-10 108 STREET","0eb7c337-32f4-ea11-b882-24ee9a37d45c",-73852621,40736314,"P.S. 220 - QUEENS","62-10 108 STREET"
1,1,0,"35a6ba98-31f4-ea11-b882-24ee9a37d45c","The Urban Assembly School for Green Careers - M402 - M470 - 03M402 - 145 WEST 84 STREET","33a6ba98-31f4-ea11-b882-24ee9a37d45c",-73974483,40786134,"LOUIS D. BRANDEIS HS - MANHATTAN","145 WEST 84 STREET"
3,2,1,"c056635c-33f4-ea11-b882-24ee9a37d45c","Herbert H. Lehman High School - X405 - X405 - 08X405 - 3000 EAST TREMONT AVENUE","b556635c-33f4-ea11-b882-24ee9a37d45c",-73839583,40839775,"HERBERT H. LEHMAN HS - X","3000 EAST TREMONT AVENUE"
4,1,3,"cd315367-30f4-ea11-b882-24ee9a37d45c","P.S. 127 Mckinley Park - K127 - K127 - 20K127 - 7805 7 Avenue","ce315367-30f4-ea11-b882-24ee9a37d45c",-74018429,40623687,"P.S. 127 - BROOKLYN","7805 7 Avenue"
2,1,1,"a369c231-32f4-ea11-b882-24ee9a37d45c","Energy Tech High School - Q258 - Q204 - 30Q258 - 36-41 28 STREET","9c69c231-32f4-ea11-b882-24ee9a37d45c",-73932628,40756471,"I.S. 204 - QUEENS","36-41 28 STREET"
2,1,1,"848946f4-31f4-ea11-b882-24ee9a37d45c","P.S. 58 - The School of Heroes - Q058 - Q058 - 24Q058 - 72-24 GRAND AVENUE","808946f4-31f4-ea11-b882-24ee9a37d45c",-73890638,40728517,"P.S. 58 - QUEENS","72-24 GRAND AVENUE"
2,1,1,"bb3aa668-33f4-ea11-b882-24ee9a37d45c","Bronx High School for Law and Community Service - X439 - X435 - 10X439 - 500 EAST FORDHAM ROAD","b03aa668-33f4-ea11-b882-24ee9a37d45c",-73888625,40859466,"THEODORE ROOSEVELT EDUCATIONAL CAMPUS - X","500 EAST FORDHAM ROAD"
1,1,0,"5d9f4974-31f4-ea11-b882-24ee9a37d45c","P.S. 153 Adam Clayton Powell - M153 - M153 - 06M153 - 1750 AMSTERDAM AVENUE","589f4974-31f4-ea11-b882-24ee9a37d45c",-73947599,40826514,"P.S. 153 - MANHATTAN","1750 AMSTERDAM AVENUE"
2,1,1,"3268ee1e-31f4-ea11-b882-24ee9a37d45c","School of Math, Science, and Healthy Living - K971 - K971 - 20K971 - 6214 4TH AVENUE","3368ee1e-31f4-ea11-b882-24ee9a37d45c",-74020343,40639518,"P.S. 971 - BROOKLYN","6214 4TH AVENUE"
1,0,1,"5d611579-4afb-ea11-b883-24ee9a37d459","MARBLE HILL NURSERY SCHOOL - XAOU - XAOU -  - 5480 BROADWAY","5e611579-4afb-ea11-b883-24ee9a37d459",-73908101,40874703,"MARBLE HILL NURSERY SCHOOL","5480 BROADWAY"
2,0,2,"47416e00-31f4-ea11-b882-24ee9a37d45c","Success Academy Charter School - Bushwick - K882 - K677 - 84K882 - 139 MENAHAN STREET","48416e00-31f4-ea11-b882-24ee9a37d45c",-73919653,40695975,"P.S. 677 - BROOKLYN","139 MENAHAN STREET"
2,0,2,"68977d2b-32f4-ea11-b882-24ee9a37d45c","P.S. 186 Castlewood - Q186 - Q186 - 26Q186 - 252-12 72 AVENUE","67977d2b-32f4-ea11-b882-24ee9a37d45c",-73721594,40749556,"P.S. 186 - QUEENS","252-12 72 AVENUE"
2,0,2,"613cbf01-ebf6-ea11-b883-24ee9a37d459","Success Academy Charter School - Bronx 3 - X380 - X145 - 84X380 - 1000 TELLER AVENUE","9abfa431-33f4-ea11-b882-24ee9a37d45c",-73914067,40827438,"I.S. 145 - BRONX","1000 TELLER AVENUE"
2,2,0,"02cf496e-31f4-ea11-b882-24ee9a37d45c","Pace High School - M298 - M131 - 02M298 - 100 HESTER STREET","03cf496e-31f4-ea11-b882-24ee9a37d45c",-73993607,40716231,"I.S. 131 - MANHATTAN","100 HESTER STREET"
2,2,0,"90bc9674-32f4-ea11-b882-24ee9a37d45c","Hillcrest High School - Q505 - Q505 - 28Q505 - 160-05 HIGHLAND AVENUE","8fbc9674-32f4-ea11-b882-24ee9a37d45c",-73803001,40709461,"HILLCREST HS - Q","160-05 HIGHLAND AVENUE"
1,0,1,"cd689025-33f4-ea11-b882-24ee9a37d45c","Success Academy Charter School - Bronx 4 - X464 - X131 - 84X464 - 885 Bolton Avenue","c8689025-33f4-ea11-b882-24ee9a37d45c",-73859998,40822925,"I.S. 131 - BRONX","885 Bolton Avenue"
6,3,3,"cbe8ce00-32f4-ea11-b882-24ee9a37d45c","I.S. 73 - The Frank Sansivieri Intermediate School - Q073 - Q073 - 24Q073 - 70-02 54 AVENUE","cce8ce00-32f4-ea11-b882-24ee9a37d45c",-73893318,40728558,"I.S. 73 - QUEENS","70-02 54 AVENUE"
1,0,1,"c148b1f5-eaf6-ea11-b883-24ee9a37d459","Restart Academy - M973 - M834 -  - 444 WEST 56 STREET","5d6e70b7-31f4-ea11-b882-24ee9a37d45c",-73988610,40767848,"HS FOR ENVIRONMENTAL STUDIES - M","444 WEST 56 STREET"
1,1,0,"b7b36d80-30f4-ea11-b882-24ee9a37d45c","P.S. K231 - K231 - K180 - 75K231 - 5601 16 AVENUE","b8b36d80-30f4-ea11-b882-24ee9a37d45c",-73989250,40626454,"P.S. 180 - BROOKLYN","5601 16 AVENUE"
2,0,2,"1168ee1e-31f4-ea11-b882-24ee9a37d45c","P.S. 373 - Brooklyn Transition Center - K373 - K909 - 75K373 - 561 GRAND AVENUE","1268ee1e-31f4-ea11-b882-24ee9a37d45c",-73961636,40678591,"ACORN COMMUNITY HS - K","561 GRAND AVENUE"
1,0,1,"e83159fa-30f4-ea11-b882-24ee9a37d45c","Clara Barton High School - K600 - K600 - 17K600 - 901 CLASSON AVENUE","e13159fa-30f4-ea11-b882-24ee9a37d45c",-73960689,40669805,"CLARA BARTON HS - K","901 CLASSON AVENUE"
3,2,1,"1bb7c337-32f4-ea11-b882-24ee9a37d45c","Waterside Children's Studio School - Q317 - Q225 - 27Q317 - 190 BEACH 110 STREET","19b7c337-32f4-ea11-b882-24ee9a37d45c",-73831090,40580907,"P.S. 225 - QUEENS","190 BEACH 110 STREET"
1,1,0,"da9b4c1f-32f4-ea11-b882-24ee9a37d45c","P.S. 151 Mary D. Carter - Q151 - Q151 - 30Q151 - 50-05 31 AVENUE","db9b4c1f-32f4-ea11-b882-24ee9a37d45c",-73908146,40758027,"P.S. 151 - QUEENS","50-05 31 AVENUE"
1,0,1,"afeb6056-32f4-ea11-b882-24ee9a37d45c","New Visions Charter High School for Advanced Math and Science IV - Q320 - Q400 - 84Q320 - 156-10 BAISLEY BOULEVARD","a9eb6056-32f4-ea11-b882-24ee9a37d45c",-73782684,40673949,"AUGUST MARTIN HS - QUEENS","156-10 BAISLEY BOULEVARD"
4,4,0,"9d476368-32f4-ea11-b882-24ee9a37d45c","Queens High School for Language Studies - Q241 - Q460 - 25Q241 - 35-01 UNION STREET","97476368-32f4-ea11-b882-24ee9a37d45c",-73826811,40764892,"FLUSHING HS - Q","35-01 UNION STREET"
1,0,1,"57042f6f-ebf6-ea11-b883-24ee9a37d459","Success Academy Charter School - Harlem 1 - M351 - M620 - 84M351 - 111 EAST 33RD STREET","a0d810ab-31f4-ea11-b882-24ee9a37d45c",-73981070,40746510,"NORMAN THOMAS HS (ECF) - MANHATTAN","111 EAST 33RD STREET"
1,1,0,"0baf0313-32f4-ea11-b882-24ee9a37d45c","P.S. 130 - Q130 - Q130 - 25Q130 - 200-01 42 AVENUE","04af0313-32f4-ea11-b882-24ee9a37d45c",-73784009,40760219,"P.S. 130 - QUEENS","200-01 42 AVENUE"
1,0,1,"92283fb1-30f4-ea11-b882-24ee9a37d45c","Success Academy Charter School - Cobble Hill - K129 - K293 - 84K129 - 284 Baltic Street","91283fb1-30f4-ea11-b882-24ee9a37d45c",-73993293,40685006,"J.H.S. 293 - BROOKLYN","284 Baltic Street"
1,0,1,"fde1abc9-30f4-ea11-b882-24ee9a37d45c","P.S. 156 Waverly - K156 - K356 - 23K156 - 104 SUTTER AVENUE","35a198c3-30f4-ea11-b882-24ee9a37d45c",-73917880,40665553,"P.S. 156 - BROOKLYN","104 SUTTER AVENUE"
2,0,2,"e2ce496e-31f4-ea11-b882-24ee9a37d45c","Success Academy Charter School - Harlem 5 - M482 - M123 - 84M482 - 301 WEST 140 STREET","e3ce496e-31f4-ea11-b882-24ee9a37d45c",-73944551,40820216,"P.S. 123 - MANHATTAN","301 WEST 140 STREET"
1,1,0,"22416e00-31f4-ea11-b882-24ee9a37d45c","Academy for Health Careers - K751 - K625 - 17K751 - 150 ALBANY AVENUE","23416e00-31f4-ea11-b882-24ee9a37d45c",-73939282,40675905,"ROBESON HS COMP&BUS TC (A HML)-K","150 ALBANY AVENUE"
1,0,1,"8a03194f-30f4-ea11-b882-24ee9a37d45c","Success Academy Charter School - Bergen Beach - K781 - K078 - 84K781 - 1420 EAST 68 STREET","8b03194f-30f4-ea11-b882-24ee9a37d45c",-73912914,40620537,"I.S. 78 - BROOKLYN","1420 EAST 68 STREET"
1,0,1,"d59319d7-ebf6-ea11-b883-24ee9a37d459","P.S. R373 - R373 - R058 - 75R373 - 77 MARSH AVENUE","2a0410ca-32f4-ea11-b882-24ee9a37d45c",-74160867,40582791,"P.S. 58 - STATEN ISLAND","77 MARSH AVENUE"
3,3,0,"75d92255-30f4-ea11-b882-24ee9a37d45c","J.H.S. 088 Peter Rouget - K088 - K088 - 15K088 - 544 7TH AVENUE","76d92255-30f4-ea11-b882-24ee9a37d45c",-73988743,40660805,"I.S. 88 - BROOKLYN","544 7TH AVENUE"
1,1,0,"92977d2b-32f4-ea11-b882-24ee9a37d45c","P.S. 197 The Ocean School - Q197 - Q197 - 27Q197 - 825 HICKSVILLE ROAD","93977d2b-32f4-ea11-b882-24ee9a37d45c",-73744128,40599664,"P.S. 197 - QUEENS","825 HICKSVILLE ROAD"
1,1,0,"2302926e-32f4-ea11-b882-24ee9a37d45c","High School for Community Leadership - Q328 - Q470 - 28Q328 - 167-01 GOTHIC DRIVE","1f02926e-32f4-ea11-b882-24ee9a37d45c",-73798658,40714551,"JAMAICA HS - Q","167-01 GOTHIC DRIVE"
3,2,1,"09e0ede7-49fb-ea11-b883-24ee9a37d459","Williamsburg Y Head Start - KBWW - KBUN -  - 64 Division Avenue","0ae0ede7-49fb-ea11-b883-24ee9a37d459",0,0,"Williamsburg Y Head Start","64 Division Avenue"
1,0,1,"72e2635c-32f4-ea11-b882-24ee9a37d45c","District 25 PRE-K Center - Q409 - Q409 - 25Q409 - 14-45 143rd Street","73e2635c-32f4-ea11-b882-24ee9a37d45c",-73826154,40785787,"DDC UPK CENTER @143RD STREET - QUEENS","14-45 143rd Street"
2,1,1,"2102926e-32f4-ea11-b882-24ee9a37d45c","Queens Collegiate: A College Board School - Q310 - Q470 - 28Q310 - 167-01 GOTHIC DRIVE","1f02926e-32f4-ea11-b882-24ee9a37d45c",-73798658,40714551,"JAMAICA HS - Q","167-01 GOTHIC DRIVE"
19,13,6,"2ee61462-31f4-ea11-b882-24ee9a37d45c","KIPP NYC Washington Heights Academy Charter School - M068 - M090 - 84M068 - 21 JUMEL PLACE","2ce61462-31f4-ea11-b882-24ee9a37d45c",-73935815,40839139,"I.S. 90 - MANHATTAN","21 JUMEL PLACE"
4,2,2,"e68521d0-32f4-ea11-b882-24ee9a37d45c","I.S. 075 Frank D. Paulo - R075 - R075 - 31R075 - 455 HUGUENOT AVENUE","e28521d0-32f4-ea11-b882-24ee9a37d45c",-74197033,40544535,"I.S. 75 - STATEN ISLAND","455 HUGUENOT AVENUE"
2,1,1,"a5edf392-32f4-ea11-b882-24ee9a37d45c","Joseph F. Quinn Intermediate School 77 - Q077 - Q849 - 24Q077 - 976 Seneca Avenue","a4edf392-32f4-ea11-b882-24ee9a37d45c",-73902147,40699101,"I.S. 77 - QUEENS","976 Seneca Avenue"
2,0,2,"480b210d-33f4-ea11-b882-24ee9a37d45c","P.S. X811 - X811 - X084 - 75X811 - 1434 Longfellow Avenue","490b210d-33f4-ea11-b882-24ee9a37d45c",-73886798,40830552,"P.S. 811 (OLD I84) - BRONX","1434 Longfellow Avenue"
5,3,2,"e377bb9f-33f4-ea11-b882-24ee9a37d45c","Urban Assembly School for Applied Math and Science, The - X241 - X970 - 09X241 - 1595 BATHGATE AVENUE","e177bb9f-33f4-ea11-b882-24ee9a37d45c",-73901774,40839508,"BATHGATE HS - BRONX","1595 BATHGATE AVENUE"
3,0,3,"d6d27c6d-30f4-ea11-b882-24ee9a37d45c","P.S. 145 Andrew Jackson - K145 - K145 - 32K145 - 100 NOLL STREET","d7d27c6d-30f4-ea11-b882-24ee9a37d45c",-73932388,40701107,"P.S. 145 - BROOKLYN","100 NOLL STREET"
1,1,0,"502f7d06-31f4-ea11-b882-24ee9a37d45c","The Maurice Sendak Community School - K118 - K763 - 15K118 - 211 8TH STREET","512f7d06-31f4-ea11-b882-24ee9a37d45c",-73987602,40671145,"P.S. 118 MAURICE SENDAK COMMUNITY SCHOOL- BROOKLYN","211 8TH STREET"
1,1,0,"1ca6ba98-31f4-ea11-b882-24ee9a37d45c","International High School at Union Square - M438 - M460 - 02M438 - 40 IRVING PLACE","16a6ba98-31f4-ea11-b882-24ee9a37d45c",-73987064,40735361,"WASHINGTON IRVING HS - MANHATTAN","40 IRVING PLACE"
1,1,0,"29e61462-31f4-ea11-b882-24ee9a37d45c","P.S. 89 - M089 - M089 - 02M089 - 201 WARREN STREET","9741e65b-31f4-ea11-b882-24ee9a37d45c",-74013967,40717010,"P.S./I.S. 89 - MANHATTAN","201 WARREN STREET"
1,1,0,"c762c807-f014-ec11-b8b5-24ee9a37d45c","Restart Academy - M973 - M025 -  - 145 Stanton Street","29767649-31f4-ea11-b882-24ee9a37d45c",-73986038,40720040,"J.H.S. 25 - MANHATTAN","145 Stanton Street"
2,0,2,"277eed06-32f4-ea11-b882-24ee9a37d45c","P.S. 094 David D. Porter - Q094 - Q094 - 26Q094 - 41-77 Little Neck Parkway","287eed06-32f4-ea11-b882-24ee9a37d45c",-73738703,40771258,"P.S. 94 - QUEENS","41-77 Little Neck Parkway"
1,0,1,"ad48b1f5-eaf6-ea11-b883-24ee9a37d459","Girls Preparatory Charter School of New York - M330 - M188 - 84M330 - 442 EAST HOUSTON STREET","4b507380-31f4-ea11-b882-24ee9a37d45c",-73977380,40719888,"P.S. 188 - MANHATTAN","442 EAST HOUSTON STREET"
3,2,1,"d611f898-32f4-ea11-b882-24ee9a37d45c","Renaissance Charter School - Q705 - Q885 - 84Q705 - 35-59 81ST STREET","d511f898-32f4-ea11-b882-24ee9a37d45c",-73884817,40749934,"RENAISSANCE CHARTER SCHOOL - Q","35-59 81ST STREET"
2,1,1,"12af1f69-ebf6-ea11-b883-24ee9a37d459","District 2 Pre-K Center - M391 - M474 - 02M391 - 252 EAST 57 STREET","41a6ba98-31f4-ea11-b882-24ee9a37d45c",-73965878,40759081,"PRE-K CENTER @ EAST 57 STREET - MANHATTAN","252 EAST 57 STREET"
1,1,0,"3c02eeff-49fb-ea11-b883-24ee9a37d459","Worldtots - 6 Avenue - KCRY - KCHV -  - 5015 6th Avenue","3d02eeff-49fb-ea11-b883-24ee9a37d459",-74008253,40643640,"New York Creative Childcare","5015 6th Avenue"
7,2,5,"40b4977a-32f4-ea11-b882-24ee9a37d45c","Queens Technical High School - Q600 - Q600 - 24Q600 - 37-02 47 AVENUE","41b4977a-32f4-ea11-b882-24ee9a37d45c",-73927995,40741658,"QUEENS VOC HS - Q","37-02 47 AVENUE"
2,2,0,"9f6b4ae9-ea40-ec11-b8c3-24ee9a37d45c","KIPP Bronx Charter School II - X616 - XCHO - 84X616 - 501 Gerard Avenue","a06b4ae9-ea40-ec11-b8c3-24ee9a37d45c",-73929502,40818347,"501 Gerard Avenue","501 Gerard Avenue"
11,11,0,"f5454b50-32f4-ea11-b882-24ee9a37d45c","P.S. 376 - Q376 - Q332 - 26Q376 - 210-21 48 AVENUE","f6454b50-32f4-ea11-b882-24ee9a37d45c",-73770314,40754954,"Bayside Hills School of Excellence","210-21 48 AVENUE"
2,2,0,"f9ae0313-32f4-ea11-b882-24ee9a37d45c","P.S. 124 Osmond A Church - Q124 - Q124 - 27Q124 - 129-15 150 AVENUE","faae0313-32f4-ea11-b882-24ee9a37d45c",-73811266,40665669,"P.S. 124 - QUEENS","129-15 150 AVENUE"
2,1,1,"57ebaa73-30f4-ea11-b882-24ee9a37d45c","Ralph A. Fabrizio School - K170 - K170 - 20K170 - 619 72ND STREET","58ebaa73-30f4-ea11-b882-24ee9a37d45c",-74018719,40630373,"P.S. 170 - BROOKLYN","619 72ND STREET"
1,1,0,"f32ece86-32f4-ea11-b882-24ee9a37d45c","Queens High School for the Sciences at York College - Q687 - Q774 - 28Q687 - 94-50 159 Street","f42ece86-32f4-ea11-b882-24ee9a37d45c",-73798364,40700884,"QUEENS HIGH SCHOOL FOR THE SCIENCES","94-50 159 Street"
2,2,0,"bf315367-30f4-ea11-b882-24ee9a37d45c","P.S. 123 Suydam - K123 - K123 - 32K123 - 100 IRVING AVENUE","bb315367-30f4-ea11-b882-24ee9a37d45c",-73922388,40704076,"P.S. 123 - BROOKLYN","100 IRVING AVENUE"
2,1,1,"bd0d3c5b-30f4-ea11-b882-24ee9a37d45c","P.S. 094 The Henry Longfellow - K094 - K094 - 15K094 - 5010 6 AVENUE","8fd92255-30f4-ea11-b882-24ee9a37d45c",-74008795,40643730,"P.S. 94 - BROOKLYN","5010 6 AVENUE"
3,0,3,"69fdc1bd-32f4-ea11-b882-24ee9a37d45c","P.S. 022 Graniteville - R022 - R022 - 31R022 - 1860 Forest Avenue","6afdc1bd-32f4-ea11-b882-24ee9a37d45c",-74150544,40624847,"P.S. 22 - STATEN ISLAND","1860 Forest Avenue"
5,5,0,"b3120b25-31f4-ea11-b882-24ee9a37d45c","Bedford Academy High School - K595 - K994 - 13K595 - 1119 BEDFORD AVENUE","b4120b25-31f4-ea11-b882-24ee9a37d45c",-73953692,40685486,"Bedford Academy - Brooklyn","1119 BEDFORD AVENUE"
1,1,0,"fa1aad3c-30f4-ea11-b882-24ee9a37d45c","P.S. 034 Oliver H. Perry - K034 - K034 - 14K034 - 131 NORMAN AVENUE","f91aad3c-30f4-ea11-b882-24ee9a37d45c",-73949756,40726378,"P.S. 34 - BROOKLYN","131 NORMAN AVENUE"
2,0,2,"9641e65b-31f4-ea11-b882-24ee9a37d45c","I.S. 289 - M289 - M089 - 02M289 - 201 WARREN STREET","9741e65b-31f4-ea11-b882-24ee9a37d45c",-74013967,40717010,"P.S./I.S. 89 - MANHATTAN","201 WARREN STREET"
2,2,0,"cdfab455-31f4-ea11-b882-24ee9a37d45c","Neighborhood School - M363 - M063 - 01M363 - 121 EAST 3 STREET","cefab455-31f4-ea11-b882-24ee9a37d45c",-73986214,40724440,"P.S. 63 - MANHATTAN","121 EAST 3 STREET"
1,1,0,"d4f57030-30f4-ea11-b882-24ee9a37d45c","The Emily Warren Roebling School - K008 - K008 - 13K008 - 37 HICKS STREET","d5f57030-30f4-ea11-b882-24ee9a37d45c",-73992841,40700709,"P.S. 8 - BROOKLYN","37 HICKS STREET"
1,0,1,"daf57030-30f4-ea11-b882-24ee9a37d45c","Magnet School of Math, Science and Design Technology - K010 - K010 - 15K010 - 511 7 AVENUE","dbf57030-30f4-ea11-b882-24ee9a37d45c",-73985946,40660912,"P.S. 10 - BROOKLYN","511 7 AVENUE"
2,1,1,"4b71bd14-8b23-ed11-b0a2-088e901ef405","The East Village Community School - M315 - M019 - 01M315 - 185 1 AVENUE","2b767649-31f4-ea11-b882-24ee9a37d45c",-73984496,40730009,"P.S. 19 - MANHATTAN","185 1 AVENUE"
2,2,0,"818d8486-31f4-ea11-b882-24ee9a37d45c","P.S. 77 Lower Lab School - M077 - M198 - 02M077 - 1700 3 AVENUE","7f8d8486-31f4-ea11-b882-24ee9a37d45c",-73950420,40785018,"P.S. 198 - MANHATTAN","1700 3 AVENUE"
1,0,1,"858d8486-31f4-ea11-b882-24ee9a37d45c","P.S. 199 Jessie Isador Straus - M199 - M199 - 03M199 - 270 WEST 70 STREET","868d8486-31f4-ea11-b882-24ee9a37d45c",-73984423,40777603,"P.S. 199 - MANHATTAN","270 WEST 70 STREET"
1,1,0,"b82ff20c-32f4-ea11-b882-24ee9a37d45c","P.S. 108 Captain Vincent G. Fowler - Q108 - Q108 - 27Q108 - 108-10 109 AVENUE","b92ff20c-32f4-ea11-b882-24ee9a37d45c",-73831025,40679083,"P.S. 108 - QUEENS","108-10 109 AVENUE"
19,13,6,"fbfb3df4-30f4-ea11-b882-24ee9a37d45c","Edward R. Murrow High School - K525 - K525 - 21K525 - 1600 AVENUE L","fafb3df4-30f4-ea11-b882-24ee9a37d45c",-73959141,40619671,"EDWARD R. MURROW HS - K","1600 AVENUE L"
7,4,3,"d2b66262-32f4-ea11-b882-24ee9a37d45c","Forest Hills High School - Q440 - Q440 - 28Q440 - 67-01 110 STREET","d3b66262-32f4-ea11-b882-24ee9a37d45c",-73843972,40730017,"FOREST HILLS HS - Q","67-01 110 STREET"
1,0,1,"620c1bb1-31f4-ea11-b882-24ee9a37d45c","The Judith S. Kaye School - M310 - M646 - 04M310 - 321 East 96 Street","5e0c1bb1-31f4-ea11-b882-24ee9a37d45c",-73945647,40784112,"SCL COOP TECH ED (MNH VOC HS) - M","321 East 96 Street"
2,2,0,"8b476368-32f4-ea11-b882-24ee9a37d45c","Newtown High School - Q455 - Q455 - 24Q455 - 48-01 90 STREET","8c476368-32f4-ea11-b882-24ee9a37d45c",-73874129,40740824,"NEWTOWN HS - Q","48-01 90 STREET"
1,0,1,"ea09e2e1-30f4-ea11-b882-24ee9a37d45c","PROGRESS High School for Professional Careers - K474 - K450 - 14K474 - 850 GRAND STREET","e909e2e1-30f4-ea11-b882-24ee9a37d45c",-73938921,40711134,"GRAND STREET CAMPUS (OLD E.D.HS)- K","850 GRAND STREET"
2,0,2,"1378931f-33f4-ea11-b882-24ee9a37d45c","P.S. X188 - X188 - X120 - 75X188 - 890 CAULDWELL AVENUE","1478931f-33f4-ea11-b882-24ee9a37d45c",-73906739,40822291,"I.S. 301 - BRONX","890 CAULDWELL AVENUE"
1,0,1,"f302cefa-32f4-ea11-b882-24ee9a37d45c","P.S. 032 Belmont - X032 - X032 - 10X032 - 690 EAST 183 STREET","f402cefa-32f4-ea11-b882-24ee9a37d45c",-73886220,40851724,"P.S. 32 - BRONX","690 EAST 183 STREET"
1,1,0,"31e61462-31f4-ea11-b882-24ee9a37d45c","M.S. 319 - Maria Teresa - M319 - M090 - 06M319 - 21 JUMEL PLACE","2ce61462-31f4-ea11-b882-24ee9a37d45c",-73935815,40839139,"I.S. 90 - MANHATTAN","21 JUMEL PLACE"
2,1,1,"e437fba4-31f4-ea11-b882-24ee9a37d45c","Urban Assembly Maker Academy - M282 - M520 - 02M282 - 411 PEARL STREET","e037fba4-31f4-ea11-b882-24ee9a37d45c",-74000851,40711441,"MURRY BERGTRAUM HS (ECF) - M","411 PEARL STREET"
1,0,1,"465d0a12-4afb-ea11-b883-24ee9a37d459","MISSION OF THE IMMACULATE VIRGIN - RAFS - RAFS -  - 6581 HYLAN BOULEVARD","475d0a12-4afb-ea11-b883-24ee9a37d459",-74218688,40512019,"MISSION OF THE IMMACULATE VIRGIN","6581 HYLAN BOULEVARD"
2,2,0,"47fdc1bd-32f4-ea11-b882-24ee9a37d45c","P.S. 8 Shirlee Solomon - R008 - R008 - 31R008 - 112 LINDENWOOD ROAD","48fdc1bd-32f4-ea11-b882-24ee9a37d45c",-74152212,40547567,"P.S. 8 - STATEN ISLAND","112 LINDENWOOD ROAD"
1,1,0,"f83159fa-30f4-ea11-b882-24ee9a37d45c","Transit Tech Career and Technical Education High School - K615 - K615 - 19K615 - 1 WELLS STREET","f93159fa-30f4-ea11-b882-24ee9a37d45c",-73875328,40678780,"E NY VOC HS OF TRANSIT TECH.-K","1 WELLS STREET"
1,0,1,"86e657bd-30f4-ea11-b882-24ee9a37d45c","P.S. 312 Bergen Beach - K312 - K312 - 22K312 - 7103 Avenue T","87e657bd-30f4-ea11-b882-24ee9a37d45c",-73909554,40622442,"P.S. 312 - BROOKLYN","7103 Avenue T"
2,1,1,"07fc3df4-30f4-ea11-b882-24ee9a37d45c","John Dewey High School - K540 - K540 - 21K540 - 50 AVENUE X","05fc3df4-30f4-ea11-b882-24ee9a37d45c",-73981925,40588070,"JOHN DEWEY HS - K","50 AVENUE X"
1,1,0,"9672c880-32f4-ea11-b882-24ee9a37d45c","High School for Construction Trades, Engineering and Architecture - Q650 - Q650 - 27Q650 - 94-06 104TH STREET","8f72c880-32f4-ea11-b882-24ee9a37d45c",-73841475,40689177,"HS FOR CONST.TRADES,ENGG.,& ARCH-Q","94-06 104TH STREET"
1,1,0,"1ea6ba98-31f4-ea11-b882-24ee9a37d45c","Union Square Academy for Health Sciences - M533 - M460 - 02M533 - 40 IRVING PLACE","16a6ba98-31f4-ea11-b882-24ee9a37d45c",-73987064,40735361,"WASHINGTON IRVING HS - MANHATTAN","40 IRVING PLACE"
1,1,0,"018bc007-ebf6-ea11-b883-24ee9a37d459","Bronx Charter School for Better Learning - X718 - X937 - 84X718 - 3740 BAYCHESTER AVENUE","20497593-33f4-ea11-b882-24ee9a37d45c",-73839288,40884371,"BX CHARTER SCH FOR BETTER LRNG - X","3740 BAYCHESTER AVENUE"
2,2,0,"35de5eb7-30f4-ea11-b882-24ee9a37d45c","Evergreen Middle School for Urban Exploration - K562 - K296 - 32K562 - 125 COVERT STREET","99283fb1-30f4-ea11-b882-24ee9a37d45c",-73910589,40688647,"I.S. 296 - BROOKLYN","125 COVERT STREET"
3,1,2,"9ae657bd-30f4-ea11-b882-24ee9a37d45c","P.S. 133 William A. Butler - K133 - K317 - 13K133 - 610 Baltic Street","99e657bd-30f4-ea11-b882-24ee9a37d45c",-73980455,40679916,"P.S. 133 WILLIAM A. BUTLER - BROOKLYN","610 Baltic Street"
1,0,1,"7b283fb1-30f4-ea11-b882-24ee9a37d45c","P.S. 289 George V. Brower - K289 - K289 - 17K289 - 900 ST MARKS AVENUE","77283fb1-30f4-ea11-b882-24ee9a37d45c",-73942401,40674244,"P.S. 289 - BROOKLYN","900 ST MARKS AVENUE"
2,2,0,"429f4974-31f4-ea11-b882-24ee9a37d45c","Washington Heights Expeditionary Learning School - M348 - M143 - 06M348 - 511 WEST 182ND STREET","3f9f4974-31f4-ea11-b882-24ee9a37d45c",-73930991,40849311,"I.S. 143 - MANHATTAN","511 WEST 182ND STREET"
1,0,1,"e8c1392a-30f4-ea11-b882-24ee9a37d45c","Explore Charter School - K704 - K002 - 84K704 - 655 Parkside Avenue","dfc1392a-30f4-ea11-b882-24ee9a37d45c",-73951575,40656423,"I.S. 2 - BROOKLYN","655 Parkside Avenue"
1,1,0,"629d7c62-33f4-ea11-b882-24ee9a37d45c","The Cinema School - X478 - X423 - 12X478 - 1551 EAST 172ND STREET","639d7c62-33f4-ea11-b882-24ee9a37d45c",-73878191,40832508,"JAMES MONROE HS CAMPUS ANNEX - BRONX","1551 EAST 172ND STREET"
1,1,0,"d0ed94c3-31f4-ea11-b882-24ee9a37d45c","Leadership and Public Service High School - M425 - M894 - 02M425 - 90 TRINITY PLACE","d1ed94c3-31f4-ea11-b882-24ee9a37d45c",-74012465,40708971,"HS FOR LEADERSHIP & PUBLIC SER - M","90 TRINITY PLACE"
2,1,1,"dd92e6d5-30f4-ea11-b882-24ee9a37d45c","Spring Creek Community School - K422 - K422 - 19K422 - 1065 Elton Street","da92e6d5-30f4-ea11-b882-24ee9a37d45c",-73874064,40657266,"SPRING CREEK EDUCATIONAL CAMPUS - BROOKLYN","1065 Elton Street"
3,0,3,"ed207b48-4afb-ea11-b883-24ee9a37d459","Birch Family Services, Inc - MBBI - MADU -  - 554 FORT WASHINGTON AVENUE","ee207b48-4afb-ea11-b883-24ee9a37d459",-73936827,0,"HERBERT G. BIRCH ANNEX","554 FORT WASHINGTON AVENUE"
1,1,0,"e7f22ce2-31f4-ea11-b882-24ee9a37d45c","I.S. 5 - The Walter Crowley Intermediate School - Q005 - Q005 - 24Q005 - 50-40 JACOBUS STREET","9adc32dc-31f4-ea11-b882-24ee9a37d45c",-73888133,40737405,"I.S. 5 - QUEENS","50-40 JACOBUS STREET"
2,2,0,"1eb4977a-32f4-ea11-b882-24ee9a37d45c","Townsend Harris High School - Q525 - Q515 - 25Q525 - 149-11 MELBOURNE AVENUE","1db4977a-32f4-ea11-b882-24ee9a37d45c",-73821532,40737038,"TOWNSEND HARRIS HS - Q","149-11 MELBOURNE AVENUE"
5,3,2,"29b7c337-32f4-ea11-b882-24ee9a37d45c","I.S. 227 Louis Armstrong - Q227 - Q227 - 30Q227 - 32-02 JUNCTION BOULEVARD","27b7c337-32f4-ea11-b882-24ee9a37d45c",-73874614,40757567,"I.S. 227 - QUEENS","32-02 JUNCTION BOULEVARD"
3,2,1,"ef9b4c1f-32f4-ea11-b882-24ee9a37d45c","J.H.S. 157 Stephen A. Halsey - Q157 - Q157 - 28Q157 - 63-55 102ND STREET","f09b4c1f-32f4-ea11-b882-24ee9a37d45c",-73852879,40732348,"J.H.S. 157 - QUEENS","63-55 102ND STREET"
1,1,0,"1f03cefa-32f4-ea11-b882-24ee9a37d45c","P.S. 044 David C. Farragut - X044 - X044 - 12X044 - 1825 PROSPECT AVENUE","1d03cefa-32f4-ea11-b882-24ee9a37d45c",-73891086,40842564,"P.S. 44 - BRONX","1825 PROSPECT AVENUE"
5,0,5,"8f593c87-33f4-ea11-b882-24ee9a37d45c","P.S. 246 Poe Center - X246 - X843 - 10X246 - 2641 Grand Concourse","90593c87-33f4-ea11-b882-24ee9a37d45c",-73895300,40865972,"P.S. 246 (POE CENTER) - BRONX","2641 Grand Concourse"
1,0,1,"9948b1f5-eaf6-ea11-b883-24ee9a37d459","P.S. K134 - K134 - K849 - 22K134 - 4001 18 AVENUE","12d8cf12-31f4-ea11-b882-24ee9a37d45c",-73973180,40632145,"P.S. 134 - BROOKLYN","4001 18 AVENUE"
1,1,0,"95886843-31f4-ea11-b882-24ee9a37d45c","P.S. 009 Sarah Anderson - M009 - M009 - 03M009 - 100 WEST 84 STREET","87886843-31f4-ea11-b882-24ee9a37d45c",-73974256,40785234,"P.S. 9 - MANHATTAN","100 WEST 84 STREET"
1,0,1,"f1b98b86-30f4-ea11-b882-24ee9a37d45c","P.S. 196 Ten Eyck - K196 - K196 - 14K196 - 207 BUSHWICK AVENUE","e9b98b86-30f4-ea11-b882-24ee9a37d45c",-73939385,40708804,"P.S. 196 - BROOKLYN","207 BUSHWICK AVENUE"
1,1,0,"0d6e3d68-31f4-ea11-b882-24ee9a37d45c","STEM Institute of Manhattan - M241 - M113 - 03M241 - 240 WEST 113 STREET","086e3d68-31f4-ea11-b882-24ee9a37d45c",-73955583,40801573,"P.S. 241 - MANHATTAN","240 WEST 113 STREET"
1,1,0,"df2ece86-32f4-ea11-b882-24ee9a37d45c","Bard High School Early College Queens - Q299 - Q735 - 24Q299 - 30-20 THOMSON AVENUE","db2ece86-32f4-ea11-b882-24ee9a37d45c",-73937004,40744175,"QUEENS HIGH SCHOOL COMPLEX - Q","30-20 THOMSON AVENUE"
2,1,1,"d9968d36-30f4-ea11-b882-24ee9a37d45c","P.S. 020 Clinton Hill - K020 - K020 - 13K020 - 225 ADELPHI STREET","d1968d36-30f4-ea11-b882-24ee9a37d45c",-73970896,40690742,"P.S. 20 - BROOKLYN","225 ADELPHI STREET"
1,0,1,"445bc58c-30f4-ea11-b882-24ee9a37d45c","P.S. 212 Lady Deborah Moody - K212 - K212 - 21K212 - 87 BAY 49 STREET","455bc58c-30f4-ea11-b882-24ee9a37d45c",-73985368,40587612,"P.S. 212 - BROOKLYN","87 BAY 49 STREET"
1,0,1,"abd810ab-31f4-ea11-b882-24ee9a37d45c","Stephen T. Mather Building Arts & Craftsmanship High School - M139 - M625 - 02M139 - 439 WEST 49TH STREET","a9d810ab-31f4-ea11-b882-24ee9a37d45c",-73990318,40763655,"HS OF GRAPHIC COMMUNICATION ARTS-M","439 WEST 49TH STREET"
1,0,1,"c8edf392-32f4-ea11-b882-24ee9a37d45c","P.S. 007 Louis F. Simeone - Q007 - Q877 - 24Q007 - 76-05 51 AVENUE","c9edf392-32f4-ea11-b882-24ee9a37d45c",-73887011,40737222,"51ST AVENUE ACADEMY - QUEENS","76-05 51 AVENUE"
2,0,2,"6f41e65b-31f4-ea11-b882-24ee9a37d45c","P.S. 075 Emily Dickinson - M075 - M075 - 03M075 - 735 WEST END AVENUE","6a41e65b-31f4-ea11-b882-24ee9a37d45c",-73973996,40795109,"P.S. 75 - MANHATTAN","735 WEST END AVENUE"
1,1,0,"9601ce37-33f4-ea11-b882-24ee9a37d45c","P.S. 160 Walt Disney - X160 - X160 - 11X160 - 4140 HUTCHINSON RIVER PKWAY EA","9501ce37-33f4-ea11-b882-24ee9a37d45c",-73823816,40864073,"P.S. 160 - BRONX","4140 HUTCHINSON RIVER PKWAY EA"
1,0,1,"2f06003e-32f4-ea11-b882-24ee9a37d45c","The Active Learning Elementary School - Q244 - Q244 - 25Q244 - 137-20 FRANKLIN AVENUE","2b06003e-32f4-ea11-b882-24ee9a37d45c",-73826192,40754483,"P.S. 244 ECC (@ FRANKLIN AVE) - Q","137-20 FRANKLIN AVENUE"
1,0,1,"08af0313-32f4-ea11-b882-24ee9a37d45c","P.S. 129 Patricia Larkin - Q129 - Q129 - 25Q129 - 128-02 7 Avenue","09af0313-32f4-ea11-b882-24ee9a37d45c",-73839505,40789926,"P.S. 129 - QUEENS","128-02 7 Avenue"
3,2,1,"d3d27c6d-30f4-ea11-b882-24ee9a37d45c","Young Women's Leadership School of Brooklyn - K614 - K147 - 14K614 - 325 BUSHWICK AVENUE","d4d27c6d-30f4-ea11-b882-24ee9a37d45c",-73938790,40705005,"P.S. 147 - BROOKLYN","325 BUSHWICK AVENUE"
1,1,0,"d3ed94c3-31f4-ea11-b882-24ee9a37d45c","Young Women's Leadership School - M610 - M895 - 04M610 - 105 East 106th Street","d4ed94c3-31f4-ea11-b882-24ee9a37d45c",-73947171,40792932,"YOUNG WOMEN'S LEADERSHIP HS - M","105 East 106th Street"
1,1,0,"fb22f4ed-49fb-ea11-b883-24ee9a37d459","CHRIST UNITED METHODIST HEAD START - KBVR - KBVR -  - 4419 7TH AVENUE","fc22f4ed-49fb-ea11-b883-24ee9a37d459",-74002598,40645243,"CHRIST UNITED METHODIST HEAD START","4419 7TH AVENUE"
1,1,0,"6b283fb1-30f4-ea11-b882-24ee9a37d45c","The Gregory Jocko Jackson School of Sports, Art, and Technology - K284 - K284 - 23K284 - 213 OSBORN STREET","fd201dab-30f4-ea11-b882-24ee9a37d45c",-73907634,40666942,"P.S. 284 - BROOKLYN","213 OSBORN STREET"
2,2,0,"77c280bd-31f4-ea11-b882-24ee9a37d45c","The Clinton School - M260 - M868 - 02M260 - 10 East 15th Street","78c280bd-31f4-ea11-b882-24ee9a37d45c",-73992727,40736526,"THE CLINTON SCHOOL - MANHATTAN","10 East 15th Street"
1,1,0,"86eb6056-32f4-ea11-b882-24ee9a37d45c","The CIVIC School of Bayside Hills - Q390 - Q361 - 26Q390 - 56-10 214 Street","85eb6056-32f4-ea11-b882-24ee9a37d45c",-73764954,40749673,"P.S. @ 56-10 214 STREET - QUEENS","56-10 214 Street"
1,0,1,"d667ce0c-8cc7-eb11-b8a8-24ee9a37d459","The Richmond Pre-K Center - R066 - R110 - 31R066 - 1800 Richmond Terrace","d767ce0c-8cc7-eb11-b8a8-24ee9a37d459",-74125156,40637070,"3K CENTER @ RICHMOND TERRACE - STATEN ISLAND","1800 Richmond Terrace"
1,0,1,"da201dab-30f4-ea11-b882-24ee9a37d45c","Metropolitan Diploma Plus High School - K647 - K275 - 23K647 - 985 ROCKAWAY AVENUE","d2201dab-30f4-ea11-b882-24ee9a37d45c",-73906662,40655644,"I.S. 275 - BROOKLYN","985 ROCKAWAY AVENUE"
2,2,0,"3788e6db-30f4-ea11-b882-24ee9a37d45c","FDNY - Captain Vernon A. Richard High School for Fire and Life Safety - K502 - K435 - 19K502 - 400 PENNSYLVANIA AVENUE","3688e6db-30f4-ea11-b882-24ee9a37d45c",-73895122,40666868,"THOMAS JEFFERSON HS - K","400 PENNSYLVANIA AVENUE"
1,0,1,"92886843-31f4-ea11-b882-24ee9a37d45c","P.S. 008 Luis Belliard - M008 - M008 - 06M008 - 465 WEST 167 STREET","93886843-31f4-ea11-b882-24ee9a37d45c",-73936614,40839235,"P.S. 8 - MANHATTAN","465 WEST 167 STREET"
1,0,1,"3a0410ca-32f4-ea11-b882-24ee9a37d45c","P.S. 055 Henry M. Boehm - R055 - R055 - 31R055 - 54 OSBORNE STREET","3b0410ca-32f4-ea11-b882-24ee9a37d45c",-74163037,40536625,"P.S. 55 - STATEN ISLAND","54 OSBORNE STREET"
1,1,0,"e622f4ed-49fb-ea11-b883-24ee9a37d459","Strong Place for Hope Day Care Center/DBA Strong Place for Hope Day Care - KBFN - KBIY -  - 333 2 STREET","e722f4ed-49fb-ea11-b883-24ee9a37d459",-73983488,40673996,"ALONZO A. DAUGHTRY MEMORIAL DAY CARE CENTER SITE 2","333 2 STREET"
11,5,6,"59be7adc-32f4-ea11-b882-24ee9a37d45c","Susan E. Wagner High School - R460 - R460 - 31R460 - 1200 MANOR ROAD","5abe7adc-32f4-ea11-b882-24ee9a37d45c",-74130819,40588985,"SUSAN E. WAGNER HS - S. I.","1200 MANOR ROAD"
1,1,0,"7be2635c-32f4-ea11-b882-24ee9a37d45c","Rockaway Collegiate High School - Q351 - Q410 - 27Q351 - 100-00 BEACH CHANNEL DRIVE","71e2635c-32f4-ea11-b882-24ee9a37d45c",-73825317,40586012,"Beach Channel Educational Campus","100-00 BEACH CHANNEL DRIVE"
3,2,1,"f6f57030-30f4-ea11-b882-24ee9a37d45c","P.S. 015 Patrick F. Daly - K015 - K015 - 15K015 - 71 SULLIVAN STREET","f5f57030-30f4-ea11-b882-24ee9a37d45c",-74011864,40677085,"P.S. 15 - BROOKLYN","71 SULLIVAN STREET"
1,0,1,"2d6e3d68-31f4-ea11-b882-24ee9a37d45c","P.S. 38 Roberto Clemente - M038 - M121 - 04M038 - 232 EAST 103 STREET","2b6e3d68-31f4-ea11-b882-24ee9a37d45c",-73944762,40788668,"P.S. 38 (OLD M121) - MANHATTAN","232 EAST 103 STREET"
2,1,1,"602b3eee-30f4-ea11-b882-24ee9a37d45c","High School for Innovation in Advertising and Media - K617 - K500 - 18K617 - 1600 ROCKAWAY PARKWAY","5e2b3eee-30f4-ea11-b882-24ee9a37d45c",-73898601,40640543,"CANARSIE HS - K","1600 ROCKAWAY PARKWAY"
6,1,5,"eef22ce2-31f4-ea11-b882-24ee9a37d45c","P.S. 007 Louis F. Simeone - Q007 - Q007 - 24Q007 - 80-55 CORNISH AVENUE","ecf22ce2-31f4-ea11-b882-24ee9a37d45c",-73882446,40739644,"P.S. 7 - QUEENS","80-55 CORNISH AVENUE"
2,0,2,"28ebaa73-30f4-ea11-b882-24ee9a37d45c","P.S. 158 Warwick - K158 - K158 - 19K158 - 400 ASHFORD STREET","29ebaa73-30f4-ea11-b882-24ee9a37d45c",-73885214,40672590,"P.S. 158 - BROOKLYN","400 ASHFORD STREET"
1,0,1,"d78a0044-33f4-ea11-b882-24ee9a37d45c","Archimedes Academy for Math, Science and Technology Applications - X367 - X174 - 08X367 - 456 WHITE PLAINS ROAD","2a2ed53d-33f4-ea11-b882-24ee9a37d45c",-73856070,40815043,"I.S. 174 - BRONX","456 WHITE PLAINS ROAD"
1,0,1,"20ebaa73-30f4-ea11-b882-24ee9a37d45c","P.S./ I.S. 155 Nicholas Herkimer - K155 - K155 - 23K155 - 1355 HERKIMER STREET","f6d27c6d-30f4-ea11-b882-24ee9a37d45c",-73908682,40677634,"P.S. 155 - BROOKLYN","1355 HERKIMER STREET"
2,2,0,"3b3cbf01-ebf6-ea11-b883-24ee9a37d459","P.S. Q233 - Q233 - Q686 - 75Q233 - 91-30 METROPOLITAN AVENUE","a372c880-32f4-ea11-b882-24ee9a37d45c",-73855543,40708431,"METROPOLITAN AVENUE CAMPUS - QUEENS","91-30 METROPOLITAN AVENUE"
1,0,1,"6b36d900-33f4-ea11-b882-24ee9a37d45c","Frederick Douglass Academy V. Middle School - X273 - X057 - 12X273 - 2111 CROTONA AVENUE","6c36d900-33f4-ea11-b882-24ee9a37d45c",-73888987,40848748,"P.S. 57 - BRONX","2111 CROTONA AVENUE"
1,1,0,"c70d3c5b-30f4-ea11-b882-24ee9a37d45c","Success Academy Charter School - Bensonhurst - K772 - K096 - 84K772 - 99 AVENUE P","c10d3c5b-30f4-ea11-b882-24ee9a37d45c",-73984985,40608135,"I.S. 96 - BROOKLYN","99 AVENUE P"
1,0,1,"79886843-31f4-ea11-b882-24ee9a37d45c","P.S. 001 Alfred E. Smith - M001 - M001 - 02M001 - 8 HENRY STREET","7a886843-31f4-ea11-b882-24ee9a37d45c",-73997478,40712550,"P.S. 1 - MANHATTAN","8 HENRY STREET"
1,1,0,"df883319-32f4-ea11-b882-24ee9a37d45c","P.S. 144 Col Jeromus Remsen - Q144 - Q144 - 28Q144 - 69-20 JUNO STREET","e0883319-32f4-ea11-b882-24ee9a37d45c",-73852398,40714890,"P.S. 144 - QUEENS","69-20 JUNO STREET"
1,0,1,"1ceabc42-30f4-ea11-b882-24ee9a37d45c","Lyons Community School - K586 - K049 - 14K586 - 223 GRAHAM AVENUE","14eabc42-30f4-ea11-b882-24ee9a37d45c",-73944463,40709765,"I.S. 49 - BROOKLYN","223 GRAHAM AVENUE"
1,1,0,"db2ff20c-32f4-ea11-b882-24ee9a37d45c","P.S. 120 Queens - Q120 - Q120 - 25Q120 - 58-01 136 STREET","dc2ff20c-32f4-ea11-b882-24ee9a37d45c",-73828674,40745215,"P.S. 120 - QUEENS","58-01 136 STREET"
1,1,0,"8407e99e-31f4-ea11-b882-24ee9a37d45c","Manhattan / Hunter Science High School - M541 - M490 - 03M541 - 122 AMSTERDAM AVENUE","7c07e99e-31f4-ea11-b882-24ee9a37d45c",-73985608,40774891,"MARTIN LUTHER KING, JR. HS - M","122 AMSTERDAM AVENUE"
1,0,1,"e39b4c1f-32f4-ea11-b882-24ee9a37d45c","P.S. 154 Queens - Q154 - Q154 - 25Q154 - 75-02 162 Street","d69b4c1f-32f4-ea11-b882-24ee9a37d45c",-73807750,40726473,"P.S. 154 - QUEENS","75-02 162 Street"
3,1,2,"b7ab074a-33f4-ea11-b882-24ee9a37d45c","P.S./M.S. 194 - X194 - X194 - 11X194 - 2365 WATERBURY AVENUE","b6ab074a-33f4-ea11-b882-24ee9a37d45c",-73846594,40835410,"P.S./I.S. 194 - BRONX","2365 WATERBURY AVENUE"
1,0,1,"612f7d06-31f4-ea11-b882-24ee9a37d45c","District 20 Pre-K Center - K768 - K780 - 20K768 - 7415 Fort Hamilton Parkway","622f7d06-31f4-ea11-b882-24ee9a37d45c",-74015894,40626158,"PRE-K CENTER @FORT HAMILTON PARKWAY - BROOKLYN","7415 Fort Hamilton Parkway"
1,1,0,"f609e2e1-30f4-ea11-b882-24ee9a37d45c","Boys and Girls High School - K455 - K455 - 16K455 - 1700 FULTON STREET","f209e2e1-30f4-ea11-b882-24ee9a37d45c",-73931604,40678478,"BOYS & GIRLS HS - K","1700 FULTON STREET"
1,0,1,"9441e65b-31f4-ea11-b882-24ee9a37d45c","Frederick Douglass Academy II Secondary School - M860 - M088 - 03M860 - 215 WEST 114 STREET","8841e65b-31f4-ea11-b882-24ee9a37d45c",-73954152,40802610,"I.S. 88 - MANHATTAN","215 WEST 114 STREET"
2,0,2,"b4cab8ee-48fb-ea11-b883-24ee9a37d459","YOLANDA MIGUEL - KDIG - KCEB -  - 440 VERMONT STREET","b5cab8ee-48fb-ea11-b883-24ee9a37d459",-73893339,40668605,"440 VERMONT STREET","440 VERMONT STREET"
1,0,1,"81eb6056-32f4-ea11-b882-24ee9a37d45c","The Woodside Community School - Q361 - Q339 - 30Q361 - 39-07 57th Street","82eb6056-32f4-ea11-b882-24ee9a37d45c",-73906430,40747701,"P.S. 339 - Queens","39-07 57th Street"
1,0,1,"625bc58c-30f4-ea11-b882-24ee9a37d45c","P.S. 219 Kennedy-King - K219 - K219 - 18K219 - 1060 CLARKSON AVENUE","615bc58c-30f4-ea11-b882-24ee9a37d45c",-73922296,40658834,"P.S. 219 - BROOKLYN","1060 CLARKSON AVENUE"
2,2,0,"9b3aa668-33f4-ea11-b882-24ee9a37d45c","Bronx Aerospace High School - X545 - X425 - 11X545 - 800 EAST GUN HILL ROAD","699d7c62-33f4-ea11-b882-24ee9a37d45c",-73861649,40875172,"EVANDER CHILDS HS - X","800 EAST GUN HILL ROAD"
1,0,1,"14a198c3-30f4-ea11-b882-24ee9a37d45c","P.S. K231 - K231 - K331 - 75K231 - 7002 4TH AVENUE","15a198c3-30f4-ea11-b882-24ee9a37d45c",-74023950,40633598,"P.S./I.S.30 MARY WHITE OVINGTON - BROOKLYN","7002 4TH AVENUE"
2,2,0,"ba689025-33f4-ea11-b882-24ee9a37d45c","J.H.S. 127 The Castle Hill - X127 - X127 - 11X127 - 1560 PURDY STREET","b9689025-33f4-ea11-b882-24ee9a37d45c",-73853203,40838759,"I.S. 127 - BRONX","1560 PURDY STREET"
1,0,1,"9ee657bd-30f4-ea11-b882-24ee9a37d45c","I.S. 318 Eugenio Maria De Hostos - K318 - K318 - 14K318 - 101 WALTON STREET","9de657bd-30f4-ea11-b882-24ee9a37d45c",-73948771,40703034,"I.S. 318 - BROOKLYN","101 WALTON STREET"
1,0,1,"967e21a6-ebf6-ea11-b883-24ee9a37d459","The Riverview School - Q277 - Q315 - 75Q277 - 43-18 97TH PLACE","de454b50-32f4-ea11-b882-24ee9a37d45c",-73866372,40745995,"P.S. 315 - Queens","43-18 97TH PLACE"
1,0,1,"df11f898-32f4-ea11-b882-24ee9a37d45c","P.S. 360 - Q360 - Q892 - 29Q360 - 199-10 112 AVENUE","e011f898-32f4-ea11-b882-24ee9a37d45c",-73756259,40702329,"P.S. 892 - QUEENS","199-10 112 AVENUE"
2,0,2,"db17b7f4-32f4-ea11-b882-24ee9a37d45c","P.S. 168 - X168 - X020 - 75X168 - 3050 WEBSTER AVENUE","d817b7f4-32f4-ea11-b882-24ee9a37d45c",-73878731,40869482,"P.S. 20 - BRONX","3050 WEBSTER AVENUE"
1,1,0,"180410ca-32f4-ea11-b882-24ee9a37d45c","I.S. 49 Berta A. Dreyfus - R049 - R049 - 31R049 - 101 WARREN STREET","190410ca-32f4-ea11-b882-24ee9a37d45c",-74080695,40620443,"I.S. 49 - STATEN ISLAND","101 WARREN STREET"
1,1,0,"96778cb8-ebf6-ea11-b883-24ee9a37d459","Curious Young Learners Pre-K Center - Q336 - Q486 - 27Q336 - 160-06 CROSS BAY BOULEVARD","78bc9674-32f4-ea11-b882-24ee9a37d45c",-73839962,40656943,"3K CENTER @ 160-06 CROSS BAY BOULEVARD - QUEENS","160-06 CROSS BAY BOULEVARD"
2,0,2,"4febaa73-30f4-ea11-b882-24ee9a37d45c","New Bridges Elementary - K532 - K167 - 17K532 - 1025 EASTERN PARKWAY","4cebaa73-30f4-ea11-b882-24ee9a37d45c",-73934316,40669557,"P.S. 167 - BROOKLYN","1025 EASTERN PARKWAY"
1,1,0,"ca8521d0-32f4-ea11-b882-24ee9a37d45c","P.S. 060 Alice Austen - R060 - R060 - 31R060 - 55 Merrill Avenue","cb8521d0-32f4-ea11-b882-24ee9a37d45c",-74162634,40610604,"P.S. 60 - STATEN ISLAND","55 Merrill Avenue"
1,0,1,"40953aac-ebf6-ea11-b883-24ee9a37d459","The Riverview School - Q277 - Q322 - 75Q277 - 89-11 43rd Avenue","ec454b50-32f4-ea11-b882-24ee9a37d45c",-73876706,40742891,"PS 14 Annex","89-11 43rd Avenue"
1,0,1,"bf8fd48d-ebf6-ea11-b883-24ee9a37d459","P.S. Q993 - Q993 - Q072 - 75Q993 - 133-25 GUY R BREWER BOULEVARD","852f77fa-31f4-ea11-b882-24ee9a37d45c",-73775643,40675014,"J.H.S. 72 - QUEENS","133-25 GUY R BREWER BOULEVARD"
1,1,0,"b78a894e-4afb-ea11-b883-24ee9a37d459","JEWISH COMMUNITY CENTER OF STATEN ISLAND - RAFO - RAFO -  - 1466 Manor Road","b88a894e-4afb-ea11-b883-24ee9a37d459",-74130819,40588985,"JEWISH COMMUNITY CENTER OF STATEN ISLAND","1466 Manor Road"
2,0,2,"08cf496e-31f4-ea11-b882-24ee9a37d45c","P.S. 130 Hernando De Soto - M130 - M130 - 02M130 - 143 BAXTER STREET","09cf496e-31f4-ea11-b882-24ee9a37d45c",-73998326,40718660,"P.S. 130 - MANHATTAN","143 BAXTER STREET"
1,1,0,"df9aeff9-49fb-ea11-b883-24ee9a37d459","Imagine Early Learning Center @ the Louis Green and Evely Green Davis Child Care Center - MANH - MASX -  - 60-62 E 97TH STREET","e09aeff9-49fb-ea11-b883-24ee9a37d459",-73952972,40787363,"Imagine Early Learning Center","60-62 E 97TH STREET"
7,5,2,"30767649-31f4-ea11-b882-24ee9a37d45c","New Explorations into Science, Technology and Math High School - M539 - M022 - 01M539 - 111 COLUMBIA STREET","31767649-31f4-ea11-b882-24ee9a37d45c",-73979581,40719416,"N.E.S.T (OLD J22) - MANHATTAN","111 COLUMBIA STREET"
2,2,0,"b89c11e8-30f4-ea11-b882-24ee9a37d45c","The Brooklyn School for Social Justice - K549 - K480 - 32K549 - 400 IRVING AVENUE","b39c11e8-30f4-ea11-b882-24ee9a37d45c",-73911751,40696457,"BUSHWICK EDUCATIONAL CAMPUS - K","400 IRVING AVENUE"
1,1,0,"081bad3c-30f4-ea11-b882-24ee9a37d45c","P.S. 039 Henry Bristow - K039 - K039 - 15K039 - 417 6 AVENUE","091bad3c-30f4-ea11-b882-24ee9a37d45c",-73982909,40668644,"P.S. 39 - BROOKLYN","417 6 AVENUE"
1,1,0,"3a0b210d-33f4-ea11-b882-24ee9a37d45c","P.S./M.S. 280 Mosholu Parkway - X280 - X080 - 10X280 - 3202 STEUBEN AVENUE","370b210d-33f4-ea11-b882-24ee9a37d45c",-73881245,40876819,"I.S. 80/P.S. 280 - BRONX","3202 STEUBEN AVENUE"
2,0,2,"e5e0a4fb-ebf6-ea11-b883-24ee9a37d459","P.S. 723 - X723 - X338 - 75X723 - 1780 Dr. Martin Luther King Jr. Blvd","e3ba3c50-33f4-ea11-b882-24ee9a37d45c",-73915217,40849416,"MORRIS HEIGHTS EDUCATIONAL COMPLEX - BRONX","1780 Dr. Martin Luther King Jr. Blvd"
1,1,0,"b479df48-30f4-ea11-b882-24ee9a37d45c","Success Academy Charter School - Bed Stuy 2 - K125 - K059 - 84K125 - 211 THROOP AVENUE","b579df48-30f4-ea11-b882-24ee9a37d45c",-73943279,40697619,"P.S. 59 - BROOKLYN","211 THROOP AVENUE"
1,1,0,"d9454b50-32f4-ea11-b882-24ee9a37d45c","The Queens School for Leadership and Excellence - Q349 - Q314 - 28Q349 - 88-08 164TH STREET","d5454b50-32f4-ea11-b882-24ee9a37d45c",-73797981,40708698,"P.S./ I.S. 314 - Queens","88-08 164TH STREET"
1,1,0,"3cde5eb7-30f4-ea11-b882-24ee9a37d45c","Brownsville Collaborative Middle School - K363 - K298 - 23K363 - 85 WATKINS STREET","3dde5eb7-30f4-ea11-b882-24ee9a37d45c",-73907718,40671015,"P.S. 298 - BROOKLYN","85 WATKINS STREET"
1,1,0,"9034aa92-31f4-ea11-b882-24ee9a37d45c","High School for Dual Language and Asian Studies - M545 - M445 - 02M545 - 350 GRAND STREET","8834aa92-31f4-ea11-b882-24ee9a37d45c",-73989329,40717329,"SEWARD PARK HS - MANHATTAN","350 GRAND STREET"
1,0,1,"c6bfa431-33f4-ea11-b882-24ee9a37d45c","P.S./M.S. 031 The William Lloyd Garrison - X031 - X151 - 07X031 - 250 EAST 156 STREET","c1bfa431-33f4-ea11-b882-24ee9a37d45c",-73921140,40822574,"I.S. 151 - BRONX","250 EAST 156 STREET"
2,1,1,"3e0b210d-33f4-ea11-b882-24ee9a37d45c","I.S. X303 Leadership & Community Service - X303 - X082 - 09X303 - 1700 MACOMBS ROAD","3f0b210d-33f4-ea11-b882-24ee9a37d45c",-73915217,40849416,"I.S. 232 - BRONX","1700 MACOMBS ROAD"
1,0,1,"239ebaee-32f4-ea11-b882-24ee9a37d45c","P.S. 011 Highbridge - X011 - X011 - 09X011 - 1257 OGDEN AVENUE","249ebaee-32f4-ea11-b882-24ee9a37d45c",-73925890,40839693,"P.S. 11 - BRONX","1257 OGDEN AVENUE"
2,1,1,"18f32ce2-31f4-ea11-b882-24ee9a37d45c","P.S. 019 Marino Jeantet - Q019 - Q019 - 24Q019 - 98-02 ROOSEVELT AVENUE","19f32ce2-31f4-ea11-b882-24ee9a37d45c",-73866557,40748600,"P.S. 19 - QUEENS","98-02 ROOSEVELT AVENUE"
2,2,0,"5d3cbf01-ebf6-ea11-b883-24ee9a37d459","P.S. 087 Bronx - X087 - X087 - 11X087 - 1935 BUSSING AVENUE","510b210d-33f4-ea11-b882-24ee9a37d45c",-73846198,40895741,"P.S. 87 - BRONX","1935 BUSSING AVENUE"
1,1,0,"a6778cb8-ebf6-ea11-b883-24ee9a37d459","Pathways to Graduation - Q950 - Q595 - 79Q950 - 162-02 HILLSIDE AVENUE","39b4977a-32f4-ea11-b882-24ee9a37d45c",-73799532,40708204,"AUX. SERV. - JAMAICA LEARN CT - Q","162-02 HILLSIDE AVENUE"
1,1,0,"c52ff20c-32f4-ea11-b882-24ee9a37d45c","P.S./I.S. 113 Anthony J. Pranzo - Q113 - Q113 - 24Q113 - 78-23 87TH STREET","c62ff20c-32f4-ea11-b882-24ee9a37d45c",-73861493,40705476,"P.S./I.S. 113 - QUEENS","78-23 87TH STREET"
1,0,1,"0dcf496e-31f4-ea11-b882-24ee9a37d45c","Emma Lazarus High School - M394 - M131 - 02M394 - 100 HESTER STREET","03cf496e-31f4-ea11-b882-24ee9a37d45c",-73993607,40716231,"I.S. 131 - MANHATTAN","100 HESTER STREET"
1,0,1,"692b3eee-30f4-ea11-b882-24ee9a37d45c","Franklin Delano Roosevelt High School - K505 - K505 - 20K505 - 5800 20 AVENUE","682b3eee-30f4-ea11-b882-24ee9a37d45c",-73982583,40621299,"FRANKLIN D. ROOSEVELT HS - K","5800 20 AVENUE"
2,2,0,"89977d2b-32f4-ea11-b882-24ee9a37d45c","J.H.S. 194 William Carr - Q194 - Q194 - 25Q194 - 154-60 17 AVENUE","8a977d2b-32f4-ea11-b882-24ee9a37d45c",-73806990,40783231,"J.H.S. 194 - QUEENS","154-60 17 AVENUE"
1,0,1,"747eda5c-ebf6-ea11-b883-24ee9a37d459","P.S. M721 - Manhattan Occupational Training Center - M721 - M047 - 75M721 - 223 EAST 23 STREET","d0c88e4f-31f4-ea11-b882-24ee9a37d45c",-73981329,40738374,"J.H.S. 47 (SCH FOR THE DEAF) - M","223 EAST 23 STREET"
1,0,1,"2fc15a75-ebf6-ea11-b883-24ee9a37d459","Alternative Education Complex - E004 - M827 -  - 500 8 AVENUE","576e70b7-31f4-ea11-b882-24ee9a37d45c",-73992405,40753038,"AUX. SERV-MAN. LEARNING CENTER - M","500 8 AVENUE"
2,0,2,"af2ff20c-32f4-ea11-b882-24ee9a37d45c","P.S. 105 The Bay School - Q105 - Q105 - 27Q105 - 420 BEACH 51 STREET","b02ff20c-32f4-ea11-b882-24ee9a37d45c",-73780961,40595911,"P.S. 105 - QUEENS","420 BEACH 51 STREET"
2,0,2,"6cbc9674-32f4-ea11-b882-24ee9a37d45c","John Adams High School - Q480 - Q480 - 27Q480 - 101-01 ROCKAWAY BOULEVARD","6abc9674-32f4-ea11-b882-24ee9a37d45c",-73838616,40680065,"JOHN ADAMS HS - QUEENS","101-01 ROCKAWAY BOULEVARD"
4,2,2,"686e70b7-31f4-ea11-b882-24ee9a37d45c","West End Secondary School - M291 - M837 - 03M291 - 227-243 West 61st Street","696e70b7-31f4-ea11-b882-24ee9a37d45c",-73988338,40772608,"BEACON HS - MANHATTAN","227-243 West 61st Street"
1,1,0,"df8442ee-31f4-ea11-b882-24ee9a37d45c","P.S. 038 Rosedale - Q038 - Q038 - 29Q038 - 135-21 241 STREET","e08442ee-31f4-ea11-b882-24ee9a37d45c",-73733774,40671150,"P.S. 38 - QUEENS","135-21 241 STREET"
1,0,1,"73593c87-33f4-ea11-b882-24ee9a37d45c","P.S. 196 - X196 - X823 - 12X196 - 1025 Morrison Avenue","34a31781-33f4-ea11-b882-24ee9a37d45c",-73874162,40824989,"I.S. 123 MINISCHOOL - BRONX","1025 Morrison Avenue"
2,0,2,"290b210d-33f4-ea11-b882-24ee9a37d45c","P.S. 196 - X196 - X077 - 12X196 - 1250 WARD AVENUE","230b210d-33f4-ea11-b882-24ee9a37d45c",-73877305,40830811,"P.S. 195 - BRONX","1250 WARD AVENUE"
1,1,0,"15fc3df4-30f4-ea11-b882-24ee9a37d45c","District 20 Pre-K Center - K768 - K560 - 20K768 - 550 59 Street","16fc3df4-30f4-ea11-b882-24ee9a37d45c",-74014450,40639394,"PRE-K CENTER @ 550 59 STREET - BROOKLYN","550 59 Street"
1,1,0,"2f416e00-31f4-ea11-b882-24ee9a37d45c","Brooklyn High School of the Arts - K656 - K655 - 15K656 - 345 DEAN STREET","30416e00-31f4-ea11-b882-24ee9a37d45c",-73980266,40683951,"BKLYN HS OF THE ARTS (OL S J HL)-K","345 DEAN STREET"
3,1,2,"fc9b4c1f-32f4-ea11-b882-24ee9a37d45c","P.S. 161 Arthur Ashe School - Q161 - Q161 - 28Q161 - 101-33 124 STREET","fb9b4c1f-32f4-ea11-b882-24ee9a37d45c",-73821080,40690439,"P.S. 161 - QUEENS","101-33 124 STREET"
3,3,0,"8fe657bd-30f4-ea11-b882-24ee9a37d45c","P.S. 503: The School of Discovery - K503 - K314 - 20K503 - 330 59 Street","8ee657bd-30f4-ea11-b882-24ee9a37d45c",-74019299,40641950,"P.S. 314 - BROOKLYN","330 59 Street"
1,0,1,"b12aa42b-33f4-ea11-b882-24ee9a37d45c","Bronx Charter School for Better Learning II - X484 - X144 - 84X484 - 2545 GUNTHER AVENUE","b22aa42b-33f4-ea11-b882-24ee9a37d45c",-73836525,40863842,"I.S. 144 - BRONX","2545 GUNTHER AVENUE"
1,1,0,"cfc88e4f-31f4-ea11-b882-24ee9a37d45c","47 The American Sign Language and English Secondary School - M047 - M047 - 02M047 - 223 EAST 23 STREET","d0c88e4f-31f4-ea11-b882-24ee9a37d45c",-73981329,40738374,"J.H.S. 47 (SCH FOR THE DEAF) - M","223 EAST 23 STREET"
1,1,0,"f2ae0313-32f4-ea11-b882-24ee9a37d45c","P.S. 122 Mamie Fay - Q122 - Q122 - 30Q122 - 21-21 DITMARS BOULEVARD","cb2ff20c-32f4-ea11-b882-24ee9a37d45c",-73915785,40780507,"P.S. 122 - QUEENS","21-21 DITMARS BOULEVARD"
1,0,1,"6541e65b-31f4-ea11-b882-24ee9a37d45c","New York City Lab Middle School for Collaborative Studies - M312 - M070 - 02M312 - 333 WEST 17 STREET","defab455-31f4-ea11-b882-24ee9a37d45c",-74002222,40742512,"I.S. 70 - MANHATTAN","333 WEST 17 STREET"
1,0,1,"c579df48-30f4-ea11-b882-24ee9a37d45c","J.H.S. 062 Ditmas - K062 - K062 - 20K062 - 700 Cortelyou Road","c479df48-30f4-ea11-b882-24ee9a37d45c",-73971153,40638087,"I.S. 62 - BROOKLYN","700 Cortelyou Road"
4,1,3,"489d7c62-33f4-ea11-b882-24ee9a37d45c","Astor Collegiate Academy - X299 - X415 - 11X299 - 925 ASTOR AVENUE","439d7c62-33f4-ea11-b882-24ee9a37d45c",-73860729,40860443,"CHRISTOPHER COLUMBUS HS - X","925 ASTOR AVENUE"
1,1,0,"8d83ff9e-30f4-ea11-b882-24ee9a37d45c","P.S. 247 Brooklyn - K247 - K247 - 20K247 - 7000 21 AVENUE","8e83ff9e-30f4-ea11-b882-24ee9a37d45c",-73987195,40612247,"P.S. 247 - BROOKLYN","7000 21 AVENUE"
2,2,0,"790e6e25-32f4-ea11-b882-24ee9a37d45c","P.S. 166 Henry Gradstein - Q166 - Q166 - 30Q166 - 33-09 35 AVENUE","7a0e6e25-32f4-ea11-b882-24ee9a37d45c",-73926249,40757497,"P.S. 166 - QUEENS","33-09 35 AVENUE"
3,0,3,"485bc58c-30f4-ea11-b882-24ee9a37d45c","P.S. 213 New Lots - K213 - K213 - 19K213 - 580 HEGEMAN AVENUE","435bc58c-30f4-ea11-b882-24ee9a37d45c",-73889968,40659845,"P.S. 213 - BROOKLYN","580 HEGEMAN AVENUE"
2,2,0,"748946f4-31f4-ea11-b882-24ee9a37d45c","Success Academy Charter School - Far Rockaway - Q375 - Q053 - 84Q375 - 10-45 NAMEOKE STREET","648946f4-31f4-ea11-b882-24ee9a37d45c",-73749891,40604019,"I.S. 53 - QUEENS","10-45 NAMEOKE STREET"
1,1,0,"6934aa92-31f4-ea11-b882-24ee9a37d45c","Success Academy Charter School - Washington Heights - M265 - M387 - 84M265 - 701 Fort Washington Avenue","6a34aa92-31f4-ea11-b882-24ee9a37d45c",-73935231,40857650,"Success Academy - Washington Heights","701 Fort Washington Avenue"
1,0,1,"362f7d06-31f4-ea11-b882-24ee9a37d45c","Brooklyn Studio Secondary School - K690 - K721 - 21K690 - 8310 21ST AVENUE","56416e00-31f4-ea11-b882-24ee9a37d45c",-73995084,40604980,"BROOKLYN STUDIO (TANDEM K128) - K","8310 21ST AVENUE"
2,1,1,"f6fb3df4-30f4-ea11-b882-24ee9a37d45c","Brooklyn Frontiers High School - K423 - K520 - 15K423 - 112 SCHERMERHORN STREET","f7fb3df4-30f4-ea11-b882-24ee9a37d45c",-73989369,40690007,"PACIFIC ALT HS - K","112 SCHERMERHORN STREET"
1,1,0,"0b7eed06-32f4-ea11-b882-24ee9a37d45c","P.S. 084 Steinway - Q084 - Q084 - 30Q084 - 22-45 41 STREET","0c7eed06-32f4-ea11-b882-24ee9a37d45c",-73906117,40771154,"P.S. 84 - QUEENS","22-45 41 STREET"
3,2,1,"fa77931f-33f4-ea11-b882-24ee9a37d45c","Academy For Personal Leadership And Excellence - X363 - X115 - 10X363 - 120 EAST 184 STREET","5b0d6d19-33f4-ea11-b882-24ee9a37d45c",-73900490,40859496,"I.S. 399 (OLD X HS/X115) - BRONX","120 EAST 184 STREET"
3,1,2,"7e886843-31f4-ea11-b882-24ee9a37d45c","P.S. 004 Duke Ellington - M004 - M004 - 06M004 - 500 WEST 160 STREET","7f886843-31f4-ea11-b882-24ee9a37d45c",-73941594,40834877,"P.S. 4 - MANHATTAN","500 WEST 160 STREET"
1,1,0,"5e34aa92-31f4-ea11-b882-24ee9a37d45c","The Peck Slip School - M343 - M343 - 02M343 - 1 PECK SLIP","e7e0838c-31f4-ea11-b882-24ee9a37d45c",-74002407,40708774,"THE PECK SLIP SCHOOL - MANHATTAN","1 PECK SLIP"
2,0,2,"21497593-33f4-ea11-b882-24ee9a37d45c","P.S. 138 Samuel Randall - X138 - X938 - 08X138 - 2060 Lafayette Avenue","22497593-33f4-ea11-b882-24ee9a37d45c",-73853157,40822288,"P.S. 138 TRANSPORTABLE - X","2060 Lafayette Avenue"
2,0,2,"f0f22ce2-31f4-ea11-b882-24ee9a37d45c","York Early College Academy - Q284 - Q008 - 28Q284 - 108-35 167 STREET","f1f22ce2-31f4-ea11-b882-24ee9a37d45c",-73786403,40696910,"J.H.S. 8 - QUEENS","108-35 167 STREET"
1,1,0,"d8e13320-ebf6-ea11-b883-24ee9a37d459","P.S. K077 - K077 - K164 - 75K077 - 4211 14 AVENUE","36ebaa73-30f4-ea11-b882-24ee9a37d45c",-73985739,40637101,"P.S. 164 - BROOKLYN","4211 14 AVENUE"
2,1,1,"d874b6e8-32f4-ea11-b882-24ee9a37d45c","Bronx Center for Science and Mathematics - X260 - X002 - 09X260 - 1363 FULTON AVENUE","d974b6e8-32f4-ea11-b882-24ee9a37d45c",-73902794,40833884,"MORRISANIA SEC ED COMPLEX-X","1363 FULTON AVENUE"
1,0,1,"66fdc1bd-32f4-ea11-b882-24ee9a37d45c","P.S. 21 Margaret Emery-Elm Park - R021 - R021 - 31R021 - 168 Hooker Place","67fdc1bd-32f4-ea11-b882-24ee9a37d45c",-74144599,40631165,"P.S. 21 - STATEN ISLAND","168 Hooker Place"
2,2,0,"75bc9674-32f4-ea11-b882-24ee9a37d45c","Grover Cleveland High School - Q485 - Q485 - 24Q485 - 21-27 HIMROD STREET","74bc9674-32f4-ea11-b882-24ee9a37d45c",-73909202,40711881,"GROVER CLEVELAND HS - Q","21-27 HIMROD STREET"
1,0,1,"555bc58c-30f4-ea11-b882-24ee9a37d45c","P.S. 216 Arturo Toscanini - K216 - K216 - 21K216 - 350 AVENUE X","565bc58c-30f4-ea11-b882-24ee9a37d45c",-73969647,40590000,"P.S. 216 - BROOKLYN","350 AVENUE X"
6,0,6,"d6689025-33f4-ea11-b882-24ee9a37d45c","P.S. 134 George F. Bristow - X134 - X134 - 12X134 - 1330 BRISTOW STREET","d7689025-33f4-ea11-b882-24ee9a37d45c",-73894241,40831613,"P.S. 134 - BRONX","1330 BRISTOW STREET"
3,1,2,"4f507380-31f4-ea11-b882-24ee9a37d45c","P.S. 180 Hugo Newman - M180 - M180 - 03M180 - 370 WEST 120TH STREET","50507380-31f4-ea11-b882-24ee9a37d45c",-73955861,40807570,"P.S. 180 - MANHATTAN","370 WEST 120TH STREET"
1,1,0,"df0d3c5b-30f4-ea11-b882-24ee9a37d45c","P.S. 105 The Blythebourne - K105 - K105 - 20K105 - 1031 59 STREET","e00d3c5b-30f4-ea11-b882-24ee9a37d45c",-74003635,40633320,"P.S. 105 - BROOKLYN","1031 59 STREET"
1,0,1,"a483ff9e-30f4-ea11-b882-24ee9a37d45c","P.S. 254 Dag Hammarskjold - K254 - K254 - 22K254 - 2469 East 18 Street","a583ff9e-30f4-ea11-b882-24ee9a37d45c",-73951550,40591103,"P.S. 254 - BROOKLYN","2469 East 18 Street"
1,1,0,"66c4fc0b-4afb-ea11-b883-24ee9a37d459","Center of Excellence Springfield Gardens Preschool - QATE - QAXU -  - 127-08 MERRICK BOULEVARD","67c4fc0b-4afb-ea11-b883-24ee9a37d459",-73765117,40680891,"QUEENS VILLAGE DAY SCHOOL","127-08 MERRICK BOULEVARD"
1,1,0,"2502926e-32f4-ea11-b882-24ee9a37d45c","Jamaica Gateway to the Sciences - Q350 - Q470 - 28Q350 - 167-01 GOTHIC DRIVE","1f02926e-32f4-ea11-b882-24ee9a37d45c",-73798658,40714551,"JAMAICA HS - Q","167-01 GOTHIC DRIVE"
1,1,0,"d28442ee-31f4-ea11-b882-24ee9a37d45c","P.S. 035 Nathaniel Woodhull - Q035 - Q035 - 29Q035 - 90-01 191 Street","bb8442ee-31f4-ea11-b882-24ee9a37d45c",-73768894,40713438,"P.S. 35 - QUEENS","191-02 90 Avenue"
5,3,2,"320b210d-33f4-ea11-b882-24ee9a37d45c","School for Environmental Citizenship - X386 - X079 - 10X386 - 125 EAST 181 STREET","2c0b210d-33f4-ea11-b882-24ee9a37d45c",-73903139,40855337,"P.S. 79 - BRONX","125 EAST 181 STREET"
4,3,1,"579f4974-31f4-ea11-b882-24ee9a37d45c","The William Lynch School - M368 - M153 - 06M368 - 1750 AMSTERDAM AVENUE","589f4974-31f4-ea11-b882-24ee9a37d45c",-73947599,40826514,"P.S. 153 - MANHATTAN","1750 AMSTERDAM AVENUE"
1,0,1,"c50d3c5b-30f4-ea11-b882-24ee9a37d45c","I.S. 096 Seth Low - K096 - K096 - 21K096 - 99 AVENUE P","c10d3c5b-30f4-ea11-b882-24ee9a37d45c",-73984985,40608135,"I.S. 96 - BROOKLYN","99 AVENUE P"
2,2,0,"52507380-31f4-ea11-b882-24ee9a37d45c","P.S. 183 Robert L. Stevenson - M183 - M183 - 02M183 - 419 East 66 Street","53507380-31f4-ea11-b882-24ee9a37d45c",-73957731,40763804,"P.S. 183 - MANHATTAN","419 East 66 Street"
1,0,1,"6741e65b-31f4-ea11-b882-24ee9a37d45c","N.Y.C. Museum School - M414 - M070 - 02M414 - 333 WEST 17 STREET","defab455-31f4-ea11-b882-24ee9a37d45c",-74002222,40742512,"I.S. 70 - MANHATTAN","333 WEST 17 STREET"
1,1,0,"86977d2b-32f4-ea11-b882-24ee9a37d45c","P.S. 193 Alfred J. Kennedy - Q193 - Q193 - 25Q193 - 152-20 11 AVENUE","87977d2b-32f4-ea11-b882-24ee9a37d45c",-73808987,40792053,"P.S. 193 - QUEENS","152-20 11 AVENUE"
3,0,3,"cf0d3c5b-30f4-ea11-b882-24ee9a37d45c","P.S. 099 Isaac Asimov - K099 - K099 - 21K099 - 1120 EAST 10 STREET","d00d3c5b-30f4-ea11-b882-24ee9a37d45c",-73966031,40621474,"P.S. 99 - BROOKLYN","1120 EAST 10 STREET"
1,1,0,"0a2ed53d-33f4-ea11-b882-24ee9a37d45c","Grant Avenue Elementary School - X449 - X166 - 09X449 - 250 EAST 164 STREET","0b2ed53d-33f4-ea11-b882-24ee9a37d45c",-73917705,40828009,"I.S. 166 - BRONX","250 EAST 164 STREET"
2,2,0,"33474313-33f4-ea11-b882-24ee9a37d45c","Ampark Neighborhood - X344 - X095 - 10X344 - 3961 HILLMAN AVENUE","34474313-33f4-ea11-b882-24ee9a37d45c",-73891664,40883049,"P.S. 95 - BRONX","3961 HILLMAN AVENUE"
9,7,2,"7107e99e-31f4-ea11-b882-24ee9a37d45c","Fiorello H. LaGuardia High School of Music & Art and Performing Arts - M485 - M485 - 03M485 - 100 Amsterdam Avenue","7207e99e-31f4-ea11-b882-24ee9a37d45c",-73985976,40774202,"FIORELLO LAGUARDIA HS - MANHATTAN","100 Amsterdam Avenue"
1,0,1,"197eed06-32f4-ea11-b882-24ee9a37d45c","P.S. 89Q: The Jose Peralta School of Dreamers - Q089 - Q089 - 24Q089 - 85-28 BRITTON AVENUE","1a7eed06-32f4-ea11-b882-24ee9a37d45c",-73879641,40745963,"P.S. 89 - QUEENS","85-28 BRITTON AVENUE"
2,1,1,"e7201dab-30f4-ea11-b882-24ee9a37d45c","J.H.S. 278 Marine Park - K278 - K278 - 22K278 - 1925 STUART STREET","e8201dab-30f4-ea11-b882-24ee9a37d45c",-73938721,40606745,"I.S. 278 - BROOKLYN","1925 STUART STREET"
7,3,4,"8653dd74-33f4-ea11-b882-24ee9a37d45c","Harry S Truman High School - X455 - X455 - 11X455 - 750 BAYCHESTER AVENUE","8253dd74-33f4-ea11-b882-24ee9a37d45c",-73831669,40874035,"HARRY S. TRUMAN HS - X","750 BAYCHESTER AVENUE"
1,0,1,"3d767649-31f4-ea11-b882-24ee9a37d45c","P.S. 030 Hernandez/Hughes - M030 - M030 - 05M030 - 144-176 EAST 128 STREET","38767649-31f4-ea11-b882-24ee9a37d45c",-73935461,40805653,"P.S. 30 - MANHATTAN","144-176 EAST 128 STREET"
1,1,0,"788946f4-31f4-ea11-b882-24ee9a37d45c","P.S. 054 Hillside - Q054 - Q054 - 28Q054 - 86-02 127 STREET","778946f4-31f4-ea11-b882-24ee9a37d45c",-73824629,40702656,"P.S. 54 - QUEENS","86-02 127 STREET"
1,1,0,"d4d81655-6a01-ed11-b8db-24ee9a37d45c","A School Without Walls - K960 - K802 - 33K960 - 131 LIVINGSTON STREET","d5d81655-6a01-ed11-b8db-24ee9a37d45c",-73988475,40691075,"CENT HEADQTRS (131 LIV) - K","131 LIVINGSTON STREET"
2,2,0,"378dbfcf-30f4-ea11-b882-24ee9a37d45c","P.S. 770 New American Academy - K770 - K398 - 17K770 - 60 EAST 94 STREET","308dbfcf-30f4-ea11-b882-24ee9a37d45c",-73927979,40663388,"P.S. 398 (UDC) - BROOKLYN","60 EAST 94 STREET"
1,0,1,"c3bfa431-33f4-ea11-b882-24ee9a37d45c","P.S. 150 Charles James Fox - X150 - X150 - 12X150 - 920 EAST 167 STREET","c4bfa431-33f4-ea11-b882-24ee9a37d45c",-73894349,40824710,"P.S. 150 - BRONX","920 EAST 167 STREET"
1,1,0,"762b3eee-30f4-ea11-b882-24ee9a37d45c","Academy for Conservation and the Environment - K637 - K515 - 18K637 - 6565 FLATLANDS AVENUE","6d2b3eee-30f4-ea11-b882-24ee9a37d45c",-73916927,40634451,"SOUTH SHORE EDUCATIONAL CAMPUS - K","6565 FLATLANDS AVENUE"
2,2,0,"652f77fa-31f4-ea11-b882-24ee9a37d45c","P. S. 62 - Chester Park School - Q062 - Q062 - 27Q062 - 97-25 108 STREET","642f77fa-31f4-ea11-b882-24ee9a37d45c",-73835567,40688359,"P.S. 62 - QUEENS","97-25 108 STREET"
2,1,1,"26af0313-32f4-ea11-b882-24ee9a37d45c","P.S./M.S. 138 Sunrise - Q138 - Q138 - 29Q138 - 251-11 WELLER AVENUE","1aaf0313-32f4-ea11-b882-24ee9a37d45c",-73734342,40659876,"P.S. 138 - QUEENS","251-11 WELLER AVENUE"
3,3,0,"db21d292-30f4-ea11-b882-24ee9a37d45c","P.S. 222 Katherine R. Snyder - K222 - K222 - 22K222 - 3301 QUENTIN ROAD","dc21d292-30f4-ea11-b882-24ee9a37d45c",-73939205,40614005,"P.S. 222 - BROOKLYN","3301 QUENTIN ROAD"
1,1,0,"6e36d900-33f4-ea11-b882-24ee9a37d45c","P.S. 056 Norwood Heights - X056 - X056 - 10X056 - 341 EAST 207 STREET","6f36d900-33f4-ea11-b882-24ee9a37d45c",-73874912,40875481,"P.S. 56 - BRONX","341 EAST 207 STREET"
1,1,0,"a332c3fb-eaf6-ea11-b883-24ee9a37d459","P.S. 131 Abigail Adams - Q131 - Q131 - 29Q131 - 170-21 84 Avenue","0eaf0313-32f4-ea11-b882-24ee9a37d45c",-73794061,40717150,"P.S. 131 - QUEENS","170-21 84 Avenue"
1,0,1,"e18fd20d-ebf6-ea11-b883-24ee9a37d459","The Joan Snow Pre-K Center - K853 - K042 - 22K853 - 3610 GLENWOOD ROAD","121bad3c-30f4-ea11-b882-24ee9a37d45c",-73941795,40634360,"PRE-K CENTER @3610 GLENWOOD ROAD - BROOKLYN","3610 GLENWOOD ROAD"
1,1,0,"d1d27c6d-30f4-ea11-b882-24ee9a37d45c","The Brooklyn New School, P.S. 146 - K146 - K142 - 15K146 - 610 HENRY STREET","cfd27c6d-30f4-ea11-b882-24ee9a37d45c",-74002022,40679462,"J.H.S. 142 - BROOKLYN","610 HENRY STREET"
1,0,1,"2c30f69f-ebf6-ea11-b883-24ee9a37d459","P.S. Q255 - Q255 - Q247 - 75Q255 - 69-10 65th Drive","2ca10a44-32f4-ea11-b882-24ee9a37d45c",-73885974,40715005,"PS/IS 128","69-10 65th Drive"
2,1,1,"61507380-31f4-ea11-b882-24ee9a37d45c","P.S. 189 - M189 - M189 - 06M189 - 2580 AMSTERDAM AVENUE","5f507380-31f4-ea11-b882-24ee9a37d45c",-73928048,40853045,"P.S. 189 - MANHATTAN","2580 AMSTERDAM AVENUE"
2,0,2,"172ed53d-33f4-ea11-b882-24ee9a37d45c","P.S. 214 - X214 - X167 - 12X214 - 1970 WEST FARMS ROAD","152ed53d-33f4-ea11-b882-24ee9a37d45c",-73879931,40839297,"P.S. 214 - BRONX","1970 WEST FARMS ROAD"
1,0,1,"e8b98b86-30f4-ea11-b882-24ee9a37d45c","M.S. 582 - K582 - K196 - 14K582 - 207 BUSHWICK AVENUE","e9b98b86-30f4-ea11-b882-24ee9a37d45c",-73939385,40708804,"P.S. 196 - BROOKLYN","207 BUSHWICK AVENUE"
5,1,4,"84476368-32f4-ea11-b882-24ee9a37d45c","Long Island City High School - Q450 - Q452 - 30Q450 - 14-30 BROADWAY","81476368-32f4-ea11-b882-24ee9a37d45c",-73933907,40765881,"LONG ISLAND CITY HS(NEW)-Q","14-30 BROADWAY"
1,1,0,"e42ece86-32f4-ea11-b882-24ee9a37d45c","Young Women's Leadership School, Astoria - Q286 - Q739 - 30Q286 - 23-15 Newtown Avenue","e52ece86-32f4-ea11-b882-24ee9a37d45c",-73923830,40770769,"YOUNG WOMEN'S LEADERSHIP ACADEMY- QUEENS","23-15 Newtown Avenue"
2,0,2,"2aa6ba98-31f4-ea11-b882-24ee9a37d45c","High School for Media and Communications - M463 - M465 - 06M463 - 549 AUDUBON AVENUE","25a6ba98-31f4-ea11-b882-24ee9a37d45c",-73926060,40856532,"G. WASHINGTON HS EDUC. CAMPUS - M","549 AUDUBON AVENUE"
3,3,0,"39474313-33f4-ea11-b882-24ee9a37d45c","P.S. 095 Sheila Mencher - X095 - X095 - 10X095 - 3961 HILLMAN AVENUE","34474313-33f4-ea11-b882-24ee9a37d45c",-73891664,40883049,"P.S. 95 - BRONX","3961 HILLMAN AVENUE"
2,0,2,"1b0410ca-32f4-ea11-b882-24ee9a37d45c","P.S. 044 Thomas C. Brown - R044 - R044 - 31R044 - 80 MAPLE PARKWAY","1c0410ca-32f4-ea11-b882-24ee9a37d45c",-74157303,40631689,"P.S. 44 - STATEN ISLAND","80 MAPLE PARKWAY"
1,1,0,"df8fd20d-ebf6-ea11-b883-24ee9a37d459","P.S. K140 - K140 - K026 - 75K140 - 1014 LAFAYETTE AVENUE","f2968d36-30f4-ea11-b882-24ee9a37d45c",-73931700,40692100,"P.S. 26 - BROOKLYN","1014 LAFAYETTE AVENUE"
1,1,0,"1923f4ed-49fb-ea11-b883-24ee9a37d459","Sunny Skies Preschool at 720 Washington - KCLC - KCGM -  - 720 Washington Avenue","1a23f4ed-49fb-ea11-b883-24ee9a37d459",0,0,"Sunny Skies Preschool at 720 Washington","720 Washington Avenue"
1,1,0,"0a9c4c1f-32f4-ea11-b882-24ee9a37d45c","P.S. 165 Edith K. Bergtraum - Q165 - Q165 - 25Q165 - 70-35 150 Street","0b9c4c1f-32f4-ea11-b882-24ee9a37d45c",-73816966,40729746,"P.S. 165 - QUEENS","70-35 150 Street"
1,0,1,"f3ed94c3-31f4-ea11-b882-24ee9a37d45c","Paula Hedbavny School - M278 - M918 - 06M278 - 421 W 219th St","f4ed94c3-31f4-ea11-b882-24ee9a37d45c",-73912339,40871673,"P.S./IS 278 - MANHATTAN","421 W 219th St"
1,1,0,"692f77fa-31f4-ea11-b882-24ee9a37d45c","P.S. 063 Old South - Q063 - Q063 - 27Q063 - 90-15 SUTTER AVENUE","6a2f77fa-31f4-ea11-b882-24ee9a37d45c",-73846796,40676978,"P.S. 63 - QUEENS","90-15 SUTTER AVENUE"
1,0,1,"82283fb1-30f4-ea11-b882-24ee9a37d45c","Bushwick Community High School - K564 - K291 - 32K564 - 231 PALMETTO STREET","83283fb1-30f4-ea11-b882-24ee9a37d45c",-73915217,40695875,"I.S. 291 - BROOKLYN","231 PALMETTO STREET"
1,1,0,"df17b7f4-32f4-ea11-b882-24ee9a37d45c","P.S. 021 Philip H. Sheridan - X021 - X021 - 11X021 - 715 EAST 225 STREET","e017b7f4-32f4-ea11-b882-24ee9a37d45c",-73859420,40887888,"P.S. 21 - BRONX","715 EAST 225 STREET"
2,2,0,"18474313-33f4-ea11-b882-24ee9a37d45c","P.S. 086 Kingsbridge Heights - X086 - X086 - 10X086 - 2756 RESERVOIR AVENUE","19474313-33f4-ea11-b882-24ee9a37d45c",-73897066,40869061,"P.S. 86 - BRONX","2756 RESERVOIR AVENUE"
1,1,0,"11e85c61-30f4-ea11-b882-24ee9a37d45c","P.S. 108 Sal Abbracciamento - K108 - K108 - 19K108 - 200 LINWOOD STREET","12e85c61-30f4-ea11-b882-24ee9a37d45c",-73884348,40681295,"P.S. 108 - BROOKLYN","200 LINWOOD STREET"
1,0,1,"778d8486-31f4-ea11-b882-24ee9a37d45c","KIPP Infinity Charter School - M336 - M195 - 84M336 - 625 WEST 133 STREET","758d8486-31f4-ea11-b882-24ee9a37d45c",-73956814,40819793,"TERENCE D. TOLBERT EDUCATION COMPLEX - MANHATTAN","625 WEST 133 STREET"
2,2,0,"43474313-33f4-ea11-b882-24ee9a37d45c","J.H.S. 098 Herman Ridder - X098 - X098 - 12X098 - 1619 BOSTON ROAD","3c474313-33f4-ea11-b882-24ee9a37d45c",-73890591,40836245,"I.S. 98 - BRONX","1619 BOSTON ROAD"
1,1,0,"1503cefa-32f4-ea11-b882-24ee9a37d45c","P.S. 042 Claremont - X042 - X042 - 09X042 - 1537 WASHINGTON AVENUE","1103cefa-32f4-ea11-b882-24ee9a37d45c",-73903243,40838636,"P.S. 42 - BRONX","1537 WASHINGTON AVENUE"
2,1,1,"24b7c337-32f4-ea11-b882-24ee9a37d45c","Epic High School - South - Q314 - Q226 - 27Q314 - 121-10 ROCKAWAY BOULEVARD","1eb7c337-32f4-ea11-b882-24ee9a37d45c",-73816730,40675021,"I.S. 226 - QUEENS","121-10 ROCKAWAY BOULEVARD"
1,1,0,"a22aa42b-33f4-ea11-b882-24ee9a37d45c","One World Middle School at Edenwald - X529 - X142 - 11X529 - 3750 BAYCHESTER AVENUE","a32aa42b-33f4-ea11-b882-24ee9a37d45c",-73839682,40886002,"I.S. 142 - BRONX","3750 BAYCHESTER AVENUE"
1,0,1,"d7b66262-32f4-ea11-b882-24ee9a37d45c","William Cullen Bryant High School - Q445 - Q445 - 30Q445 - 48-10 31 AVENUE","d8b66262-32f4-ea11-b882-24ee9a37d45c",-73911165,40757072,"WILLIAM C. BRYANT HS - Q","48-10 31 AVENUE"
2,0,2,"eaed94c3-31f4-ea11-b882-24ee9a37d45c","ALC - BATTERY PARK - M982 - M913 - 88M982 - 50 Broadway","ebed94c3-31f4-ea11-b882-24ee9a37d45c",-74012440,40706232,"YES Program","50 Broadway"
2,0,2,"94a9d9c3-32f4-ea11-b882-24ee9a37d45c","P.S. 038 George Cromwell - R038 - R038 - 31R038 - 421 LINCOLN AVENUE","92a9d9c3-32f4-ea11-b882-24ee9a37d45c",-74099409,40574799,"P.S. 38 - STATEN ISLAND","421 LINCOLN AVENUE"
1,0,1,"a605be56-ebf6-ea11-b883-24ee9a37d459","Pathways to Graduation - Q950 - KCHF - 79Q950 - 692 BLAKE AVENUE","335b5337-31f4-ea11-b882-24ee9a37d45c",-73893172,40668080,"BROOKLYN PRIDE","692 BLAKE AVENUE"
1,0,1,"e7968d36-30f4-ea11-b882-24ee9a37d45c","P.S. 023 Carter G. Woodson - K023 - K023 - 14K023 - 545 WILLOUGHBY AVENUE","e5968d36-30f4-ea11-b882-24ee9a37d45c",-73947256,40694470,"P.S. 23 - BROOKLYN","545 WILLOUGHBY AVENUE"
2,2,0,"a40e6e25-32f4-ea11-b882-24ee9a37d45c","Scholars' Academy - Q323 - Q180 - 27Q323 - 320 BEACH 104TH STREET","a50e6e25-32f4-ea11-b882-24ee9a37d45c",-73825162,40584543,"I.S. 323 (OLD IS 180) - QUEENS","320 BEACH 104TH STREET"
1,0,1,"66395a2c-ebf6-ea11-b883-24ee9a37d459","P.S. K053 - K053 - K296 - 75K053 - 125 COVERT STREET","99283fb1-30f4-ea11-b882-24ee9a37d45c",-73910589,40688647,"I.S. 296 - BROOKLYN","125 COVERT STREET"
1,1,0,"30b4977a-32f4-ea11-b882-24ee9a37d45c","Frank Sinatra School of the Arts High School - Q501 - Q570 - 30Q501 - 35-12 35TH AVENUE","2eb4977a-32f4-ea11-b882-24ee9a37d45c",-73925182,40756099,"FRANK SINATRA HIGH SCHOOL-Q","35-12 35TH AVENUE"
1,1,0,"45474313-33f4-ea11-b882-24ee9a37d45c","Explorations Academy H.S. - X251 - X098 - 12X251 - 1619 BOSTON ROAD","3c474313-33f4-ea11-b882-24ee9a37d45c",-73890591,40836245,"I.S. 98 - BRONX","1619 BOSTON ROAD"
1,0,1,"a532c3fb-eaf6-ea11-b883-24ee9a37d459","P.S. Q255 - Q255 - Q168 - 75Q255 - 158-40 76 ROAD","099c4c1f-32f4-ea11-b882-24ee9a37d45c",-73809380,40724195,"J.H.S. 168 - QUEENS","158-40 76 ROAD"
1,1,0,"d8315367-30f4-ea11-b882-24ee9a37d45c","P.S. 131 Brooklyn - K131 - K131 - 15K131 - 4305 FT HAMILTON PARKWAY","d9315367-30f4-ea11-b882-24ee9a37d45c",-73993247,40640728,"P.S. 131 - BROOKLYN","4305 FT HAMILTON PARKWAY"
1,0,1,"e12ece86-32f4-ea11-b882-24ee9a37d45c","Pan American International High School - Q296 - Q744 - 24Q296 - 45-10 94th Street","e22ece86-32f4-ea11-b882-24ee9a37d45c",-73871505,40743228,"ELMHURST EDUCATIONAL CAMPUS - Q","45-10 94th Street"
1,1,0,"720c1bb1-31f4-ea11-b882-24ee9a37d45c","Harvey Milk High School - M586 - M807 - 02M586 - 2-10 ASTOR PLACE","710c1bb1-31f4-ea11-b882-24ee9a37d45c",-73992343,40729661,"HARVEY MILK SCHOOL - MANHATTAN","2-10 ASTOR PLACE"
1,1,0,"8734aa92-31f4-ea11-b882-24ee9a37d45c","Urban Assembly Academy of Government and Law, The - M305 - M445 - 02M305 - 350 GRAND STREET","8834aa92-31f4-ea11-b882-24ee9a37d45c",-73989329,40717329,"SEWARD PARK HS - MANHATTAN","350 GRAND STREET"
1,1,0,"24d8cf12-31f4-ea11-b882-24ee9a37d45c","East Brooklyn Community High School - K673 - K860 - 18K673 - 9517 KINGS HIGHWAY","25d8cf12-31f4-ea11-b882-24ee9a37d45c",-73920658,40659914,"P.S. 219 ANNEX - BROOKLYN","9517 KINGS HIGHWAY"
1,1,0,"a2886843-31f4-ea11-b882-24ee9a37d45c","Central Park East High School - M555 - M013 - 04M555 - 1573 MADISON AVENUE","98886843-31f4-ea11-b882-24ee9a37d45c",-73948488,40793649,"I.S. 13 - MANHATTAN","1573 MADISON AVENUE"
1,0,1,"9bc1797b-ebf6-ea11-b883-24ee9a37d459","Hospital Schools - M401 - MAYH - 75M401 - 3959 BROADWAY","2116d3cf-31f4-ea11-b882-24ee9a37d45c",-73941542,40840605,"NY PRESBYTERIAN MORGAN STANLEY CHILDREN'S HOSPITAL","3959 BROADWAY"
1,0,1,"33e61462-31f4-ea11-b882-24ee9a37d45c","M.S. 324 - Patria Mirabal - M324 - M090 - 06M324 - 21 JUMEL PLACE","2ce61462-31f4-ea11-b882-24ee9a37d45c",-73935815,40839139,"I.S. 90 - MANHATTAN","21 JUMEL PLACE"
1,0,1,"e6454b50-32f4-ea11-b882-24ee9a37d45c","Queens Explorers Elementary School - Q316 - Q316 - 27Q316 - 90-07 101ST AVENUE","e7454b50-32f4-ea11-b882-24ee9a37d45c",-73850123,40683112,"THE OZONE PARK EDUCATIONAL CAMPUS - QUEENS","90-07 101ST AVENUE"
1,1,0,"47a10a44-32f4-ea11-b882-24ee9a37d45c","P.S./I.S. 295 - Q295 - Q263 - 29Q295 - 222-14 JAMAICA AVENUE","41a10a44-32f4-ea11-b882-24ee9a37d45c",-73731398,40720617,"P.S. /I.S 295 - QUEENS","222-14 JAMAICA AVENUE"
2,2,0,"87e2635c-32f4-ea11-b882-24ee9a37d45c","Benjamin N. Cardozo High School - Q415 - Q415 - 26Q415 - 57-00 223RD STREET","86e2635c-32f4-ea11-b882-24ee9a37d45c",-73757271,40752343,"BENJAMIN N. CARDOZO HS - Q","57-00 223RD STREET"
2,1,1,"30e85c61-30f4-ea11-b882-24ee9a37d45c","P.S. 115 Daniel Mucatel School - K115 - K115 - 18K115 - 1500 East 92 Street","2fe85c61-30f4-ea11-b882-24ee9a37d45c",-73897896,40634861,"P.S. 115 - BROOKLYN","1500 East 92 Street"
3,0,3,"882aa42b-33f4-ea11-b882-24ee9a37d45c","P186X Walter J. Damrosch School - X186 - X136 - 75X186 - 750 Jennings Street","892aa42b-33f4-ea11-b882-24ee9a37d45c",-73897797,40831388,"P.S. 186 (OLD J136) - BRONX","750 Jennings Street"
1,1,0,"bbfab455-31f4-ea11-b882-24ee9a37d45c","James Weldon Johnson - M057 - M057 - 04M057 - 176 EAST 115 STREET","bcfab455-31f4-ea11-b882-24ee9a37d45c",-73941598,40797205,"P.S. 57 - MANHATTAN","176 EAST 115 STREET"
2,2,0,"62a5db98-30f4-ea11-b882-24ee9a37d45c","Brooklyn School of Inquiry - K686 - K237 - 20K686 - 50 AVENUE P","5fa5db98-30f4-ea11-b882-24ee9a37d45c",-73986678,40606994,"LUCRETIA MARCIGLIANO CAMPUS - K","50 AVENUE P"
3,2,1,"92eb0e7b-33f4-ea11-b882-24ee9a37d45c","New Visions Charter High School for Advanced Math and Science II - X202 - X650 - 84X202 - 900 TINTON AVENUE","91eb0e7b-33f4-ea11-b882-24ee9a37d45c",-73902892,40821723,"JANE ADDAMS HS - X","900 TINTON AVENUE"
2,2,0,"31005d7a-31f4-ea11-b882-24ee9a37d45c","P.S. 165 Robert E. Simon - M165 - M165 - 03M165 - 234 West 109 Street","2f005d7a-31f4-ea11-b882-24ee9a37d45c",-73965949,40802653,"P.S. 165 - MANHATTAN","234 West 109 Street"
3,3,0,"546e70b7-31f4-ea11-b882-24ee9a37d45c","Millennium High School - M418 - M824 - 02M418 - 75 BROAD STREET","760c1bb1-31f4-ea11-b882-24ee9a37d45c",-74011202,40704697,"MILLENNIUM HS - MANHATTAN","75 BROAD STREET"
1,0,1,"f08a0044-33f4-ea11-b882-24ee9a37d45c","P.S. 182 - X182 - X182 - 08X182 - 601 STICKBALL BOULEVARD","f18a0044-33f4-ea11-b882-24ee9a37d45c",-73856976,40818925,"P.S. 182 - BRONX","601 STICKBALL BOULEVARD"
1,1,0,"a82aa42b-33f4-ea11-b882-24ee9a37d45c","Bronx Alliance Middle School - X355 - X142 - 11X355 - 3750 BAYCHESTER AVENUE","a32aa42b-33f4-ea11-b882-24ee9a37d45c",-73839682,40886002,"I.S. 142 - BRONX","3750 BAYCHESTER AVENUE"
2,2,0,"71c280bd-31f4-ea11-b882-24ee9a37d45c","Eleanor Roosevelt High School - M416 - M855 - 02M416 - 411 EAST 76 STREET","72c280bd-31f4-ea11-b882-24ee9a37d45c",-73953276,40770288,"ELEANOR ROOSEVELT HS - MANHATTAN","411 EAST 76 STREET"
1,1,0,"14af0313-32f4-ea11-b882-24ee9a37d45c","P.S. 133 Queens - Q133 - Q133 - 26Q133 - 248-05 86 AVENUE","15af0313-32f4-ea11-b882-24ee9a37d45c",-73717819,40732458,"P.S. 133 - QUEENS","248-05 86 AVENUE"
1,0,1,"0d2ed53d-33f4-ea11-b882-24ee9a37d45c","P.S. 163 Arthur A. Schomburg - X163 - X163 - 09X163 - 2075 Webster Avenue","0e2ed53d-33f4-ea11-b882-24ee9a37d45c",-73899005,40851700,"P.S. 163 - BRONX","2075 Webster Avenue"
2,0,2,"ef77bb9f-33f4-ea11-b882-24ee9a37d45c","East Bronx Academy for the Future - X271 - X973 - 12X271 - 1716 SOUTHERN BOULEVARD","ed77bb9f-33f4-ea11-b882-24ee9a37d45c",-73887688,40836821,"M.S./H.S. 270 - BRONX","1716 SOUTHERN BOULEVARD"
3,3,0,"2e0410ca-32f4-ea11-b882-24ee9a37d45c","I.S. 051 Edwin Markham - R051 - R051 - 31R051 - 80 WILLOWBROOK ROAD","2f0410ca-32f4-ea11-b882-24ee9a37d45c",-74145522,40623077,"I.S. 51 - STATEN ISLAND","80 WILLOWBROOK ROAD"
2,1,1,"38c73b4a-32f4-ea11-b882-24ee9a37d45c","Corona Arts & Sciences Academy - Q311 - Q311 - 24Q311 - 98-11 44TH AVENUE","36c73b4a-32f4-ea11-b882-24ee9a37d45c",-73865239,40745920,"P.S./ I.S. 311 - QUEENS","98-11 44TH AVENUE"
1,1,0,"c792e6d5-30f4-ea11-b882-24ee9a37d45c","Multicultural High School - K583 - K420 - 19K583 - 999 JAMAICA AVENUE","c692e6d5-30f4-ea11-b882-24ee9a37d45c",-73869305,40693002,"FRANKLIN K. LANE HS - K","999 JAMAICA AVENUE"
2,1,1,"a70e6e25-32f4-ea11-b882-24ee9a37d45c","P.S. 181 Brookfield - Q181 - Q181 - 29Q181 - 148-15 230 Street","a80e6e25-32f4-ea11-b882-24ee9a37d45c",-73752948,40655674,"P.S. 181 - QUEENS","148-15 230 Street"
1,0,1,"5f3cbf01-ebf6-ea11-b883-24ee9a37d459","P.S. X010 - X010 - X101 - 75X010 - 2750 LAFAYETTE AVENUE","4e474313-33f4-ea11-b882-24ee9a37d45c",-73829211,40827080,"I.S. 101 - BRONX","2750 LAFAYETTE AVENUE"
1,1,0,"21c73b4a-32f4-ea11-b882-24ee9a37d45c","Helen M. Marshall School - Q330 - Q287 - 24Q330 - 110-08 NORTHERN BOULEVARD","20c73b4a-32f4-ea11-b882-24ee9a37d45c",-73859202,40757888,"P.S. 330 - QUEENS","110-08 NORTHERN BOULEVARD"
2,0,2,"e0e0838c-31f4-ea11-b882-24ee9a37d45c","P.S. 051 Elias Howe - M051 - M338 - 02M051 - 525 WEST 44TH STREET","dfe0838c-31f4-ea11-b882-24ee9a37d45c",-73995825,40761487,"P.S. 51 ELIAS HOWE - MANHATTAN","525 WEST 44TH STREET"
1,1,0,"191bad3c-30f4-ea11-b882-24ee9a37d45c","Fort Greene Preparatory Academy - K691 - K046 - 13K691 - 100 CLERMONT AVENUE","1a1bad3c-30f4-ea11-b882-24ee9a37d45c",-73971644,40694530,"P.S. 46 - BROOKLYN","100 CLERMONT AVENUE"
1,1,0,"23ff3d8d-33f4-ea11-b882-24ee9a37d45c","Bronx Leadership Academy High School - X525 - X876 - 09X525 - 1710 Webster Avenue","24ff3d8d-33f4-ea11-b882-24ee9a37d45c",-73902969,40843250,"BRONX LEADERSHIP ACADEMY - BRONX","1710 Webster Avenue"
1,1,0,"7303194f-30f4-ea11-b882-24ee9a37d45c","P.S. 69 Vincent D. Grippo School - K069 - K069 - 20K069 - 6302 9TH AVENUE","7203194f-30f4-ea11-b882-24ee9a37d45c",-74009752,40632392,"P.S. 69 - BROOKLYN","6302 9TH AVENUE"
1,1,0,"ad9c11e8-30f4-ea11-b882-24ee9a37d45c","High School for Public Service: Heroes of Tomorrow - K546 - K470 - 17K546 - 600 KINGSTON AVENUE","aa9c11e8-30f4-ea11-b882-24ee9a37d45c",-73943839,40658671,"GEORGE W. WINGATE HS - K","600 KINGSTON AVENUE"
2,0,2,"34e85c61-30f4-ea11-b882-24ee9a37d45c","P.S. 116 Elizabeth L Farrell - K116 - K116 - 32K116 - 515 KNICKERBOCKER AVENUE","35e85c61-30f4-ea11-b882-24ee9a37d45c",-73916563,40698077,"P.S. 116 - BROOKLYN","515 KNICKERBOCKER AVENUE"
1,0,1,"5ade5eb7-30f4-ea11-b882-24ee9a37d45c","P.S. 306 Ethan Allen - K306 - K306 - 19K306 - 970 VERMONT STREET","59de5eb7-30f4-ea11-b882-24ee9a37d45c",-73886620,40655340,"P.S. 306 - BROOKLYN","970 VERMONT STREET"
3,3,0,"2bb4977a-32f4-ea11-b882-24ee9a37d45c","Queens High School of Teaching, Liberal Arts and the Sciences - Q566 - Q566 - 26Q566 - 74-20 COMMONWEALTH BLVD","27b4977a-32f4-ea11-b882-24ee9a37d45c",-73728834,40744197,"QNS HS OF TEACH., LIB. ARTS&SCI-Q","74-20 COMMONWEALTH BLVD"
2,2,0,"66b50aa5-30f4-ea11-b882-24ee9a37d45c","P.S. 261 Zipporiah Mills - K261 - K261 - 15K261 - 314 PACIFIC STREET","5fb50aa5-30f4-ea11-b882-24ee9a37d45c",-73988667,40687218,"P.S. 261 - BROOKLYN","314 PACIFIC STREET"
2,2,0,"7d53dd74-33f4-ea11-b882-24ee9a37d45c","Bronx Compass High School - X561 - X450 - 08X561 - 1980 LAFAYETTE AVENUE","62ffcc6e-33f4-ea11-b882-24ee9a37d45c",-73855930,40821218,"Adlai E. Stevenson Educational Campus","1980 LAFAYETTE AVENUE"
4,2,2,"4c9d7c62-33f4-ea11-b882-24ee9a37d45c","High School of Language and Innovation - X509 - X415 - 11X509 - 925 ASTOR AVENUE","439d7c62-33f4-ea11-b882-24ee9a37d45c",-73860729,40860443,"CHRISTOPHER COLUMBUS HS - X","925 ASTOR AVENUE"
2,0,2,"16a198c3-30f4-ea11-b882-24ee9a37d45c","P.S./I.S. 30 Mary White Ovington - K030 - K331 - 20K030 - 7002 4TH AVENUE","15a198c3-30f4-ea11-b882-24ee9a37d45c",-74023950,40633598,"P.S./I.S.30 MARY WHITE OVINGTON - BROOKLYN","7002 4TH AVENUE"
1,0,1,"4e9d7c62-33f4-ea11-b882-24ee9a37d45c","Pelham Preparatory Academy - X542 - X415 - 11X542 - 925 ASTOR AVENUE","439d7c62-33f4-ea11-b882-24ee9a37d45c",-73860729,40860443,"CHRISTOPHER COLUMBUS HS - X","925 ASTOR AVENUE"
1,1,0,"d5e0838c-31f4-ea11-b882-24ee9a37d45c","Lower Manhattan Community Middle School - M896 - M282 - 02M896 - 26 BROADWAY","d1e0838c-31f4-ea11-b882-24ee9a37d45c",-74013303,40705688,"BROADWAY EDUCATION CAMPUS - M","26 BROADWAY"
1,1,0,"0878931f-33f4-ea11-b882-24ee9a37d45c","Young Women's Leadership School of the Bronx - X568 - X117 - 09X568 - 1865 MORRIS AVENUE","0578931f-33f4-ea11-b882-24ee9a37d45c",-73909022,40848552,"I.S. 117 - BRONX","1865 MORRIS AVENUE"
3,0,3,"380d6d19-33f4-ea11-b882-24ee9a37d45c","P.S. 105 Sen Abraham Bernstein - X105 - X105 - 11X105 - 725 Brady Avenue","390d6d19-33f4-ea11-b882-24ee9a37d45c",-73866264,40853075,"P.S. 105 - BRONX","725 Brady Avenue"
3,2,1,"46de5eb7-30f4-ea11-b882-24ee9a37d45c","Vista Academy - K661 - K302 - 19K661 - 350 LINWOOD STREET","42de5eb7-30f4-ea11-b882-24ee9a37d45c",-73884211,40677112,"I.S. 302 - BROOKLYN","350 LINWOOD STREET"
1,1,0,"b5bfa431-33f4-ea11-b882-24ee9a37d45c","Kappa - X215 - X148 - 09X215 - 3630 THIRD AVENUE","b0bfa431-33f4-ea11-b882-24ee9a37d45c",-73903951,40833493,"I.S. 219 (OLD 148) - BRONX","3630 THIRD AVENUE"
1,1,0,"a153dd74-33f4-ea11-b882-24ee9a37d45c","New Visions Charter High School for Advanced Math and Science - X539 - X475 - 84X539 - 99 TERRACE VIEW AVENUE","9853dd74-33f4-ea11-b882-24ee9a37d45c",-73912686,40877379,"JOHN F. KENNEDY HS - X","99 TERRACE VIEW AVENUE"
