"TotalCases","StudentCases","EmployeeCases","nycsr_locationsiteid","nycsr_sitename","nycsr_building.nycsr_buildingid","nycsr_building.nycsr_longitude","nycsr_building.nycsr_latitude","nycsr_building.nycsr_buildingname","nycsr_building.nycsr_address"
12,0,12,"18f32ce2-31f4-ea11-b882-24ee9a37d45c","P.S. 019 Marino Jeantet - Q019 - Q019 - 24Q019 - 98-02 ROOSEVELT AVENUE","19f32ce2-31f4-ea11-b882-24ee9a37d45c",-73866557,40748600,"P.S. 19 - QUEENS","98-02 ROOSEVELT AVENUE"
2,0,2,"6a5bc58c-30f4-ea11-b882-24ee9a37d45c","J.H.S. 220 John J. Pershing - K220 - K220 - 20K220 - 4812 9TH AVENUE","695bc58c-30f4-ea11-b882-24ee9a37d45c",-74001250,40640997,"I.S. 220 - BROOKLYN","4812 9TH AVENUE"
5,0,5,"3a767649-31f4-ea11-b882-24ee9a37d45c","P.S. 028 Wright Brothers - M028 - M028 - 06M028 - 475 WEST 155 STREET","3b767649-31f4-ea11-b882-24ee9a37d45c",-73942023,40831630,"P.S. 28 - MANHATTAN","475 WEST 155 STREET"
4,0,4,"3c9f4974-31f4-ea11-b882-24ee9a37d45c","P.S. 142 Amalia Castro - M142 - M142 - 01M142 - 100 ATTORNEY STREET","379f4974-31f4-ea11-b882-24ee9a37d45c",-73984116,40718121,"P.S. 142 - MANHATTAN","100 ATTORNEY STREET"
2,0,2,"470410ca-32f4-ea11-b882-24ee9a37d45c","The Harbor View School - R059 - R059 - 31R059 - 300 Richmond Terrace","480410ca-32f4-ea11-b882-24ee9a37d45c",-74083408,40647898,"THE HARBOR VIEW SCHOOL - STATEN ISLAND","300 Richmond Terrace"
1,1,0,"e4454b50-32f4-ea11-b882-24ee9a37d45c","Learners and Leaders - Q305 - Q320 - 24Q305 - 360 SENECA AVENUE","e5454b50-32f4-ea11-b882-24ee9a37d45c",-73915359,40707343,"P.S. 320 - QUEENS","360 SENECA AVENUE"
7,4,3,"3b0d6d19-33f4-ea11-b882-24ee9a37d45c","P.S. 106 Parkchester - X106 - X106 - 11X106 - 1514 OLMSTEAD AVENUE","3c0d6d19-33f4-ea11-b882-24ee9a37d45c",-73854823,40836974,"P.S. 106 - BRONX","1514 OLMSTEAD AVENUE"
1,0,1,"bde0838c-31f4-ea11-b882-24ee9a37d45c","Washington Heights Academy - M366 - M263 - 06M366 - 202 SHERMAN AVE","bee0838c-31f4-ea11-b882-24ee9a37d45c",-73921631,40865575,"PS/IS 263 - Manhattan","202 SHERMAN AVE"
3,0,3,"b0edf392-32f4-ea11-b882-24ee9a37d45c","P.S. 060 Woodhaven - Q060 - Q860 - 27Q060 - 91-02 88 AVENUE","b1edf392-32f4-ea11-b882-24ee9a37d45c",-73852792,40691467,"P.S. 60 MINISCHOOL - QUEENS","91-02 88 AVENUE"
3,2,1,"172ed53d-33f4-ea11-b882-24ee9a37d45c","P.S. 214 - X214 - X167 - 12X214 - 1970 WEST FARMS ROAD","152ed53d-33f4-ea11-b882-24ee9a37d45c",-73879931,40839297,"P.S. 214 - BRONX","1970 WEST FARMS ROAD"
1,0,1,"d4d81655-6a01-ed11-b8db-24ee9a37d45c","A School Without Walls - K960 - K802 - 33K960 - 131 LIVINGSTON STREET","d5d81655-6a01-ed11-b8db-24ee9a37d45c",-73988475,40691075,"CENT HEADQTRS (131 LIV) - K","131 LIVINGSTON STREET"
1,1,0,"07ca024b-84ef-eb11-b8b1-24ee9a37d45c","P.S. Q177 - Q177 - Q435 - 75Q177 - 230-17 HILLSIDE AVENUE","c4b66262-32f4-ea11-b882-24ee9a37d45c",-73739726,40733888,"MARTIN VAN BUREN HS - QUEENS","230-17 HILLSIDE AVENUE"
2,1,1,"692f77fa-31f4-ea11-b882-24ee9a37d45c","P.S. 063 Old South - Q063 - Q063 - 27Q063 - 90-15 SUTTER AVENUE","6a2f77fa-31f4-ea11-b882-24ee9a37d45c",-73846796,40676978,"P.S. 63 - QUEENS","90-15 SUTTER AVENUE"
2,2,0,"21b4977a-32f4-ea11-b882-24ee9a37d45c","International High School at LaGuardia Community College - Q530 - Q520 - 24Q530 - 45-35 VAN DAM STREET","22b4977a-32f4-ea11-b882-24ee9a37d45c",-73933316,40743253,"MIDDLE COLLEGE CAMPUS - QUEENS","45-35 VAN DAM STREET"
1,0,1,"5fbe7adc-32f4-ea11-b882-24ee9a37d45c","Concord High School - R470 - R470 - 31R470 - 109 RHINE AVENUE","60be7adc-32f4-ea11-b882-24ee9a37d45c",-74087072,40610620,"CONCORD HS (OLD 12) - S.I.","109 RHINE AVENUE"
1,0,1,"0678931f-33f4-ea11-b882-24ee9a37d45c","I.S. 117 Joseph H. Wade - X117 - X117 - 09X117 - 1865 MORRIS AVENUE","0578931f-33f4-ea11-b882-24ee9a37d45c",-73909022,40848552,"I.S. 117 - BRONX","1865 MORRIS AVENUE"
2,1,1,"4c9d7c62-33f4-ea11-b882-24ee9a37d45c","High School of Language and Innovation - X509 - X415 - 11X509 - 925 ASTOR AVENUE","439d7c62-33f4-ea11-b882-24ee9a37d45c",-73860729,40860443,"CHRISTOPHER COLUMBUS HS - X","925 ASTOR AVENUE"
3,2,1,"bd69c231-32f4-ea11-b882-24ee9a37d45c","P.S. 212 - Q212 - Q212 - 30Q212 - 34-25 82 STREET","b969c231-32f4-ea11-b882-24ee9a37d45c",-73884458,40753035,"P.S. 212 - QUEENS","34-25 82 STREET"
1,0,1,"aa2aa42b-33f4-ea11-b882-24ee9a37d45c","Baychester Middle School - X532 - X142 - 11X532 - 3750 BAYCHESTER AVENUE","a32aa42b-33f4-ea11-b882-24ee9a37d45c",-73839682,40886002,"I.S. 142 - BRONX","3750 BAYCHESTER AVENUE"
1,0,1,"be689025-33f4-ea11-b882-24ee9a37d45c","Kappa III - X316 - X129 - 12X316 - 2055 MAPES AVENUE","bf689025-33f4-ea11-b882-24ee9a37d45c",-73886721,40846128,"I.S. 129 (PAIRED W P234) - BRONX","2055 MAPES AVENUE"
1,0,1,"69edfc72-4afb-ea11-b883-24ee9a37d459","OUR SAVIOUR LUTHERAN - QAXQ - QAXQ -  - 90-04 175TH STREET","6aedfc72-4afb-ea11-b883-24ee9a37d459",-73786925,40709647,"OUR SAVIOUR LUTHERAN","90-04 175TH STREET"
9,7,2,"13ba8b86-30f4-ea11-b882-24ee9a37d45c","P.S. 206 Joseph F Lamb - K206 - K206 - 22K206 - 2200 GRAVESEND NECK ROAD","14ba8b86-30f4-ea11-b882-24ee9a37d45c",-73948453,40596876,"P.S. 206 - BROOKLYN","2200 GRAVESEND NECK ROAD"
3,3,0,"167eed06-32f4-ea11-b882-24ee9a37d45c","P.S. 088 Seneca - Q088 - Q088 - 24Q088 - 60-85 CATALPA AVENUE","177eed06-32f4-ea11-b882-24ee9a37d45c",-73896437,40704105,"P.S. 88 - QUEENS","60-85 CATALPA AVENUE"
3,2,1,"96d91731-31f4-ea11-b882-24ee9a37d45c","Brooklyn Urban Garden Charter School - K758 - KBNU - 84K758 - 500 19 Street","97d91731-31f4-ea11-b882-24ee9a37d45c",-73982624,40656202,"STANLEY LAMM INSTITUE PRE-SCHOOL OF LONGISLAND HO","500 19 Street"
2,0,2,"6636d900-33f4-ea11-b882-24ee9a37d45c","P.S./I.S. 54 - X054 - X054 - 10X054 - 2703 WEBSTER AVENUE","6736d900-33f4-ea11-b882-24ee9a37d45c",-73887940,40864872,"P.S. 54 - BRONX","2703 WEBSTER AVENUE"
8,4,4,"dd9b4c1f-32f4-ea11-b882-24ee9a37d45c","P.S. 152 Gwendoline N. Alleyne School - Q152 - Q152 - 30Q152 - 33-52 62 STREET","de9b4c1f-32f4-ea11-b882-24ee9a37d45c",-73900584,40753094,"P.S. 152 - QUEENS","33-52 62 STREET"
1,0,1,"46b4977a-32f4-ea11-b882-24ee9a37d45c","Aviation Career & Technical Education High School - Q610 - Q610 - 24Q610 - 45-30 36 STREET","44b4977a-32f4-ea11-b882-24ee9a37d45c",-73929577,40743309,"AVIATION HS - Q","45-30 36 STREET"
3,2,1,"16a31781-33f4-ea11-b882-24ee9a37d45c","Bronx Leadership Academy II High School - X527 - X790 - 07X527 - 730 CONCOURSE VILLAGE WEST","0ea31781-33f4-ea11-b882-24ee9a37d45c",-73922366,40821828,"MOTT HAVEN EDUCATIONAL CAMPUS - BRONX","730 CONCOURSE VILLAGE WEST"
3,2,1,"d08521d0-32f4-ea11-b882-24ee9a37d45c","Port Richmond School for Visionary Learning - R068 - R066 - 31R068 - 1625 FOREST AVENUE","d18521d0-32f4-ea11-b882-24ee9a37d45c",-74142526,40624781,"ECC @1625 FOREST AVENUE - STATEN ISLAND","1625 FOREST AVENUE"
6,5,1,"4c8dbfcf-30f4-ea11-b882-24ee9a37d45c","Midwood High School - K405 - K405 - 22K405 - 2839 BEDFORD AVENUE","4d8dbfcf-30f4-ea11-b882-24ee9a37d45c",-73952356,40632829,"MIDWOOD HS - K","2839 BEDFORD AVENUE"
1,0,1,"44ff3d8d-33f4-ea11-b882-24ee9a37d45c","High School of American Studies at Lehman College - X696 - X905 - 10X696 - 2925 Goulden Avenue","45ff3d8d-33f4-ea11-b882-24ee9a37d45c",-73895543,40874725,"HS OF AMERICAN STUDIES - BRONX","2925 Goulden Avenue"
3,0,3,"827e21a6-ebf6-ea11-b883-24ee9a37d459","P.S. Q004 - Q004 - Q270 - 75Q004 - 233-15 MERRICK BOULEVARD","52a10a44-32f4-ea11-b882-24ee9a37d45c",-73736232,40675070,"P.S. 270 - QUEENS","233-15 MERRICK BOULEVARD"
1,1,0,"af2ff20c-32f4-ea11-b882-24ee9a37d45c","P.S. 105 The Bay School - Q105 - Q105 - 27Q105 - 420 BEACH 51 STREET","b02ff20c-32f4-ea11-b882-24ee9a37d45c",-73780961,40595911,"P.S. 105 - QUEENS","420 BEACH 51 STREET"
2,0,2,"b82ff20c-32f4-ea11-b882-24ee9a37d45c","P.S. 108 Captain Vincent G. Fowler - Q108 - Q108 - 27Q108 - 108-10 109 AVENUE","b92ff20c-32f4-ea11-b882-24ee9a37d45c",-73831025,40679083,"P.S. 108 - QUEENS","108-10 109 AVENUE"
2,1,1,"8734aa92-31f4-ea11-b882-24ee9a37d45c","Urban Assembly Academy of Government and Law, The - M305 - M445 - 02M305 - 350 GRAND STREET","8834aa92-31f4-ea11-b882-24ee9a37d45c",-73989329,40717329,"SEWARD PARK HS - MANHATTAN","350 GRAND STREET"
1,0,1,"026e3d68-31f4-ea11-b882-24ee9a37d45c","P.S. 110 Florence Nightingale - M110 - M110 - 01M110 - 285 DELANCY STREET","036e3d68-31f4-ea11-b882-24ee9a37d45c",-73979800,40716200,"P.S. 110 - MANHATTAN","285 DELANCY STREET"
3,1,2,"7aa9d9c3-32f4-ea11-b882-24ee9a37d45c","P.S. 029 Bardwell - R029 - R029 - 31R029 - 1581 VICTORY BOULEVARD","7ba9d9c3-32f4-ea11-b882-24ee9a37d45c",-74116197,40614039,"P.S. 29 - STATEN ISLAND","1581 VICTORY BOULEVARD"
5,0,5,"347c21b7-32f4-ea11-b882-24ee9a37d45c","P.S. 003 The Margaret Gioiosa School - R003 - R003 - 31R003 - 80 SOUTH GOFF AVENUE","357c21b7-32f4-ea11-b882-24ee9a37d45c",-74211850,40520812,"P.S. 3 - STATEN ISLAND","80 SOUTH GOFF AVENUE"
4,3,1,"56767649-31f4-ea11-b882-24ee9a37d45c","P.S. 042 Benjamin Altman - M042 - M042 - 02M042 - 71 HESTER STREET","51767649-31f4-ea11-b882-24ee9a37d45c",-73990826,40716126,"P.S. 42 - MANHATTAN","71 HESTER STREET"
5,3,2,"a32ff20c-32f4-ea11-b882-24ee9a37d45c","P.S. 101 School in the Gardens - Q101 - Q101 - 28Q101 - 2 RUSSELL PLACE","a42ff20c-32f4-ea11-b882-24ee9a37d45c",-73843400,40715543,"P.S. 101 - QUEENS","2 RUSSELL PLACE"
3,2,1,"d0e0838c-31f4-ea11-b882-24ee9a37d45c","Richard R. Green High School of Teaching - M580 - M282 - 02M580 - 7 BEAVER STREET","d1e0838c-31f4-ea11-b882-24ee9a37d45c",-74013303,40705688,"BROADWAY EDUCATION CAMPUS - M","26 BROADWAY"
2,1,1,"7ef4a0ef-eaf6-ea11-b883-24ee9a37d459","P.S. K721 - Brooklyn Occupational Training Center - K721 - K722 - 75K721 - 64 AVENUE X","392f7d06-31f4-ea11-b882-24ee9a37d45c",-73981925,40588070,"P.S. 721 OTC - BROOKLYN","64 AVENUE X"
2,1,1,"810e6e25-32f4-ea11-b882-24ee9a37d45c","BELL Academy - Q294 - Q169 - 25Q294 - 18-25 212 STREET","820e6e25-32f4-ea11-b882-24ee9a37d45c",-73778430,40782331,"P.S. 169 - QUEENS","18-25 212 STREET"
2,2,0,"cee0838c-31f4-ea11-b882-24ee9a37d45c","The River School - M281 - M281 - 02M281 - 425 East 35 Street","cde0838c-31f4-ea11-b882-24ee9a37d45c",-73972592,40744288,"P.S. 281 - MANHATTAN","425 East 35 Street"
1,1,0,"d39b4c1f-32f4-ea11-b882-24ee9a37d45c","P.S. 149 Christa McAuliffe - Q149 - Q149 - 30Q149 - 93-11 34 AVENUE","f3883319-32f4-ea11-b882-24ee9a37d45c",-73874505,40755759,"P.S. 149 - QUEENS","93-11 34 AVENUE"
1,0,1,"d0fab455-31f4-ea11-b882-24ee9a37d45c","The STAR Academy - P.S.63 - M063 - M063 - 01M063 - 121 EAST 3 STREET","cefab455-31f4-ea11-b882-24ee9a37d45c",-73986214,40724440,"P.S. 63 - MANHATTAN","121 EAST 3 STREET"
1,0,1,"ab8fd48d-ebf6-ea11-b883-24ee9a37d459","P.S. Q993 - Q993 - Q041 - 75Q993 - 214-43 35 AVENUE","e58442ee-31f4-ea11-b882-24ee9a37d45c",-73771225,40770155,"P.S. 41 - QUEENS","214-43 35 AVENUE"
2,2,0,"43fdc1bd-32f4-ea11-b882-24ee9a37d45c","I.S. 007 Elias Bernstein - R007 - R007 - 31R007 - 1270 Huguenot Avenue","447c21b7-32f4-ea11-b882-24ee9a37d45c",-74186096,40522971,"I.S. 7 - STATEN ISLAND","1270 Huguenot Avenue"
2,2,0,"722f77fa-31f4-ea11-b882-24ee9a37d45c","J.H.S. 067 Louis Pasteur - Q067 - Q067 - 26Q067 - 51-60 MARATHON PARKWAY","732f77fa-31f4-ea11-b882-24ee9a37d45c",-73734832,40762241,"J.H.S. 67 - QUEENS","51-60 MARATHON PARKWAY"
2,0,2,"a0dab801-ecf6-ea11-b883-24ee9a37d459","P.S. X721 - Stephen McSweeney School - X721 - X423 - 75X721 - 1551 EAST 172ND STREET","639d7c62-33f4-ea11-b882-24ee9a37d45c",-73878191,40832508,"JAMES MONROE HS CAMPUS ANNEX - BRONX","1551 EAST 172ND STREET"
4,2,2,"f4201dab-30f4-ea11-b882-24ee9a37d45c","I.S. 281 Joseph B Cavallaro - K281 - K281 - 21K281 - 8787 24 AVENUE","f2201dab-30f4-ea11-b882-24ee9a37d45c",-73993565,40594648,"I.S. 281 - BROOKLYN","8787 24 AVENUE"
3,3,0,"6cbc9674-32f4-ea11-b882-24ee9a37d45c","John Adams High School - Q480 - Q480 - 27Q480 - 101-01 ROCKAWAY BOULEVARD","6abc9674-32f4-ea11-b882-24ee9a37d45c",-73838616,40680065,"JOHN ADAMS HS - QUEENS","101-01 ROCKAWAY BOULEVARD"
3,3,0,"a82aa42b-33f4-ea11-b882-24ee9a37d45c","Bronx Alliance Middle School - X355 - X142 - 11X355 - 3750 BAYCHESTER AVENUE","a32aa42b-33f4-ea11-b882-24ee9a37d45c",-73839682,40886002,"I.S. 142 - BRONX","3750 BAYCHESTER AVENUE"
1,1,0,"310410ca-32f4-ea11-b882-24ee9a37d45c","P.S. 052 John C. Thompson - R052 - R052 - 31R052 - 450 BUEL AVENUE","320410ca-32f4-ea11-b882-24ee9a37d45c",-74089012,40582550,"P.S. 52 - STATEN ISLAND","450 BUEL AVENUE"
12,11,1,"5d07e99e-31f4-ea11-b882-24ee9a37d45c","Stuyvesant High School - M475 - M477 - 02M475 - 345 CHAMBERS STREET","5c07e99e-31f4-ea11-b882-24ee9a37d45c",-74013921,40718025,"STUYVESANT HS (NEW) - MANHATTAN","345 CHAMBERS STREET"
3,2,1,"cc8442ee-31f4-ea11-b882-24ee9a37d45c","P.S. 033 Edward M. Funk - Q033 - Q033 - 29Q033 - 91-37 222 STREET","cd8442ee-31f4-ea11-b882-24ee9a37d45c",-73734102,40727172,"P.S. 33 - QUEENS","91-37 222 STREET"
2,0,2,"0a6e3d68-31f4-ea11-b882-24ee9a37d45c","P.S. 112 Jose Celso Barbosa - M112 - M112 - 04M112 - 535 EAST 119 STREET","0b6e3d68-31f4-ea11-b882-24ee9a37d45c",-73930528,40796889,"P.S. 112 (TANDEM M206) - MANHATTAN","535 EAST 119 STREET"
1,0,1,"8436d900-33f4-ea11-b882-24ee9a37d45c","P.S. 062 Inocensio Casanova - X062 - X062 - 08X062 - 660 FOX STREET","8336d900-33f4-ea11-b882-24ee9a37d45c",-73900161,40813736,"P.S. 62 - BRONX","660 FOX STREET"
2,1,1,"e09b4c1f-32f4-ea11-b882-24ee9a37d45c","P.S. 153 Maspeth Elem - Q153 - Q153 - 24Q153 - 60-02 60 LANE","e19b4c1f-32f4-ea11-b882-24ee9a37d45c",-73904463,40716296,"P.S. 153 - QUEENS","60-02 60 LANE"
4,0,4,"eed10307-33f4-ea11-b882-24ee9a37d45c","P.S. 070 Max Schoenfeld - X070 - X070 - 09X070 - 1691 WEEKS AVENUE","efd10307-33f4-ea11-b882-24ee9a37d45c",-73908070,40844236,"P.S. 70 - BRONX","1691 WEEKS AVENUE"
6,4,2,"d79b4c1f-32f4-ea11-b882-24ee9a37d45c","P.S. 150 Queens - Q150 - Q150 - 30Q150 - 40-01 43 AVENUE","d89b4c1f-32f4-ea11-b882-24ee9a37d45c",-73923375,40745887,"P.S. 150 - QUEENS","40-01 43 AVENUE"
2,2,0,"4e2b3eee-30f4-ea11-b882-24ee9a37d45c","The Christa McAuliffe School\I.S. 187 - K187 - K486 - 20K187 - 1171 65 STREET","4f2b3eee-30f4-ea11-b882-24ee9a37d45c",-74003883,40627929,"I.S. 187 - BROOKLYN","1171 65 STREET"
1,0,1,"e79319d7-ebf6-ea11-b883-24ee9a37d459","The Richard H. Hungerford School - R721 - R435 - 75R721 - 465 NEW DORP LANE","fb8521d0-32f4-ea11-b882-24ee9a37d45c",-74105878,40570909,"NEW DORP HS (NEW) - S. I.","465 NEW DORP LANE"
1,0,1,"68f4a0ef-eaf6-ea11-b883-24ee9a37d459","P.S. K811 Connie Lekas School - K811 - K286 - 75K811 - 2525 HARING STREET","6e283fb1-30f4-ea11-b882-24ee9a37d45c",-73938610,40591132,"P.S. 811 (OLD P286) - BROOKLYN","2525 HARING STREET"
4,3,1,"0d0410ca-32f4-ea11-b882-24ee9a37d45c","The Stephanie A. Vierno School - R041 - R041 - 31R041 - 216 CLAWSON STREET","0e0410ca-32f4-ea11-b882-24ee9a37d45c",-74108492,40573599,"P.S. 41 - STATEN ISLAND","216 CLAWSON STREET"
13,11,2,"fcae0313-32f4-ea11-b882-24ee9a37d45c","I.S. 125 Thom J. McCann Woodside - Q125 - Q125 - 24Q125 - 46-02 47 AVENUE","fdae0313-32f4-ea11-b882-24ee9a37d45c",-73918762,40740452,"I.S. 125 - QUEENS","46-02 47 AVENUE"
3,0,3,"1ae2abc9-30f4-ea11-b882-24ee9a37d45c","P.S. 380 John Wayne Elementary - K380 - K380 - 14K380 - 370 MARCY AVENUE","19e2abc9-30f4-ea11-b882-24ee9a37d45c",-73953702,40701790,"P.S. 380 - BROOKLYN","370 MARCY AVENUE"
1,0,1,"12ae38fc-7001-ed11-b8db-24ee9a37d45c","The Richard H. Hungerford School - R721 - R086 - 75R721 - 715 L Ocean Terrace","713f38e4-e9e5-ec11-b8d9-24ee9a37d45c",-74108045,40608374,"I.S./H.S. @ 715L OCEAN TERRACE - STATEN ISLAND","715 L Ocean Terrace"
2,1,1,"bbbfa431-33f4-ea11-b882-24ee9a37d45c","The Laboratory School of Finance and Technology: X223 - X223 - X149 - 07X223 - 360 EAST 145 STREET","bcbfa431-33f4-ea11-b882-24ee9a37d45c",-73920851,40813612,"J.H.S. 149 - BRONX","360 EAST 145 STREET"
3,0,3,"ba9c11e8-30f4-ea11-b882-24ee9a37d45c","The Academy of Urban Planning and Engineering - K552 - K480 - 32K552 - 400 IRVING AVENUE","b39c11e8-30f4-ea11-b882-24ee9a37d45c",-73911751,40696457,"BUSHWICK EDUCATIONAL CAMPUS - K","400 IRVING AVENUE"
2,0,2,"ebb98b86-30f4-ea11-b882-24ee9a37d45c","P.S. 194 Raoul Wallenberg - K194 - K194 - 22K194 - 3117 AVENUE W","ecb98b86-30f4-ea11-b882-24ee9a37d45c",-73934163,40598069,"P.S. 194 - BROOKLYN","3117 AVENUE W"
2,2,0,"60b50aa5-30f4-ea11-b882-24ee9a37d45c","J.H.S. 259 William McKinley - K259 - K259 - 20K259 - 7305 Ft Hamilton Parkway","61b50aa5-30f4-ea11-b882-24ee9a37d45c",-74014633,40626089,"I.S. 259 - BROOKLYN","7305 Ft Hamilton Parkway"
2,1,1,"7e8d8486-31f4-ea11-b882-24ee9a37d45c","P.S. 198 Isador E. Ida Straus - M198 - M198 - 02M198 - 1700 3 AVENUE","7f8d8486-31f4-ea11-b882-24ee9a37d45c",-73950420,40785018,"P.S. 198 - MANHATTAN","1700 3 AVENUE"
2,1,1,"cbd27c6d-30f4-ea11-b882-24ee9a37d45c","P.S. 139 Alexine A. Fenty - K139 - K139 - 22K139 - 330 RUGBY ROAD","cad27c6d-30f4-ea11-b882-24ee9a37d45c",-73965862,40641340,"P.S. 139 - BROOKLYN","330 RUGBY ROAD"
1,0,1,"e9e0a4fb-ebf6-ea11-b883-24ee9a37d459","P.S. X721 - Stephen McSweeney School - X721 - X368 - 75X721 - 2975 TIBBETT AVENUE","74e03d56-33f4-ea11-b882-24ee9a37d45c",-73913694,40877935,"M.S./H.S. 368 - BRONX","2975 TIBBETT AVENUE"
1,0,1,"17af0313-32f4-ea11-b882-24ee9a37d45c","P.S. 134 Hollis - Q134 - Q134 - 29Q134 - 203-02 109 Avenue","10af0313-32f4-ea11-b882-24ee9a37d45c",-73754747,40707535,"P.S. 134 - QUEENS","203-02 109 Avenue"
4,3,1,"69fdc1bd-32f4-ea11-b882-24ee9a37d45c","P.S. 022 Graniteville - R022 - R022 - 31R022 - 1860 Forest Avenue","6afdc1bd-32f4-ea11-b882-24ee9a37d45c",-74150544,40624847,"P.S. 22 - STATEN ISLAND","1860 Forest Avenue"
2,1,1,"66e2635c-32f4-ea11-b882-24ee9a37d45c","Hunters Point Community Middle School - Q291 - Q404 - 30Q291 - 1-50 51ST AVENUE","65e2635c-32f4-ea11-b882-24ee9a37d45c",-73959183,40742964,"HUNTERS POINT CAMPUS - QUEENS","1-50 51ST AVENUE"
6,3,3,"dc0d3c5b-30f4-ea11-b882-24ee9a37d45c","P.S./I.S. 104 The Fort Hamilton School - K104 - K104 - 20K104 - 9115 5 AVENUE","dd0d3c5b-30f4-ea11-b882-24ee9a37d45c",-74028492,40618077,"P.S. 104 - BROOKLYN","9115 5 AVENUE"
1,0,1,"8c53dd74-33f4-ea11-b882-24ee9a37d45c","Bronx School for Law, Government and Justice - X505 - X460 - 09X505 - 244 EAST 163 STREET","8d53dd74-33f4-ea11-b882-24ee9a37d45c",-73919024,40827461,"HS OF LAW, GOV'T & JUSTICE - X","244 EAST 163 STREET"
1,0,1,"d18fd20d-ebf6-ea11-b883-24ee9a37d459","Adult and Continuing Education - K755 - K002 - 79K755 - 655 Parkside Avenue","dfc1392a-30f4-ea11-b882-24ee9a37d45c",-73951575,40656423,"I.S. 2 - BROOKLYN","655 Parkside Avenue"
4,2,2,"6ba5db98-30f4-ea11-b882-24ee9a37d45c","Mark Twain I.S. 239 for the Gifted & Talented - K239 - K239 - 21K239 - 2401 NEPTUNE AVENUE","6ca5db98-30f4-ea11-b882-24ee9a37d45c",-73992447,40578640,"I.S. 239 - BROOKLYN","2401 NEPTUNE AVENUE"
1,1,0,"c6b66262-32f4-ea11-b882-24ee9a37d45c","Business Technology Early College High School - Q315 - Q435 - 26Q315 - 230-17 HILLSIDE AVENUE","c4b66262-32f4-ea11-b882-24ee9a37d45c",-73739726,40733888,"MARTIN VAN BUREN HS - QUEENS","230-17 HILLSIDE AVENUE"
6,6,0,"6ce2635c-32f4-ea11-b882-24ee9a37d45c","Bayside High School - Q495 - Q405 - 26Q495 - 32-24 CORPORAL KENNEDY STREET","6be2635c-32f4-ea11-b882-24ee9a37d45c",-73781041,40771398,"BAYSIDE HS - Q","32-24 CORPORAL KENNEDY STREET"
2,1,1,"400410ca-32f4-ea11-b882-24ee9a37d45c","P.S. 057 Hubert H. Humphrey - R057 - R057 - 31R057 - 140 PALMA DRIVE","410410ca-32f4-ea11-b882-24ee9a37d45c",-74083799,40611136,"P.S. 57 - STATEN ISLAND","140 PALMA DRIVE"
1,0,1,"f6d10307-33f4-ea11-b882-24ee9a37d45c","P.S. 072 Dr. William Dorney - X072 - X072 - 08X072 - 2951 DEWEY AVENUE","f4d10307-33f4-ea11-b882-24ee9a37d45c",-73818172,40823237,"P.S. 72 - BRONX","2951 DEWEY AVENUE"
1,0,1,"5af4a0ef-eaf6-ea11-b883-24ee9a37d459","P.S. K771 - K771 - K225 - 75K771 - 1075 OCEAN VIEW AVENUE","e521d292-30f4-ea11-b882-24ee9a37d45c",-73955856,40580260,"P.S. 225 - BROOKLYN","1075 OCEAN VIEW AVENUE"
1,1,0,"31a10a44-32f4-ea11-b882-24ee9a37d45c","P.S. 251 Queens - Q251 - Q251 - 29Q251 - 144-51 Arthur Street","32a10a44-32f4-ea11-b882-24ee9a37d45c",-73759396,40664809,"P.S. 251 (TANDEM Q231) - QUEENS","144-51 Arthur Street"
1,0,1,"6c41e65b-31f4-ea11-b882-24ee9a37d45c","The Lexington Academy - M072 - M072 - 04M072 - 131 EAST 104 STREET","6d41e65b-31f4-ea11-b882-24ee9a37d45c",-73947450,40791444,"P.S. 72 - MANHATTAN","131 EAST 104 STREET"
2,1,1,"bec88e4f-31f4-ea11-b882-24ee9a37d45c","M.S. M247 Dual Language Middle School - M247 - M044 - 03M247 - 100 WEST 77 STREET","bfc88e4f-31f4-ea11-b882-24ee9a37d45c",-73977602,40780536,"I.S. 44 - MANHATTAN","100 WEST 77 STREET"
1,0,1,"21c73b4a-32f4-ea11-b882-24ee9a37d45c","Helen M. Marshall School - Q330 - Q287 - 24Q330 - 110-08 NORTHERN BOULEVARD","20c73b4a-32f4-ea11-b882-24ee9a37d45c",-73859202,40757888,"P.S. 330 - QUEENS","110-08 NORTHERN BOULEVARD"
1,0,1,"56395a2c-ebf6-ea11-b883-24ee9a37d459","Sid Miller Academy - K396 - K263 - 75K396 - 210 CHESTER STREET","6eb50aa5-30f4-ea11-b882-24ee9a37d45c",-73911279,40666187,"P.S./I.S. 323 - BROOKLYN","210 CHESTER STREET"
6,6,0,"b272c880-32f4-ea11-b882-24ee9a37d45c","Robert F. Kennedy Community High School - Q670 - Q707 - 25Q670 - 75-40 PARSONS BOULEVARD","b372c880-32f4-ea11-b882-24ee9a37d45c",-73811408,40725280,"R. F. KENNEDY COMM. MIDDLE/HS-Q","75-40 PARSONS BOULEVARD"
1,0,1,"98a9d9c3-32f4-ea11-b882-24ee9a37d45c","P.S. 39 Francis J. Murphy Jr. - R039 - R039 - 31R039 - 99 Macfarland Avenue","99a9d9c3-32f4-ea11-b882-24ee9a37d45c",-74070610,40597824,"P.S. 39 - STATEN ISLAND","99 Macfarland Avenue"
1,0,1,"bd85f462-ebf6-ea11-b883-24ee9a37d459","P.S. M811 - Mickey Mantle School - M811 - M101 - 75M811 - 141 EAST 111 STREET","50e61462-31f4-ea11-b882-24ee9a37d45c",-73944546,40796098,"P.S. 101 - MANHATTAN","141 EAST 111 STREET"
4,1,3,"0dcf496e-31f4-ea11-b882-24ee9a37d45c","Emma Lazarus High School - M394 - M131 - 02M394 - 100 HESTER STREET","03cf496e-31f4-ea11-b882-24ee9a37d45c",-73993607,40716231,"I.S. 131 - MANHATTAN","100 HESTER STREET"
3,1,2,"add810ab-31f4-ea11-b882-24ee9a37d45c","Business Of Sports School - M393 - M625 - 02M393 - 439 WEST 49TH STREET","a9d810ab-31f4-ea11-b882-24ee9a37d45c",-73990318,40763655,"HS OF GRAPHIC COMMUNICATION ARTS-M","439 WEST 49TH STREET"
2,0,2,"a183ff9e-30f4-ea11-b882-24ee9a37d45c","P.S. 253 - K253 - K253 - 21K253 - 601 OCEANVIEW AVENUE","a283ff9e-30f4-ea11-b882-24ee9a37d45c",-73961962,40580237,"P.S. 253 - BROOKLYN","601 OCEANVIEW AVENUE"
2,0,2,"78f4a0ef-eaf6-ea11-b883-24ee9a37d459","Sid Miller Academy - K396 - K396 - 75K396 - 110 CHESTER STREET","2d8dbfcf-30f4-ea11-b882-24ee9a37d45c",-73911788,40668232,"P.S. 396 (TANDEM K327-D23)-K","110 CHESTER STREET"
1,0,1,"aafc24e8-31f4-ea11-b882-24ee9a37d45c","P.S. 020 John Bowne - Q020 - Q020 - 25Q020 - 142-30 BARCLAY AVENUE","14f32ce2-31f4-ea11-b882-24ee9a37d45c",-73824388,40758347,"P.S. 20 - QUEENS","142-30 BARCLAY AVENUE"
3,1,2,"26c73b4a-32f4-ea11-b882-24ee9a37d45c","A.C.E. Academy for Scholars at the Geraldine Ferraro Campus - Q290 - Q290 - 24Q290 - 55-20 METROPOLITAN AVENUE","24c73b4a-32f4-ea11-b882-24ee9a37d45c",-73908307,40713030,"THE GERALDINE FERRARO CAMPUS - QUEENS","55-20 METROPOLITAN AVENUE"
8,5,3,"ecce496e-31f4-ea11-b882-24ee9a37d45c","Columbia Secondary School - M362 - M125 - 05M362 - 425 WEST 123 STREET","edce496e-31f4-ea11-b882-24ee9a37d45c",-73955722,40810793,"P.S. 125 - MANHATTAN","425 WEST 123 STREET"
1,0,1,"c38442ee-31f4-ea11-b882-24ee9a37d45c","The Jermaine L. Green STEM Institute of Queens - Q354 - Q030 - 28Q354 - 126-10 BEDELL STREET","c48442ee-31f4-ea11-b882-24ee9a37d45c",-73774668,40679843,"P.S. 30 - QUEENS","126-10 BEDELL STREET"
5,0,5,"18e63126-ebf6-ea11-b883-24ee9a37d459","P.S. K771 - K771 - K236 - 75K771 - 6302 AVENUE U","5ba5db98-30f4-ea11-b882-24ee9a37d45c",-73912005,40615494,"P.S. 236 - BROOKLYN","6302 AVENUE U"
3,3,0,"c7ba3c50-33f4-ea11-b882-24ee9a37d45c","P.S. 279 Captain Manuel Rivera, Jr. - X279 - X279 - 10X279 - 2100 WALTON AVENUE","c8ba3c50-33f4-ea11-b882-24ee9a37d45c",-73904958,40854666,"P.S. 279 - BRONX","2100 WALTON AVENUE"
2,0,2,"a2e657bd-30f4-ea11-b882-24ee9a37d45c","P.S. 319 - K319 - K319 - 14K319 - 360 KEAP STREET","a3e657bd-30f4-ea11-b882-24ee9a37d45c",-73953881,40709632,"P.S. 319 - BROOKLYN","360 KEAP STREET"
3,1,2,"9948b1f5-eaf6-ea11-b883-24ee9a37d459","P.S. K134 - K134 - K849 - 22K134 - 4001 18 AVENUE","12d8cf12-31f4-ea11-b882-24ee9a37d45c",-73973180,40632145,"P.S. 134 - BROOKLYN","4001 18 AVENUE"
2,0,2,"fa201dab-30f4-ea11-b882-24ee9a37d45c","P.S. 282 Park Slope - K282 - K282 - 13K282 - 180 6 Avenue","f8201dab-30f4-ea11-b882-24ee9a37d45c",-73977983,40676649,"P.S. 282 - BROOKLYN","180 6 Avenue"
1,0,1,"16a198c3-30f4-ea11-b882-24ee9a37d45c","P.S./I.S. 30 Mary White Ovington - K030 - K331 - 20K030 - 7002 4TH AVENUE","15a198c3-30f4-ea11-b882-24ee9a37d45c",-74023950,40633598,"P.S./I.S.30 MARY WHITE OVINGTON - BROOKLYN","7002 4TH AVENUE"
4,1,3,"c52ff20c-32f4-ea11-b882-24ee9a37d45c","P.S./I.S. 113 Anthony J. Pranzo - Q113 - Q113 - 24Q113 - 78-23 87TH STREET","c62ff20c-32f4-ea11-b882-24ee9a37d45c",-73861493,40705476,"P.S./I.S. 113 - QUEENS","78-23 87TH STREET"
1,1,0,"ed21d292-30f4-ea11-b882-24ee9a37d45c","J.H.S. 227 Edward B. Shallow - K227 - K227 - 20K227 - 6500 16 AVENUE","ee21d292-30f4-ea11-b882-24ee9a37d45c",-73995961,40622102,"I.S. 227 - BROOKLYN","6500 16 AVENUE"
9,5,4,"c3b66262-32f4-ea11-b882-24ee9a37d45c","Martin Van Buren High School - Q435 - Q435 - 26Q435 - 230-17 HILLSIDE AVENUE","c4b66262-32f4-ea11-b882-24ee9a37d45c",-73739726,40733888,"MARTIN VAN BUREN HS - QUEENS","230-17 HILLSIDE AVENUE"
3,2,1,"516e70b7-31f4-ea11-b882-24ee9a37d45c","P.S. 527 - East Side School for Social Action - M527 - M816 - 02M527 - 323 EAST 91 STREET","526e70b7-31f4-ea11-b882-24ee9a37d45c",-73947856,40780652,"P.S. 527 - East Side School for Social Action","323 EAST 91 STREET"
2,1,1,"68e2635c-32f4-ea11-b882-24ee9a37d45c","Academy for Careers in Television and Film - Q301 - Q404 - 30Q301 - 1-50 51ST AVENUE","65e2635c-32f4-ea11-b882-24ee9a37d45c",-73959183,40742964,"HUNTERS POINT CAMPUS - QUEENS","1-50 51ST AVENUE"
2,1,1,"f677bb9f-33f4-ea11-b882-24ee9a37d45c","P.S. 083 Donald Hertz - X083 - X981 - 11X083 - 1840 BOGART AVENUE","f777bb9f-33f4-ea11-b882-24ee9a37d45c",-73858769,40849176,"P.S. 83 ANNEX - BRONX","1840 BOGART AVENUE"
6,0,6,"31c73b4a-32f4-ea11-b882-24ee9a37d45c","Elm Tree Elementary School - Q211 - Q298 - 24Q211 - 50-51 98th Street","30c73b4a-32f4-ea11-b882-24ee9a37d45c",-73863408,40741139,"Marie M. Daly Educational Building","50-51 98th Street"
5,3,2,"5b5b4cd6-32f4-ea11-b882-24ee9a37d45c","Curtis High School - R450 - R450 - 31R450 - 105 HAMILTON AVENUE","5a5b4cd6-32f4-ea11-b882-24ee9a37d45c",-74082149,40645436,"CURTIS HS - S. I.","105 HAMILTON AVENUE"
3,2,1,"64977d2b-32f4-ea11-b882-24ee9a37d45c","J.H.S. 185 Edward Bleeker - Q185 - Q185 - 25Q185 - 147-26 25 DRIVE","ae0e6e25-32f4-ea11-b882-24ee9a37d45c",-73818607,40774906,"J.H.S. 185 - QUEENS","147-26 25 DRIVE"
4,4,0,"d4f57030-30f4-ea11-b882-24ee9a37d45c","The Emily Warren Roebling School - K008 - K008 - 13K008 - 37 HICKS STREET","d5f57030-30f4-ea11-b882-24ee9a37d45c",-73992841,40700709,"P.S. 8 - BROOKLYN","37 HICKS STREET"
2,0,2,"1530f69f-ebf6-ea11-b883-24ee9a37d459","P.S. Q993 - Q993 - Q208 - 75Q993 - 74-30 COMMONWEALTH BLVD","ab69c231-32f4-ea11-b882-24ee9a37d45c",-73727632,40744276,"P.S./I.S. 208 - QUEENS","74-30 COMMONWEALTH BLVD"
1,0,1,"c617ab87-ebf6-ea11-b883-24ee9a37d459","P.S. Q233 - Q233 - Q025 - 75Q233 - 34-65 192 STREET","befc24e8-31f4-ea11-b882-24ee9a37d45c",-73789365,40764884,"J.H.S. 25 - QUEENS","34-65 192 STREET"
1,0,1,"1ceabc42-30f4-ea11-b882-24ee9a37d45c","Lyons Community School - K586 - K049 - 14K586 - 223 GRAHAM AVENUE","14eabc42-30f4-ea11-b882-24ee9a37d45c",-73944463,40709765,"I.S. 49 - BROOKLYN","223 GRAHAM AVENUE"
1,0,1,"b22ff20c-32f4-ea11-b882-24ee9a37d45c","Lighthouse Elementary School - Q106 - Q106 - 27Q106 - 180 BEACH 35 STREET","b32ff20c-32f4-ea11-b882-24ee9a37d45c",-73766846,40594738,"P.S. 106 - QUEENS","180 BEACH 35 STREET"
3,3,0,"e237fba4-31f4-ea11-b882-24ee9a37d45c","The Urban Assembly School for Emergency Management - M135 - M520 - 02M135 - 411 PEARL STREET","e037fba4-31f4-ea11-b882-24ee9a37d45c",-74000851,40711441,"MURRY BERGTRAUM HS (ECF) - M","411 PEARL STREET"
2,2,0,"87e2635c-32f4-ea11-b882-24ee9a37d45c","Benjamin N. Cardozo High School - Q415 - Q415 - 26Q415 - 57-00 223RD STREET","86e2635c-32f4-ea11-b882-24ee9a37d45c",-73757271,40752343,"BENJAMIN N. CARDOZO HS - Q","57-00 223RD STREET"
2,2,0,"42a10a44-32f4-ea11-b882-24ee9a37d45c","New York City Academy for Discovery - Q306 - Q262 - 27Q306 - 95-16 89TH AVENUE","43a10a44-32f4-ea11-b882-24ee9a37d45c",-73848577,40691482,"P.S. 262 - QUEENS","95-16 89TH AVENUE"
1,0,1,"eb9b4c1f-32f4-ea11-b882-24ee9a37d45c","P.S. 156 Laurelton - Q156 - Q156 - 29Q156 - 229-02 137 AVENUE","e69b4c1f-32f4-ea11-b882-24ee9a37d45c",-73743327,40672259,"P.S. 156 - QUEENS","229-02 137 AVENUE"
2,1,1,"0bcf496e-31f4-ea11-b882-24ee9a37d45c","M.S. 131 - M131 - M131 - 02M131 - 100 HESTER STREET","03cf496e-31f4-ea11-b882-24ee9a37d45c",-73993607,40716231,"I.S. 131 - MANHATTAN","100 HESTER STREET"
2,2,0,"f01aad3c-30f4-ea11-b882-24ee9a37d45c","P.S. 031 Samuel F. Dupont - K031 - K031 - 14K031 - 75 MESEROLE AVENUE","f11aad3c-30f4-ea11-b882-24ee9a37d45c",-73954139,40726970,"P.S. 31 (OLD 126) - K","75 MESEROLE AVENUE"
2,0,2,"df8442ee-31f4-ea11-b882-24ee9a37d45c","P.S. 038 Rosedale - Q038 - Q038 - 29Q038 - 135-21 241 STREET","e08442ee-31f4-ea11-b882-24ee9a37d45c",-73733774,40671150,"P.S. 38 - QUEENS","135-21 241 STREET"
2,0,2,"2502926e-32f4-ea11-b882-24ee9a37d45c","Jamaica Gateway to the Sciences - Q350 - Q470 - 28Q350 - 167-01 GOTHIC DRIVE","1f02926e-32f4-ea11-b882-24ee9a37d45c",-73798658,40714551,"JAMAICA HS - Q","167-01 GOTHIC DRIVE"
4,4,0,"cbe8ce00-32f4-ea11-b882-24ee9a37d45c","I.S. 73 - The Frank Sansivieri Intermediate School - Q073 - Q073 - 24Q073 - 70-02 54 AVENUE","cce8ce00-32f4-ea11-b882-24ee9a37d45c",-73893318,40728558,"I.S. 73 - QUEENS","70-02 54 AVENUE"
2,1,1,"ec201dab-30f4-ea11-b882-24ee9a37d45c","Pre-K Center at Bishop Ford School Site - K863 - K280 - 15K863 - 500 19 STREET","ed201dab-30f4-ea11-b882-24ee9a37d45c",-73983116,40656952,"PRE-K CENTER @ 500 19TH STREET - BROOKLYN","500 19 STREET"
2,0,2,"35005d7a-31f4-ea11-b882-24ee9a37d45c","P.S. 166 The Richard Rodgers School of The Arts and Technology - M166 - M166 - 03M166 - 132 WEST 89 STREET","36005d7a-31f4-ea11-b882-24ee9a37d45c",-73972557,40788925,"P.S. 166 - MANHATTAN","132 WEST 89 STREET"
4,3,1,"418dbfcf-30f4-ea11-b882-24ee9a37d45c","Kingsborough Early College School - K468 - K400 - 21K468 - 2630 BENSON AVENUE","3a8dbfcf-30f4-ea11-b882-24ee9a37d45c",-73986313,40593028,"Lafayette Educational Campus","2630 BENSON AVENUE"
1,1,0,"44953aac-ebf6-ea11-b883-24ee9a37d459","P.S. Q233 - Q233 - Q335 - 75Q233 - 150-15 RALEIGH STREET","f4454b50-32f4-ea11-b882-24ee9a37d45c",-73836850,40668083,"Centreville Educational Building","150-15 RALEIGH STREET"
4,3,1,"1e0410ca-32f4-ea11-b882-24ee9a37d45c","P.S. 045 John Tyler - R045 - R045 - 31R045 - 58 LAWRENCE AVENUE","1f0410ca-32f4-ea11-b882-24ee9a37d45c",-74107537,40628419,"P.S. 45 - STATEN ISLAND","58 LAWRENCE AVENUE"
3,2,1,"da9b4c1f-32f4-ea11-b882-24ee9a37d45c","P.S. 151 Mary D. Carter - Q151 - Q151 - 30Q151 - 50-05 31 AVENUE","db9b4c1f-32f4-ea11-b882-24ee9a37d45c",-73908146,40758027,"P.S. 151 - QUEENS","50-05 31 AVENUE"
5,3,2,"7c476368-32f4-ea11-b882-24ee9a37d45c","Newcomers High School - Q555 - Q450 - 30Q555 - 28-01 41 AVENUE","dab66262-32f4-ea11-b882-24ee9a37d45c",-73936592,40751838,"NEWCOMERS HIGH SCHOOL (OLD LIC)-Q","28-01 41 AVENUE"
1,1,0,"d3d27c6d-30f4-ea11-b882-24ee9a37d45c","Young Women's Leadership School of Brooklyn - K614 - K147 - 14K614 - 325 BUSHWICK AVENUE","d4d27c6d-30f4-ea11-b882-24ee9a37d45c",-73938790,40705005,"P.S. 147 - BROOKLYN","325 BUSHWICK AVENUE"
2,0,2,"d60d3c5b-30f4-ea11-b882-24ee9a37d45c","P.S. 101 The Verrazano - K101 - K101 - 21K101 - 8696 24 Avenue","d70d3c5b-30f4-ea11-b882-24ee9a37d45c",-73991962,40597379,"P.S. 101 - BROOKLYN","8696 24 Avenue"
2,2,0,"429f4974-31f4-ea11-b882-24ee9a37d45c","Washington Heights Expeditionary Learning School - M348 - M143 - 06M348 - 511 WEST 182ND STREET","3f9f4974-31f4-ea11-b882-24ee9a37d45c",-73930991,40849311,"I.S. 143 - MANHATTAN","511 WEST 182ND STREET"
2,0,2,"2c30f69f-ebf6-ea11-b883-24ee9a37d459","P.S. Q255 - Q255 - Q247 - 75Q255 - 69-10 65th Drive","2ca10a44-32f4-ea11-b882-24ee9a37d45c",-73885974,40715005,"PS/IS 128","69-10 65th Drive"
5,3,2,"fc454b50-32f4-ea11-b882-24ee9a37d45c","College Point Collaborative - Q379 - Q336 - 25Q379 - 12406 14TH AVENUE","fd454b50-32f4-ea11-b882-24ee9a37d45c",-73843504,40785129,"The College Point Collaborative Educational Buildi","12406 14TH AVENUE"
8,6,2,"89977d2b-32f4-ea11-b882-24ee9a37d45c","J.H.S. 194 William Carr - Q194 - Q194 - 25Q194 - 154-60 17 AVENUE","8a977d2b-32f4-ea11-b882-24ee9a37d45c",-73806990,40783231,"J.H.S. 194 - QUEENS","154-60 17 AVENUE"
4,3,1,"197eed06-32f4-ea11-b882-24ee9a37d45c","P.S. 89Q: The Jose Peralta School of Dreamers - Q089 - Q089 - 24Q089 - 85-28 BRITTON AVENUE","1a7eed06-32f4-ea11-b882-24ee9a37d45c",-73879641,40745963,"P.S. 89 - QUEENS","85-28 BRITTON AVENUE"
1,0,1,"780067b2-ebf6-ea11-b883-24ee9a37d459","Curious Young Learners Pre-K Center - Q336 - Q477 - 27Q336 - 87-40 88 STREET","68bc9674-32f4-ea11-b882-24ee9a37d45c",-73856363,40691406,"3K CENTER @ 87-40 88 STREET - QUEENS","87-40 88 STREET"
4,4,0,"130410ca-32f4-ea11-b882-24ee9a37d45c","CSI High School for International Studies - R047 - R043 - 31R047 - 100 ESSEX DRIVE","a0a9d9c3-32f4-ea11-b882-24ee9a37d45c",-74159343,40581958,"JEROME PARKER CAMPUS - S.I.","100 ESSEX DRIVE"
3,2,1,"2bc73b4a-32f4-ea11-b882-24ee9a37d45c","P.S. 092 Harry T. Stewart Sr. - Q092 - Q292 - 30Q092 - 99-01 34 AVENUE","29c73b4a-32f4-ea11-b882-24ee9a37d45c",-73868773,40755983,"P.S. 92 - QUEENS","99-01 34 AVENUE"
3,3,0,"9034aa92-31f4-ea11-b882-24ee9a37d45c","High School for Dual Language and Asian Studies - M545 - M445 - 02M545 - 350 GRAND STREET","8834aa92-31f4-ea11-b882-24ee9a37d45c",-73989329,40717329,"SEWARD PARK HS - MANHATTAN","350 GRAND STREET"
3,2,1,"e83159fa-30f4-ea11-b882-24ee9a37d45c","Clara Barton High School - K600 - K600 - 17K600 - 901 CLASSON AVENUE","e13159fa-30f4-ea11-b882-24ee9a37d45c",-73960689,40669805,"CLARA BARTON HS - K","901 CLASSON AVENUE"
3,0,3,"9d32c3fb-eaf6-ea11-b883-24ee9a37d459","P.S. 009 - Q009 - Q009 - 75Q009 - 58-74 57 STREET","f8f22ce2-31f4-ea11-b882-24ee9a37d45c",-73912458,40718234,"P.S. 9 (W REED SCHOOL) - QUEENS","58-74 57 STREET"
2,1,1,"370410ca-32f4-ea11-b882-24ee9a37d45c","P.S. 054 Charles W. Leng - R054 - R054 - 31R054 - 1060 WILLOWBROOK ROAD","380410ca-32f4-ea11-b882-24ee9a37d45c",-74137259,40602779,"P.S. 54 - STATEN ISLAND","1060 WILLOWBROOK ROAD"
3,0,3,"b732c3fb-eaf6-ea11-b883-24ee9a37d459","Curious Young Learners Pre-K Center - Q336 - Q473 - 27Q336 - 133-40 79TH STREET","2c02926e-32f4-ea11-b882-24ee9a37d45c",-73857176,0,"3K CENTER @ 133-40 79TH STREET - QUEENS","133-40 79TH STREET"
3,2,1,"8d83ff9e-30f4-ea11-b882-24ee9a37d45c","P.S. 247 Brooklyn - K247 - K247 - 20K247 - 7000 21 AVENUE","8e83ff9e-30f4-ea11-b882-24ee9a37d45c",-73987195,40612247,"P.S. 247 - BROOKLYN","7000 21 AVENUE"
3,3,0,"c2fc24e8-31f4-ea11-b882-24ee9a37d45c","World Journalism Preparatory: A College Board School - Q285 - Q025 - 25Q285 - 34-65 192 STREET","befc24e8-31f4-ea11-b882-24ee9a37d45c",-73789365,40764884,"J.H.S. 25 - QUEENS","34-65 192 STREET"
1,1,0,"4c507380-31f4-ea11-b882-24ee9a37d45c","Professor Juan Bosch Public School - M178 - M178 - 06M178 - 12-18 ELLWOOD STREET","4d507380-31f4-ea11-b882-24ee9a37d45c",-73928301,40859240,"P.S. 178 - MANHATTAN","12-18 ELLWOOD STREET"
4,2,2,"3e0b210d-33f4-ea11-b882-24ee9a37d45c","I.S. X303 Leadership & Community Service - X303 - X082 - 09X303 - 1700 MACOMBS ROAD","3f0b210d-33f4-ea11-b882-24ee9a37d45c",-73915217,40849416,"I.S. 232 - BRONX","1700 MACOMBS ROAD"
7,4,3,"a02aa42b-33f4-ea11-b882-24ee9a37d45c","P.S. X140 The Eagle School - X140 - X140 - 08X140 - 916 EAGLE AVENUE","9f2aa42b-33f4-ea11-b882-24ee9a37d45c",-73907489,40823318,"P.S. 140 - BRONX","916 EAGLE AVENUE"
2,1,1,"307c21b7-32f4-ea11-b882-24ee9a37d45c","I.S. R002 George L. Egbert - R002 - R002 - 31R002 - 333 Midland Avenue","2b7c21b7-32f4-ea11-b882-24ee9a37d45c",-74099685,40576728,"I.S. 2 - STATEN ISLAND","333 Midland Avenue"
3,3,0,"a672c880-32f4-ea11-b882-24ee9a37d45c","Queens Metropolitan High School - Q686 - Q686 - 28Q686 - 91-30 METROPOLITAN AVENUE","a372c880-32f4-ea11-b882-24ee9a37d45c",-73855543,40708431,"METROPOLITAN AVENUE CAMPUS - QUEENS","91-30 METROPOLITAN AVENUE"
1,0,1,"05217b48-4afb-ea11-b883-24ee9a37d459","HELP III - XAKQ - XAKA -  - 785 Crotona Park North","06217b48-4afb-ea11-b883-24ee9a37d459",-73891435,40840635,"Help III","785 Crotona Park North"
1,1,0,"ffbdf08c-32f4-ea11-b882-24ee9a37d45c","Baccalaureate School for Global Education - Q580 - Q798 - 30Q580 - 34-12 36 AVENUE","00bef08c-32f4-ea11-b882-24ee9a37d45c",-73926977,40754975,"BACCALAUREATE SCL FOR GLOBAL ED-Q","34-12 36 AVENUE"
2,1,1,"a169c231-32f4-ea11-b882-24ee9a37d45c","I.S. 204 Oliver W. Holmes - Q204 - Q204 - 30Q204 - 36-41 28 STREET","9c69c231-32f4-ea11-b882-24ee9a37d45c",-73932628,40756471,"I.S. 204 - QUEENS","36-41 28 STREET"
4,3,1,"07fc3df4-30f4-ea11-b882-24ee9a37d45c","John Dewey High School - K540 - K540 - 21K540 - 50 AVENUE X","05fc3df4-30f4-ea11-b882-24ee9a37d45c",-73981925,40588070,"JOHN DEWEY HS - K","50 AVENUE X"
1,1,0,"7707e99e-31f4-ea11-b882-24ee9a37d45c","P.S. 059 Beekman Hill International - M059 - M488 - 02M059 - 231-249 EAST 56 STREET","6d07e99e-31f4-ea11-b882-24ee9a37d45c",-73967204,40759248,"MIDTOWN EAST CAMPUS - MANHATTAN","231-249 EAST 56 STREET"
2,1,1,"822f77fa-31f4-ea11-b882-24ee9a37d45c","P.S. 071 Forest - Q071 - Q071 - 24Q071 - 62-85 FOREST AVENUE","802f77fa-31f4-ea11-b882-24ee9a37d45c",-73904798,40711388,"P.S. 71 - QUEENS","62-85 FOREST AVENUE"
3,0,3,"c348b1f5-eaf6-ea11-b883-24ee9a37d459","P.S. M811 - Mickey Mantle School - M811 - M841 - 75M811 - 466 West End Avenue","676e70b7-31f4-ea11-b882-24ee9a37d45c",-73979217,40786330,"P.S. 811 (OLD P148/LIVINGS HS) - M","466 West End Avenue"
3,3,0,"1f6e3d68-31f4-ea11-b882-24ee9a37d45c","Tag Young Scholars - M012 - M117 - 04M012 - 240 EAST 109 STREET","1b6e3d68-31f4-ea11-b882-24ee9a37d45c",-73942285,40792556,"J.H.S. 117 - MANHATTAN","240 EAST 109 STREET"
3,2,1,"6ca9d9c3-32f4-ea11-b882-24ee9a37d45c","I.S. 024 Myra S. Barnes - R024 - R024 - 31R024 - 750 DURANT AVENUE","5bfdc1bd-32f4-ea11-b882-24ee9a37d45c",-74145558,40545490,"I.S. 24 - STATEN ISLAND","750 DURANT AVENUE"
8,4,4,"ceb36d80-30f4-ea11-b882-24ee9a37d45c","P.S. 185 Walter Kassenbrock - K185 - K185 - 20K185 - 8601 RIDGE BOULEVARD","cfb36d80-30f4-ea11-b882-24ee9a37d45c",-74033429,40623598,"P.S. 185 - BROOKLYN","8601 RIDGE BOULEVARD"
4,4,0,"84a9d9c3-32f4-ea11-b882-24ee9a37d45c","P.S. 032 The Gifford School - R032 - R032 - 31R032 - 232 Barlow Avenue","80a9d9c3-32f4-ea11-b882-24ee9a37d45c",-74155400,40557900,"P.S. 32 - STATEN ISLAND","232 Barlow Avenue"
2,0,2,"7836d900-33f4-ea11-b882-24ee9a37d45c","P.S. 059 The Community School of Technology - X059 - X059 - 10X059 - 2185 BATHGATE AVENUE","7936d900-33f4-ea11-b882-24ee9a37d45c",-73893639,40853141,"P.S. 59 - BRONX","2185 BATHGATE AVENUE"
1,1,0,"0018b7f4-32f4-ea11-b882-24ee9a37d45c","American Dream Charter School - X471 - X030 - 84X471 - 510 EAST 141 STREET","0118b7f4-32f4-ea11-b882-24ee9a37d45c",-73917417,40809023,"P.S. 30 - BRONX","510 EAST 141 STREET"
1,0,1,"de9319d7-ebf6-ea11-b883-24ee9a37d459","The Richmond Pre-K Center - R066 - R090 - 31R066 - 1535 RICHMOND AVENUE","f18521d0-32f4-ea11-b882-24ee9a37d45c",-74159152,40610497,"3K CENTER @ 1535 RICHMOND AVENUE - STATEN ISLAND","1535 RICHMOND AVENUE"
3,2,1,"202ed53d-33f4-ea11-b882-24ee9a37d45c","P.S. 170 - X170 - X170 - 09X170 - 1598 TOWNSEND AVENUE","212ed53d-33f4-ea11-b882-24ee9a37d45c",-73913253,40844367,"P.S. 170 (ECC) - BRONX","1598 TOWNSEND AVENUE"
5,5,0,"d3ed94c3-31f4-ea11-b882-24ee9a37d45c","Young Women's Leadership School - M610 - M895 - 04M610 - 105 East 106th Street","d4ed94c3-31f4-ea11-b882-24ee9a37d45c",-73947171,40792932,"YOUNG WOMEN'S LEADERSHIP HS - M","105 East 106th Street"
1,1,0,"71dfafe6-52e6-eb11-b8b1-24ee9a37d45c","New Visions Charter High School for the Humanities II - X208 - X650 - 84X208 - 900 TINTON AVENUE","91eb0e7b-33f4-ea11-b882-24ee9a37d45c",-73902892,40821723,"JANE ADDAMS HS - X","900 TINTON AVENUE"
2,1,1,"47fdc1bd-32f4-ea11-b882-24ee9a37d45c","P.S. 8 Shirlee Solomon - R008 - R008 - 31R008 - 112 LINDENWOOD ROAD","48fdc1bd-32f4-ea11-b882-24ee9a37d45c",-74152212,40547567,"P.S. 8 - STATEN ISLAND","112 LINDENWOOD ROAD"
3,2,1,"6e36d900-33f4-ea11-b882-24ee9a37d45c","P.S. 056 Norwood Heights - X056 - X056 - 10X056 - 341 EAST 207 STREET","6f36d900-33f4-ea11-b882-24ee9a37d45c",-73874912,40875481,"P.S. 56 - BRONX","341 EAST 207 STREET"
1,0,1,"5d611579-4afb-ea11-b883-24ee9a37d459","MARBLE HILL NURSERY SCHOOL - XAOU - XAOU -  - 5480 BROADWAY","5e611579-4afb-ea11-b883-24ee9a37d459",-73908101,40874703,"MARBLE HILL NURSERY SCHOOL","5480 BROADWAY"
2,1,1,"898946f4-31f4-ea11-b882-24ee9a37d45c","I.S. 059 Springfield Gardens - Q059 - Q059 - 29Q059 - 132-55 RIDGEDALE STREET","878946f4-31f4-ea11-b882-24ee9a37d45c",-73752772,40681881,"I.S. 59 - QUEENS","132-55 RIDGEDALE STREET"
6,6,0,"63ffcc6e-33f4-ea11-b882-24ee9a37d45c","The Bronx High School of Science - X445 - X445 - 10X445 - 75 WEST 205 STREET","64ffcc6e-33f4-ea11-b882-24ee9a37d45c",-73889011,40879958,"BRONX HS OF SCIENCE - X","75 WEST 205 STREET"
2,2,0,"2a8dbfcf-30f4-ea11-b882-24ee9a37d45c","P.S. 109 - K109 - K395 - 22K109 - 1001 EAST 45 STREET","2fe2abc9-30f4-ea11-b882-24ee9a37d45c",-73933099,40635842,"P.S./I.S. 395 - BROOKLYN","1001 EAST 45 STREET"
1,0,1,"c8b66262-32f4-ea11-b882-24ee9a37d45c","Martin Van Buren High School - Q435 - Q436 - 26Q435 - 230-17 Hillside Avenue","c9b66262-32f4-ea11-b882-24ee9a37d45c",-73739726,40733888,"VAN BUREN AF - QUEENS","230-17 Hillside Avenue"
4,1,3,"18e2abc9-30f4-ea11-b882-24ee9a37d45c","P.S. K141 - K141 - K380 - 75K141 - 370 MARCY AVENUE","19e2abc9-30f4-ea11-b882-24ee9a37d45c",-73953702,40701790,"P.S. 380 - BROOKLYN","370 MARCY AVENUE"
1,1,0,"009c4c1f-32f4-ea11-b882-24ee9a37d45c","P.S. 162 John Golden - Q162 - Q162 - 26Q162 - 201-02 53 AVENUE","019c4c1f-32f4-ea11-b882-24ee9a37d45c",-73776576,40748405,"P.S. 162 - QUEENS","201-02 53 AVENUE"
2,2,0,"9369c231-32f4-ea11-b882-24ee9a37d45c","P.S./M.S. 200 - The Magnet School of Global Studies and Leadership - Q200 - Q200 - 25Q200 - 70-10 164 STREET","9469c231-32f4-ea11-b882-24ee9a37d45c",-73805759,40731070,"P.S. 200 - QUEENS","70-10 164 STREET"
2,0,2,"8fe657bd-30f4-ea11-b882-24ee9a37d45c","P.S. 503: The School of Discovery - K503 - K314 - 20K503 - 330 59 Street","8ee657bd-30f4-ea11-b882-24ee9a37d45c",-74019299,40641950,"P.S. 314 - BROOKLYN","330 59 Street"
4,0,4,"f7d27c6d-30f4-ea11-b882-24ee9a37d45c","P.S. 153 Homecrest - K153 - K153 - 21K153 - 1970 HOMECREST AVENUE","f8d27c6d-30f4-ea11-b882-24ee9a37d45c",-73960027,40601179,"P.S. 153 - BROOKLYN","1970 HOMECREST AVENUE"
1,0,1,"b12aa42b-33f4-ea11-b882-24ee9a37d45c","Bronx Charter School for Better Learning II - X484 - X144 - 84X484 - 2545 GUNTHER AVENUE","b22aa42b-33f4-ea11-b882-24ee9a37d45c",-73836525,40863842,"I.S. 144 - BRONX","2545 GUNTHER AVENUE"
5,3,2,"df8521d0-32f4-ea11-b882-24ee9a37d45c","P.S. 048 William G. Wilcox - R048 - R071 - 31R048 - 1050 Targee Street","db8521d0-32f4-ea11-b882-24ee9a37d45c",-74091239,40603492,"P.S./I.S. 48 - Staten Island","1050 Targee Street"
4,4,0,"91e657bd-30f4-ea11-b882-24ee9a37d45c","P.S. 506: The School of Journalism & Technology - K506 - K314 - 20K506 - 330 59 Street","8ee657bd-30f4-ea11-b882-24ee9a37d45c",-74019299,40641950,"P.S. 314 - BROOKLYN","330 59 Street"
5,3,2,"0fead4e1-d214-ec11-b8b5-24ee9a37d45c","East New York Family Academy - K409 - K599 - 19K409 - 760 Van Siclen Avenue","7b3fd300-d214-ec11-b8b5-24ee9a37d45c",-73886668,40661102,"K599 – East New York","760 Van Siclen Avenue"
4,2,2,"94a9d9c3-32f4-ea11-b882-24ee9a37d45c","P.S. 038 George Cromwell - R038 - R038 - 31R038 - 421 LINCOLN AVENUE","92a9d9c3-32f4-ea11-b882-24ee9a37d45c",-74099409,40574799,"P.S. 38 - STATEN ISLAND","421 LINCOLN AVENUE"
4,3,1,"c9883319-32f4-ea11-b882-24ee9a37d45c","I.S. 141 The Steinway - Q141 - Q141 - 30Q141 - 37-11 21 AVENUE","ca883319-32f4-ea11-b882-24ee9a37d45c",-73904508,40775766,"I.S. 141 - QUEENS","37-11 21 AVENUE"
4,3,1,"43de5eb7-30f4-ea11-b882-24ee9a37d45c","P.S. 299 Thomas Warren Field - K299 - K299 - 32K299 - 88 WOODBINE STREET","44de5eb7-30f4-ea11-b882-24ee9a37d45c",-73917899,40690755,"P.S. 299 - BROOKLYN","88 WOODBINE STREET"
6,5,1,"27eabc42-30f4-ea11-b882-24ee9a37d45c","M.S. 51 William Alexander - K051 - K051 - 15K051 - 350 5 AVENUE","28eabc42-30f4-ea11-b882-24ee9a37d45c",-73985050,40672358,"I.S. 51 - BROOKLYN","350 5 AVENUE"
2,0,2,"f1b98b86-30f4-ea11-b882-24ee9a37d45c","P.S. 196 Ten Eyck - K196 - K196 - 14K196 - 207 BUSHWICK AVENUE","e9b98b86-30f4-ea11-b882-24ee9a37d45c",-73939385,40708804,"P.S. 196 - BROOKLYN","207 BUSHWICK AVENUE"
1,1,0,"3f8dbfcf-30f4-ea11-b882-24ee9a37d45c","International High School at Lafayette - K337 - K400 - 21K337 - 2630 BENSON AVENUE","3a8dbfcf-30f4-ea11-b882-24ee9a37d45c",-73986313,40593028,"Lafayette Educational Campus","2630 BENSON AVENUE"
1,1,0,"9d476368-32f4-ea11-b882-24ee9a37d45c","Queens High School for Language Studies - Q241 - Q460 - 25Q241 - 35-01 UNION STREET","97476368-32f4-ea11-b882-24ee9a37d45c",-73826811,40764892,"FLUSHING HS - Q","35-01 UNION STREET"
1,1,0,"fc02cefa-32f4-ea11-b882-24ee9a37d45c","P.S. 035 Franz Siegel - X035 - X035 - 09X035 - 261 EAST 163 STREET","fd02cefa-32f4-ea11-b882-24ee9a37d45c",-73917705,40828009,"P.S. 35 - BRONX","261 EAST 163 STREET"
2,2,0,"0fa6ba98-31f4-ea11-b882-24ee9a37d45c","University Neighborhood High School - M448 - M446 - 01M448 - 200 Monroe Street","10a6ba98-31f4-ea11-b882-24ee9a37d45c",-73984128,40712269,"UNIVERSITY NEIGHBORHOOD - M","200 Monroe Street"
2,0,2,"51ffcc6e-33f4-ea11-b882-24ee9a37d45c","Bronx Collaborative High School - X351 - X440 - 10X351 - 100 WEST MOSHOLU PARKWAY SOUTH","4cffcc6e-33f4-ea11-b882-24ee9a37d45c",-73889011,40879958,"DEWITT CLINTON HS - X","100 WEST MOSHOLU PARKWAY SOUTH"
7,4,3,"05ee94c3-31f4-ea11-b882-24ee9a37d45c","Spruce Street School - M397 - M971 - 02M397 - 12 SPRUCE STREET","01ee94c3-31f4-ea11-b882-24ee9a37d45c",-74005473,40711321,"THE SPRUCE STREET EDUCATIONAL CAMPUS","12 SPRUCE STREET"
1,0,1,"dfaeb707-ecf6-ea11-b883-24ee9a37d459","P.S. X596 - X596 - X498 - 75X596 - 1640 BRONXDALE AVE","7eeb0e7b-33f4-ea11-b882-24ee9a37d45c",-73857989,40845023,"THE LT. CURTIS MEYRAN AND JOHN BELLEW ED COMPLEX","1640 BRONXDALE AVE"
2,1,1,"2568ee1e-31f4-ea11-b882-24ee9a37d45c","P.S./I.S. 30 Mary White Ovington - K030 - K940 - 20K030 - 415 OVINGTON AVENUE","2668ee1e-31f4-ea11-b882-24ee9a37d45c",-74023036,40633710,"I.S. 30 - BROOKLYN","415 OVINGTON AVENUE"
2,0,2,"85283fb1-30f4-ea11-b882-24ee9a37d45c","J.H.S. 291 Roland Hayes - K291 - K291 - 32K291 - 231 PALMETTO STREET","83283fb1-30f4-ea11-b882-24ee9a37d45c",-73915217,40695875,"I.S. 291 - BROOKLYN","231 PALMETTO STREET"
3,1,2,"de2ff20c-32f4-ea11-b882-24ee9a37d45c","P.S. 121 Queens - Q121 - Q121 - 28Q121 - 126-10 109 AVENUE","df2ff20c-32f4-ea11-b882-24ee9a37d45c",-73815330,40683585,"P.S. 121 - QUEENS","126-10 109 AVENUE"
1,0,1,"2da198c3-30f4-ea11-b882-24ee9a37d45c","P.S. 345 Patrolman Robert Bolden - K345 - K345 - 19K345 - 111 BERRIMAN STREET","2ca198c3-30f4-ea11-b882-24ee9a37d45c",-73879886,40676207,"P.S. 345 - BROOKLYN","111 BERRIMAN STREET"
3,2,1,"e8ed94c3-31f4-ea11-b882-24ee9a37d45c","Beacon High School - M479 - M912 - 03M479 - 522 WEST 44TH STREET","e7ed94c3-31f4-ea11-b882-24ee9a37d45c",-73996262,40760858,"BEACON HIGH SCHOOL - MANHATTAN","522 WEST 44TH STREET"
3,1,2,"0dd1de79-30f4-ea11-b882-24ee9a37d45c","P.S. 177 The Marlboro - K177 - K177 - 21K177 - 346 AVENUE P","0ed1de79-30f4-ea11-b882-24ee9a37d45c",-73974425,40608169,"P.S. 177 - BROOKLYN","346 AVENUE P"
1,0,1,"b056635c-33f4-ea11-b882-24ee9a37d45c","Arturo A. Schomburg Satellite Academy Bronx - X446 - X401 - 12X446 - 1010 REV. J. A. POLITE AVENUE","8ce03d56-33f4-ea11-b882-24ee9a37d45c",-73898265,40823124,"BRONX REGIONAL HS (OLD 133) - X","1010 REV. J. A. POLITE AVENUE"
11,6,5,"d7b66262-32f4-ea11-b882-24ee9a37d45c","William Cullen Bryant High School - Q445 - Q445 - 30Q445 - 48-10 31 AVENUE","d8b66262-32f4-ea11-b882-24ee9a37d45c",-73911165,40757072,"WILLIAM C. BRYANT HS - Q","48-10 31 AVENUE"
1,0,1,"240410ca-32f4-ea11-b882-24ee9a37d45c","Naples Street Elementary School - R009 - R048 - 31R009 - 1055 Targee Street","250410ca-32f4-ea11-b882-24ee9a37d45c",-74090245,40602650,"P.S. 48 - STATEN ISLAND","1055 Targee Street"
4,0,4,"6541e65b-31f4-ea11-b882-24ee9a37d45c","New York City Lab Middle School for Collaborative Studies - M312 - M070 - 02M312 - 333 WEST 17 STREET","defab455-31f4-ea11-b882-24ee9a37d45c",-74002222,40742512,"I.S. 70 - MANHATTAN","333 WEST 17 STREET"
1,0,1,"08cf496e-31f4-ea11-b882-24ee9a37d45c","P.S. 130 Hernando De Soto - M130 - M130 - 02M130 - 143 BAXTER STREET","09cf496e-31f4-ea11-b882-24ee9a37d45c",-73998326,40718660,"P.S. 130 - MANHATTAN","143 BAXTER STREET"
1,1,0,"03e0ede7-49fb-ea11-b883-24ee9a37d459","Nuestros Ninos CDS - KBVC - KBVC -  - 384 South 4th Street","04e0ede7-49fb-ea11-b883-24ee9a37d459",-73952544,40707885,"Nuestros Ninos CDS","384 South 4th Street"
7,5,2,"f29b4c1f-32f4-ea11-b882-24ee9a37d45c","M.S. 158 Marie Curie - Q158 - Q158 - 26Q158 - 46-35 Oceania Street","f39b4c1f-32f4-ea11-b882-24ee9a37d45c",-73771878,40756562,"J.H.S. 158 - QUEENS","46-35 Oceania Street"
4,4,0,"e7883319-32f4-ea11-b882-24ee9a37d45c","P.S. 146 Howard Beach - Q146 - Q146 - 27Q146 - 98-01 159 AVENUE","e8883319-32f4-ea11-b882-24ee9a37d45c",-73834896,40660531,"P.S. 146 - QUEENS","98-01 159 AVENUE"
1,0,1,"d1f57030-30f4-ea11-b882-24ee9a37d45c","P.S. 007 Abraham Lincoln - K007 - K007 - 19K007 - 858 JAMAICA AVENUE","fcc1392a-30f4-ea11-b882-24ee9a37d45c",-73872983,40689213,"P.S. 7 - BROOKLYN","858 JAMAICA AVENUE"
3,2,1,"f0f22ce2-31f4-ea11-b882-24ee9a37d45c","York Early College Academy - Q284 - Q008 - 28Q284 - 108-35 167 STREET","f1f22ce2-31f4-ea11-b882-24ee9a37d45c",-73786403,40696910,"J.H.S. 8 - QUEENS","108-35 167 STREET"
1,0,1,"31eabc42-30f4-ea11-b882-24ee9a37d45c","Achievement First Brownsville Charter School - K626 - K055 - 84K626 - 2021 BERGEN STREET","32eabc42-30f4-ea11-b882-24ee9a37d45c",-73912685,40674456,"I.S. 55 - BROOKLYN","2021 BERGEN STREET"
1,1,0,"cf0d3c5b-30f4-ea11-b882-24ee9a37d45c","P.S. 099 Isaac Asimov - K099 - K099 - 21K099 - 1120 EAST 10 STREET","d00d3c5b-30f4-ea11-b882-24ee9a37d45c",-73966031,40621474,"P.S. 99 - BROOKLYN","1120 EAST 10 STREET"
2,1,1,"76e2635c-32f4-ea11-b882-24ee9a37d45c","P.S. Q256 - Q256 - Q410 - 75Q256 - 100-00 BEACH CHANNEL DRIVE","71e2635c-32f4-ea11-b882-24ee9a37d45c",-73825317,40586012,"Beach Channel Educational Campus","100-00 BEACH CHANNEL DRIVE"
1,0,1,"51953aac-ebf6-ea11-b883-24ee9a37d459","The Riverview School - Q277 - Q404 - 75Q277 - 1-50 51ST AVENUE","65e2635c-32f4-ea11-b882-24ee9a37d45c",-73959183,40742964,"HUNTERS POINT CAMPUS - QUEENS","1-50 51ST AVENUE"
3,1,2,"cdba3c50-33f4-ea11-b882-24ee9a37d45c","The Highbridge Green School - X361 - X285 - 09X361 - 200 West 167th Street","ceba3c50-33f4-ea11-b882-24ee9a37d45c",-73927892,40838232,"HIGHBRIDGE ENVIRONMENTAL EDUCATION CAMPUS - BRONX","200 West 167th Street"
7,6,1,"039c4c1f-32f4-ea11-b882-24ee9a37d45c","P.S. 163 Flushing Heights - Q163 - Q163 - 25Q163 - 159-01 59 AVENUE","049c4c1f-32f4-ea11-b882-24ee9a37d45c",-73808765,40741107,"P.S. 163 - QUEENS","159-01 59 AVENUE"
1,1,0,"52507380-31f4-ea11-b882-24ee9a37d45c","P.S. 183 Robert L. Stevenson - M183 - M183 - 02M183 - 419 East 66 Street","53507380-31f4-ea11-b882-24ee9a37d45c",-73957731,40763804,"P.S. 183 - MANHATTAN","419 East 66 Street"
4,4,0,"03b7c337-32f4-ea11-b882-24ee9a37d45c","J.H.S. 216 George J. Ryan - Q216 - Q216 - 26Q216 - 64-20 175 Street","04b7c337-32f4-ea11-b882-24ee9a37d45c",-73794501,40737188,"J.H.S. 216 - QUEENS","64-20 175 Street"
2,1,1,"5f9f4974-31f4-ea11-b882-24ee9a37d45c","P.S. 154 Harriet Tubman - M154 - M154 - 05M154 - 250 WEST 127 STREET","609f4974-31f4-ea11-b882-24ee9a37d45c",-73948902,40810499,"P.S. 154 - MANHATTAN","250 WEST 127 STREET"
1,0,1,"f58a0044-33f4-ea11-b882-24ee9a37d45c","The Urban Assembly Bronx Academy of Letters - X551 - X183 - 07X551 - 339 MORRIS AVENUE","ef8a0044-33f4-ea11-b882-24ee9a37d45c",-73925995,40813681,"J.H.S. 203 - BRONX","339 MORRIS AVENUE"
1,0,1,"05af1f69-ebf6-ea11-b883-24ee9a37d459","District 2 Pre-K Center - M391 - M343 - 02M391 - 1 PECK SLIP","e7e0838c-31f4-ea11-b882-24ee9a37d45c",-74002407,40708774,"THE PECK SLIP SCHOOL - MANHATTAN","1 PECK SLIP"
4,2,2,"d9883319-32f4-ea11-b882-24ee9a37d45c","P.S. 143 Louis Armstrong - Q143 - Q143 - 24Q143 - 34-74 113 Street","d7883319-32f4-ea11-b882-24ee9a37d45c",-73855715,40755393,"P.S. 143 - QUEENS","34-74 113 Street"
1,0,1,"f609e2e1-30f4-ea11-b882-24ee9a37d45c","Boys and Girls High School - K455 - K455 - 16K455 - 1700 FULTON STREET","f209e2e1-30f4-ea11-b882-24ee9a37d45c",-73931604,40678478,"BOYS & GIRLS HS - K","1700 FULTON STREET"
2,0,2,"ea21d292-30f4-ea11-b882-24ee9a37d45c","P.S. 226 Alfred De B. Mason - K226 - K226 - 21K226 - 6006 23 AVENUE","eb21d292-30f4-ea11-b882-24ee9a37d45c",-73977099,40615405,"P.S. 226 - BROOKLYN","6006 23 AVENUE"
6,4,2,"59be7adc-32f4-ea11-b882-24ee9a37d45c","Susan E. Wagner High School - R460 - R460 - 31R460 - 1200 MANOR ROAD","5abe7adc-32f4-ea11-b882-24ee9a37d45c",-74130819,40588985,"SUSAN E. WAGNER HS - S. I.","1200 MANOR ROAD"
3,2,1,"db11f898-32f4-ea11-b882-24ee9a37d45c","Robert F. Wagner, Jr. Secondary School for Arts and Technology - Q560 - Q891 - 24Q560 - 47-07 30th Place","d911f898-32f4-ea11-b882-24ee9a37d45c",-73936442,40742217,"R. F. WAGNER SEC SCL ARTS & TECH-Q","47-07 30th Place"
6,3,3,"fbfb3df4-30f4-ea11-b882-24ee9a37d45c","Edward R. Murrow High School - K525 - K525 - 21K525 - 1600 AVENUE L","fafb3df4-30f4-ea11-b882-24ee9a37d45c",-73959141,40619671,"EDWARD R. MURROW HS - K","1600 AVENUE L"
1,1,0,"1cba8b86-30f4-ea11-b882-24ee9a37d45c","P.S. 209 Margaret Mead - K209 - K209 - 21K209 - 2609 EAST 7 STREET","1dba8b86-30f4-ea11-b882-24ee9a37d45c",-73961191,40586800,"P.S. 209 - BROOKLYN","2609 EAST 7 STREET"
3,1,2,"ab343d0d-85ef-eb11-b8b1-24ee9a37d45c","P.S. Q811 - Q811 - Q140 - 75Q811 - 166-01 116 AVENUE","c7883319-32f4-ea11-b882-24ee9a37d45c",-73781255,40687486,"P.S. 140 - QUEENS","166-01 116 AVENUE"
2,2,0,"b03fce93-7c88-ec11-b8d0-24ee9a37d45c","Academy of American Studies - Q575 - Q575 - 30Q575 - 40-11 28th Street","b13fce93-7c88-ec11-b8d0-24ee9a37d45c",-73936596,40751839,"ACADEMY OF AMERICAN STUDIES - QUEENS","40-11 28th Street"
1,0,1,"9f778cb8-ebf6-ea11-b883-24ee9a37d459","P.S. Q811 - Q811 - Q566 - 75Q811 - 74-20 COMMONWEALTH BLVD","27b4977a-32f4-ea11-b882-24ee9a37d45c",-73728834,40744197,"QNS HS OF TEACH., LIB. ARTS&SCI-Q","74-20 COMMONWEALTH BLVD"
4,2,2,"06b7c337-32f4-ea11-b882-24ee9a37d45c","J.H.S. 217 Robert A. Van Wyck - Q217 - Q217 - 28Q217 - 85-05 144 STREET","fcb6c337-32f4-ea11-b882-24ee9a37d45c",-73811461,40710384,"I.S. 217 - QUEENS","85-05 144 STREET"
1,1,0,"f18ac007-ebf6-ea11-b883-24ee9a37d459","Rose Hill Pre-K Center - X535 - X444 - 10X535 - 2512 Marion Avenue","60ffcc6e-33f4-ea11-b882-24ee9a37d45c",-73893236,40861316,"PRE-K CENTER @MARION AVENUE - BRONX","2512 Marion Avenue"
1,0,1,"8007e99e-31f4-ea11-b882-24ee9a37d45c","High School for Law, Advocacy and Community Justice - M492 - M490 - 03M492 - 122 AMSTERDAM AVENUE","7c07e99e-31f4-ea11-b882-24ee9a37d45c",-73985608,40774891,"MARTIN LUTHER KING, JR. HS - M","122 AMSTERDAM AVENUE"
3,3,0,"22b7c337-32f4-ea11-b882-24ee9a37d45c","Hawtree Creek Middle School - Q297 - Q226 - 27Q297 - 121-10 ROCKAWAY BOULEVARD","1eb7c337-32f4-ea11-b882-24ee9a37d45c",-73816730,40675021,"I.S. 226 - QUEENS","121-10 ROCKAWAY BOULEVARD"
4,3,1,"969c11e8-30f4-ea11-b882-24ee9a37d45c","Park Slope Collegiate - K464 - K460 - 15K464 - 237 7 AVENUE","929c11e8-30f4-ea11-b882-24ee9a37d45c",-73978580,40669255,"John Jay Educational Campus","237 7 AVENUE"
2,0,2,"7136d900-33f4-ea11-b882-24ee9a37d45c","P.S. 057 Crescent - X057 - X057 - 12X057 - 2111 CROTONA AVENUE","6c36d900-33f4-ea11-b882-24ee9a37d45c",-73888987,40848748,"P.S. 57 - BRONX","2111 CROTONA AVENUE"
4,2,2,"433cbf01-ebf6-ea11-b883-24ee9a37d459","P.S. Q811 - Q811 - Q811 - 75Q811 - 61-25 MARATHON PARKWAY","08bef08c-32f4-ea11-b882-24ee9a37d45c",-73728412,40756481,"P.S. 811 (OLD 187) - QUEENS","61-25 MARATHON PARKWAY"
7,5,2,"512b3eee-30f4-ea11-b882-24ee9a37d45c","Fort Hamilton High School - K490 - K490 - 20K490 - 8301 SHORE ROAD","522b3eee-30f4-ea11-b882-24ee9a37d45c",-74038103,40626827,"FORT HAMILTON HS - K","8301 SHORE ROAD"
1,1,0,"f9ae0313-32f4-ea11-b882-24ee9a37d45c","P.S. 124 Osmond A Church - Q124 - Q124 - 27Q124 - 129-15 150 AVENUE","faae0313-32f4-ea11-b882-24ee9a37d45c",-73811266,40665669,"P.S. 124 - QUEENS","129-15 150 AVENUE"
7,4,3,"ddfab455-31f4-ea11-b882-24ee9a37d45c","N.Y.C. Lab School for Collaborative Studies - M412 - M070 - 02M412 - 333 WEST 17 STREET","defab455-31f4-ea11-b882-24ee9a37d45c",-74002222,40742512,"I.S. 70 - MANHATTAN","333 WEST 17 STREET"
1,0,1,"ac8fd48d-ebf6-ea11-b883-24ee9a37d459","P.S. Q233 - Q233 - Q042 - 75Q233 - 488 Beach 66 Street","ea8442ee-31f4-ea11-b882-24ee9a37d45c",-73794804,40594358,"P.S. 42 - QUEENS","488 Beach 66 Street"
1,0,1,"9ac5e197-6c0c-ed11-b091-088e901ef405","The Young Women’s Leadership School of Staten Island - R085 - R070 - 31R085 - 45 Waverly Place","6e3f38e4-e9e5-ec11-b8d9-24ee9a37d45c",-74084382,40618479,"Evelyn M. King Campus","45 Waverly Place"
1,1,0,"2fff3d8d-33f4-ea11-b882-24ee9a37d45c","Community School for Social Justice - X427 - X884 - 07X427 - 350 Gerard Avenue","2dff3d8d-33f4-ea11-b882-24ee9a37d45c",-73929960,40815712,"HEALTH OPPORTUNITIES HS - X","350 Gerard Avenue"
1,1,0,"e4c1392a-30f4-ea11-b882-24ee9a37d45c","Parkside Preparatory Academy - K002 - K002 - 17K002 - 655 Parkside Avenue","dfc1392a-30f4-ea11-b882-24ee9a37d45c",-73951575,40656423,"I.S. 2 - BROOKLYN","655 Parkside Avenue"
1,1,0,"1fb7c337-32f4-ea11-b882-24ee9a37d45c","J.H.S. 226 Virgil I. Grissom - Q226 - Q226 - 27Q226 - 121-10 ROCKAWAY BOULEVARD","1eb7c337-32f4-ea11-b882-24ee9a37d45c",-73816730,40675021,"I.S. 226 - QUEENS","121-10 ROCKAWAY BOULEVARD"
1,1,0,"52395a2c-ebf6-ea11-b883-24ee9a37d459","Community Partnership Charter School - K702 - K256 - 84K702 - 114 KOSCIUSZKO STREET","9f83ff9e-30f4-ea11-b882-24ee9a37d45c",-73949610,40690595,"P.S. 256 - BROOKLYN","114 KOSCIUSZKO STREET"
2,2,0,"8c0e6e25-32f4-ea11-b882-24ee9a37d45c","Irwin Altman Middle School 172 - Q172 - Q172 - 26Q172 - 81-14 257 Street","8d0e6e25-32f4-ea11-b882-24ee9a37d45c",-73713245,40741409,"J.H.S. 172 - QUEENS","81-14 257 Street"
3,1,2,"9f53dd74-33f4-ea11-b882-24ee9a37d45c","Marble Hill High School for International Studies - X477 - X475 - 10X477 - 99 TERRACE VIEW AVENUE","9853dd74-33f4-ea11-b882-24ee9a37d45c",-73912686,40877379,"JOHN F. KENNEDY HS - X","99 TERRACE VIEW AVENUE"
4,0,4,"e62d6c32-ebf6-ea11-b883-24ee9a37d459","P.S. K771 - K771 - K329 - 75K771 - 2929 WEST 30 STREET","11a198c3-30f4-ea11-b882-24ee9a37d45c",-73995770,40574666,"P.S. 329 - BROOKLYN","2929 WEST 30 STREET"
4,4,0,"ace657bd-30f4-ea11-b882-24ee9a37d45c","P.S. 321 William Penn - K321 - K321 - 15K321 - 180 7 AVENUE","ade657bd-30f4-ea11-b882-24ee9a37d45c",-73978633,40671816,"P.S. 321 - BROOKLYN","180 7 AVENUE"
1,1,0,"340410ca-32f4-ea11-b882-24ee9a37d45c","The Barbara Esselborn School - R053 - R053 - 31R053 - 330 DURANT AVENUE","350410ca-32f4-ea11-b882-24ee9a37d45c",-74136640,40551926,"P.S. 53 - STATEN ISLAND","330 DURANT AVENUE"
1,1,0,"1ca6ba98-31f4-ea11-b882-24ee9a37d45c","International High School at Union Square - M438 - M460 - 02M438 - 40 IRVING PLACE","16a6ba98-31f4-ea11-b882-24ee9a37d45c",-73987064,40735361,"WASHINGTON IRVING HS - MANHATTAN","40 IRVING PLACE"
2,1,1,"f89b4c1f-32f4-ea11-b882-24ee9a37d45c","P.S. 160 Walter Francis Bishop - Q160 - Q160 - 28Q160 - 109-59 INWOOD STREET","ee9b4c1f-32f4-ea11-b882-24ee9a37d45c",-73799685,40688373,"P.S. 160 - QUEENS","109-59 INWOOD STREET"
3,3,0,"db315367-30f4-ea11-b882-24ee9a37d45c","P.S. 132 The Conselyea School - K132 - K132 - 14K132 - 320 MANHATTAN AVENUE","dc315367-30f4-ea11-b882-24ee9a37d45c",-73945663,40714772,"P.S. 132 - BROOKLYN","320 MANHATTAN AVENUE"
3,2,1,"a369c231-32f4-ea11-b882-24ee9a37d45c","Energy Tech High School - Q258 - Q204 - 30Q258 - 36-41 28 STREET","9c69c231-32f4-ea11-b882-24ee9a37d45c",-73932628,40756471,"I.S. 204 - QUEENS","36-41 28 STREET"
7,3,4,"1eb4977a-32f4-ea11-b882-24ee9a37d45c","Townsend Harris High School - Q525 - Q515 - 25Q525 - 149-11 MELBOURNE AVENUE","1db4977a-32f4-ea11-b882-24ee9a37d45c",-73821532,40737038,"TOWNSEND HARRIS HS - Q","149-11 MELBOURNE AVENUE"
1,0,1,"9a886843-31f4-ea11-b882-24ee9a37d45c","Frederick Douglass Academy - M499 - M010 - 05M499 - 2581 7TH AVENUE","9b886843-31f4-ea11-b882-24ee9a37d45c",-73935746,40823988,"I.S. 10 (TANDEM M200) - MANHATTAN","2581 7TH AVENUE"
4,1,3,"2bb4977a-32f4-ea11-b882-24ee9a37d45c","Queens High School of Teaching, Liberal Arts and the Sciences - Q566 - Q566 - 26Q566 - 74-20 COMMONWEALTH BLVD","27b4977a-32f4-ea11-b882-24ee9a37d45c",-73728834,40744197,"QNS HS OF TEACH., LIB. ARTS&SCI-Q","74-20 COMMONWEALTH BLVD"
2,2,0,"00b7c337-32f4-ea11-b882-24ee9a37d45c","Wave Preparatory Elementary School - Q362 - Q215 - 27Q362 - 535 BRIAR PLACE","01b7c337-32f4-ea11-b882-24ee9a37d45c",-73758587,40599467,"P.S. 215 - QUEENS","535 BRIAR PLACE"
5,4,1,"29b7c337-32f4-ea11-b882-24ee9a37d45c","I.S. 227 Louis Armstrong - Q227 - Q227 - 30Q227 - 32-02 JUNCTION BOULEVARD","27b7c337-32f4-ea11-b882-24ee9a37d45c",-73874614,40757567,"I.S. 227 - QUEENS","32-02 JUNCTION BOULEVARD"
3,3,0,"cdfab455-31f4-ea11-b882-24ee9a37d45c","Neighborhood School - M363 - M063 - 01M363 - 121 EAST 3 STREET","cefab455-31f4-ea11-b882-24ee9a37d45c",-73986214,40724440,"P.S. 63 - MANHATTAN","121 EAST 3 STREET"
1,1,0,"96431753-e78d-ec11-b8d1-24ee9a37d45c","Mid-Manhattan Adult learning Center - E005 - M007 -  - 160 EAST 120 STREET","90886843-31f4-ea11-b882-24ee9a37d45c",-73939374,40800616,"P.S. 7 - MANHATTAN","160 EAST 120 STREET"
1,1,0,"48005d7a-31f4-ea11-b882-24ee9a37d45c","P.S. 175 Henry H Garnet - M175 - M175 - 05M175 - 175 WEST 134 STREET","47005d7a-31f4-ea11-b882-24ee9a37d45c",-73942706,40814388,"P.S. 175 - MANHATTAN","175 WEST 134 STREET"
1,0,1,"6c9d7c62-33f4-ea11-b882-24ee9a37d45c","Bronx Lab School - X265 - X425 - 11X265 - 800 EAST GUN HILL ROAD","699d7c62-33f4-ea11-b882-24ee9a37d45c",-73861649,40875172,"EVANDER CHILDS HS - X","800 EAST GUN HILL ROAD"
2,1,1,"c7e0838c-31f4-ea11-b882-24ee9a37d45c","Battery Park City School - M276 - M276 - 02M276 - 55 BATTERY PLACE","c6e0838c-31f4-ea11-b882-24ee9a37d45c",-74017456,40706384,"P.S./I.S. 276 - MANHATTAN","55 BATTERY PLACE"
4,4,0,"e292e6d5-30f4-ea11-b882-24ee9a37d45c","James Madison High School - K425 - K425 - 22K425 - 3787 BEDFORD AVENUE","e092e6d5-30f4-ea11-b882-24ee9a37d45c",-73947661,40610499,"JAMES MADISON HS - K","3787 BEDFORD AVENUE"
5,1,4,"88a9d9c3-32f4-ea11-b882-24ee9a37d45c","I.S. 034 Tottenville - R034 - R034 - 31R034 - 528 ACADEMY AVENUE","87a9d9c3-32f4-ea11-b882-24ee9a37d45c",-74243400,40508300,"I.S. 34 (OLD TOTTENVILLE) - S.I","528 ACADEMY AVENUE"
2,1,1,"94283fb1-30f4-ea11-b882-24ee9a37d45c","Digital Arts and Cinema Technology High School - K429 - K293 - 15K429 - 284 Baltic Street","91283fb1-30f4-ea11-b882-24ee9a37d45c",-73993293,40685006,"J.H.S. 293 - BROOKLYN","284 Baltic Street"
4,3,1,"b779df48-30f4-ea11-b882-24ee9a37d45c","P.S. 058 The Carroll - K058 - K058 - 15K058 - 330 SMITH STREET","b879df48-30f4-ea11-b882-24ee9a37d45c",-73995486,40680379,"P.S. 58 - BROOKLYN","330 SMITH STREET"
1,1,0,"6241e65b-31f4-ea11-b882-24ee9a37d45c","Yorkville Community School - M151 - M066 - 02M151 - 421 East 88 Street","6341e65b-31f4-ea11-b882-24ee9a37d45c",-73947287,40777948,"RICHARD R GREEN HS OF TEACHING - M","421 East 88 Street"
1,1,0,"2b0d6d19-33f4-ea11-b882-24ee9a37d45c","Archer Elementary School - X531 - X102 - 12X531 - 1827 ARCHER STREET","290d6d19-33f4-ea11-b882-24ee9a37d45c",-73866038,40838151,"P.S. 102 - BRONX","1827 ARCHER STREET"
3,0,3,"673cbf01-ebf6-ea11-b883-24ee9a37d459","P.S. X596 - X596 - X178 - 75X596 - 850 BAYCHESTER AVENUE","e38a0044-33f4-ea11-b882-24ee9a37d45c",-73831669,40874035,"P.S. 178 - BRONX","850 BAYCHESTER AVENUE"
1,0,1,"92dc32dc-31f4-ea11-b882-24ee9a37d45c","P.S. 002 Alfred Zimberg - Q002 - Q002 - 30Q002 - 75-10 21 Avenue","93dc32dc-31f4-ea11-b882-24ee9a37d45c",-73894108,40769798,"P.S. 2 - QUEENS","75-10 21 Avenue"
6,4,2,"f38ac007-ebf6-ea11-b883-24ee9a37d459","P.S. X176 - X176 - X455 - 75X176 - 750 BAYCHESTER AVENUE","8253dd74-33f4-ea11-b882-24ee9a37d45c",-73831669,40874035,"HARRY S. TRUMAN HS - X","750 BAYCHESTER AVENUE"
1,1,0,"e89b4c1f-32f4-ea11-b882-24ee9a37d45c","P.S. 155 - Q155 - Q155 - 27Q155 - 130-02 115 AVENUE","e99b4c1f-32f4-ea11-b882-24ee9a37d45c",-73810067,40679105,"P.S. 155 - QUEENS","130-02 115 AVENUE"
17,11,6,"2aa6ba98-31f4-ea11-b882-24ee9a37d45c","High School for Media and Communications - M463 - M465 - 06M463 - 549 AUDUBON AVENUE","25a6ba98-31f4-ea11-b882-24ee9a37d45c",-73926060,40856532,"G. WASHINGTON HS EDUC. CAMPUS - M","549 AUDUBON AVENUE"
1,0,1,"ee8a0044-33f4-ea11-b882-24ee9a37d45c","P.S. 168 - X168 - X183 - 75X168 - 339 MORRIS AVENUE","ef8a0044-33f4-ea11-b882-24ee9a37d45c",-73925995,40813681,"J.H.S. 203 - BRONX","339 MORRIS AVENUE"
2,0,2,"659d7c62-33f4-ea11-b882-24ee9a37d45c","Mott Hall V - X242 - X423 - 12X242 - 1551 EAST 172ND STREET","639d7c62-33f4-ea11-b882-24ee9a37d45c",-73878191,40832508,"JAMES MONROE HS CAMPUS ANNEX - BRONX","1551 EAST 172ND STREET"
1,1,0,"4c02fdd0-ebf6-ea11-b883-24ee9a37d459","The Richard H. Hungerford School - R721 - R043 - 75R721 - 100 ESSEX DRIVE","a0a9d9c3-32f4-ea11-b882-24ee9a37d45c",-74159343,40581958,"JEROME PARKER CAMPUS - S.I.","100 ESSEX DRIVE"
1,1,0,"5e34aa92-31f4-ea11-b882-24ee9a37d45c","The Peck Slip School - M343 - M343 - 02M343 - 1 PECK SLIP","e7e0838c-31f4-ea11-b882-24ee9a37d45c",-74002407,40708774,"THE PECK SLIP SCHOOL - MANHATTAN","1 PECK SLIP"
5,5,0,"410b210d-33f4-ea11-b882-24ee9a37d45c","P.S. 081 Robert J. Christen - X081 - X081 - 10X081 - 5550 RIVERDALE AVENUE","420b210d-33f4-ea11-b882-24ee9a37d45c",-73904657,40903275,"P.S. 81 - BRONX","5550 RIVERDALE AVENUE"
1,0,1,"6329a44a-ebf6-ea11-b883-24ee9a37d459","Passages Academy - X695 - K932 - 79X695 - 619 BELMONT AVENUE","2368ee1e-31f4-ea11-b882-24ee9a37d45c",-73886750,40672292,"Belmont- K","619 BELMONT AVENUE"
2,2,0,"71c280bd-31f4-ea11-b882-24ee9a37d45c","Eleanor Roosevelt High School - M416 - M855 - 02M416 - 411 EAST 76 STREET","72c280bd-31f4-ea11-b882-24ee9a37d45c",-73953276,40770288,"ELEANOR ROOSEVELT HS - MANHATTAN","411 EAST 76 STREET"
1,0,1,"179ebaee-32f4-ea11-b882-24ee9a37d45c","Milton Fein School - X007 - X007 - 10X007 - 3201 KINGSBRIDGE AVENUE","189ebaee-32f4-ea11-b882-24ee9a37d45c",-73905697,40881562,"P.S. 7 - BRONX","3201 KINGSBRIDGE AVENUE"
1,0,1,"dce8ce00-32f4-ea11-b882-24ee9a37d45c","PS 80 The Thurgood Marshall Magnet School of Multimedia and Communication - Q080 - Q080 - 28Q080 - 171-05 137TH AVENUE","dde8ce00-32f4-ea11-b882-24ee9a37d45c",-73769119,40673483,"P.S. 80 - QUEENS","171-05 137TH AVENUE"
1,1,0,"9f28a20c-31f4-ea11-b882-24ee9a37d45c","P.S. 163 Bath Beach - K163 - K807 - 20K163 - 109 BAY 14TH STREET","9b28a20c-31f4-ea11-b882-24ee9a37d45c",-74007469,40606739,"P.S./ I.S. 163 - BROOKLYN","109 BAY 14TH STREET"
1,1,0,"3e2f7d06-31f4-ea11-b882-24ee9a37d45c","P.S. 207 Elizabeth G. Leary - K207 - K729 - 22K207 - 3874 Flatlands Avenue","3f2f7d06-31f4-ea11-b882-24ee9a37d45c",-73935842,40619891,"P.S. 207 ANNEX - BROOKLYN","3874 Flatlands Avenue"
9,0,9,"55507380-31f4-ea11-b882-24ee9a37d45c","The Locke School of Arts and Engineering - M185 - M185 - 03M185 - 20 WEST 112 STREET","56507380-31f4-ea11-b882-24ee9a37d45c",-73950146,40798461,"P.S. 185 (TANDEM M208) - MANHATTAN","20 WEST 112 STREET"
2,1,1,"bbba3c50-33f4-ea11-b882-24ee9a37d45c","Comprehensive Model School Project M.S. 327 - X327 - X240 - 09X327 - 1501 JEROME AVENUE","baba3c50-33f4-ea11-b882-24ee9a37d45c",-73916084,40842503,"DOE NEW SETTLEMENT COMMUNITY CAMPUS - X","1501 JEROME AVENUE"
3,0,3,"8c977d2b-32f4-ea11-b882-24ee9a37d45c","P.S. 195 William Haberle - Q195 - Q195 - 29Q195 - 253-50 149 Avenue","8d977d2b-32f4-ea11-b882-24ee9a37d45c",-73735618,40652641,"P.S. 195 - QUEENS","253-50 149 Avenue"
3,1,2,"9201ce37-33f4-ea11-b882-24ee9a37d45c","P.S. 159 Luis Munoz Marin Biling - X159 - X159 - 10X159 - 2315 WASHINGTON AVENUE","9001ce37-33f4-ea11-b882-24ee9a37d45c",-73893136,40855680,"P.S. 159 - BRONX","2315 WASHINGTON AVENUE"
1,1,0,"fcb98b86-30f4-ea11-b882-24ee9a37d45c","P.S. 199 Frederick Wachtel - K199 - K199 - 21K199 - 1100 ELM AVENUE","fdb98b86-30f4-ea11-b882-24ee9a37d45c",-73963026,40616310,"P.S. 199 - BROOKLYN","1100 ELM AVENUE"
1,0,1,"3beabc42-30f4-ea11-b882-24ee9a37d45c","P.S. 056 Lewis H. Latimer - K056 - K056 - 13K056 - 170 GATES AVENUE","39eabc42-30f4-ea11-b882-24ee9a37d45c",-73960536,40684286,"P.S. 56 - BROOKLYN","170 GATES AVENUE"
2,0,2,"0922d292-30f4-ea11-b882-24ee9a37d45c","New American Academy Charter School - K736 - K233 - 84K736 - 9301 AVENUE B","0a22d292-30f4-ea11-b882-24ee9a37d45c",-73914282,40651642,"P.S. 233 - BROOKLYN","9301 AVENUE B"
7,7,0,"150410ca-32f4-ea11-b882-24ee9a37d45c","Gaynor McCown Expeditionary Learning School - R064 - R043 - 31R064 - 100 ESSEX DRIVE","a0a9d9c3-32f4-ea11-b882-24ee9a37d45c",-74159343,40581958,"JEROME PARKER CAMPUS - S.I.","100 ESSEX DRIVE"
1,1,0,"1168ee1e-31f4-ea11-b882-24ee9a37d45c","P.S. 373 - Brooklyn Transition Center - K373 - K909 - 75K373 - 561 GRAND AVENUE","1268ee1e-31f4-ea11-b882-24ee9a37d45c",-73961636,40678591,"ACORN COMMUNITY HS - K","561 GRAND AVENUE"
1,0,1,"9441e65b-31f4-ea11-b882-24ee9a37d45c","Frederick Douglass Academy II Secondary School - M860 - M088 - 03M860 - 215 WEST 114 STREET","8841e65b-31f4-ea11-b882-24ee9a37d45c",-73954152,40802610,"I.S. 88 - MANHATTAN","215 WEST 114 STREET"
2,1,1,"818d8486-31f4-ea11-b882-24ee9a37d45c","P.S. 77 Lower Lab School - M077 - M198 - 02M077 - 1700 3 AVENUE","7f8d8486-31f4-ea11-b882-24ee9a37d45c",-73950420,40785018,"P.S. 198 - MANHATTAN","1700 3 AVENUE"
2,0,2,"f68052e9-ebf6-ea11-b883-24ee9a37d459","P.S. X017 - X017 - X043 - 75X017 - 165 BROWN PLACE","1803cefa-32f4-ea11-b882-24ee9a37d45c",-73921593,40806452,"P.S. 43 - BRONX","165 BROWN PLACE"
1,0,1,"33e61462-31f4-ea11-b882-24ee9a37d45c","M.S. 324 - Patria Mirabal - M324 - M090 - 06M324 - 21 JUMEL PLACE","2ce61462-31f4-ea11-b882-24ee9a37d45c",-73935815,40839139,"I.S. 90 - MANHATTAN","21 JUMEL PLACE"
1,0,1,"a7eb0e7b-33f4-ea11-b882-24ee9a37d45c","High School for Energy and Technology - X565 - X660 - 10X565 - 2474 CROTONA AVENUE","a3eb0e7b-33f4-ea11-b882-24ee9a37d45c",-73882487,40855392,"GRACE H. DODGE VOC HS - X","2474 CROTONA AVENUE"
1,1,0,"e78442ee-31f4-ea11-b882-24ee9a37d45c","P.S. 041 Crocheron - Q041 - Q041 - 26Q041 - 214-43 35 AVENUE","e58442ee-31f4-ea11-b882-24ee9a37d45c",-73771225,40770155,"P.S. 41 - QUEENS","214-43 35 AVENUE"
1,1,0,"9fa9d9c3-32f4-ea11-b882-24ee9a37d45c","Marsh Avenue School for Expeditionary Learning - R063 - R043 - 31R063 - 100 ESSEX DRIVE","a0a9d9c3-32f4-ea11-b882-24ee9a37d45c",-74159343,40581958,"JEROME PARKER CAMPUS - S.I.","100 ESSEX DRIVE"
1,1,0,"7303194f-30f4-ea11-b882-24ee9a37d45c","P.S. 69 Vincent D. Grippo School - K069 - K069 - 20K069 - 6302 9TH AVENUE","7203194f-30f4-ea11-b882-24ee9a37d45c",-74009752,40632392,"P.S. 69 - BROOKLYN","6302 9TH AVENUE"
1,0,1,"a2bd7f88-8f3d-eb11-b88a-24ee9a37d45c","Highbridge Advisory Council - XAIQ - XAXN -  - 921 MELROSE AVENUE","a3bd7f88-8f3d-eb11-b88a-24ee9a37d45c",-73913396,40825055,"Richard H. Mangum Early Learning Center","921 MELROSE AVENUE"
5,4,1,"d611f898-32f4-ea11-b882-24ee9a37d45c","Renaissance Charter School - Q705 - Q885 - 84Q705 - 35-59 81ST STREET","d511f898-32f4-ea11-b882-24ee9a37d45c",-73884817,40749934,"RENAISSANCE CHARTER SCHOOL - Q","35-59 81ST STREET"
1,1,0,"48e61462-31f4-ea11-b882-24ee9a37d45c","P.S. 098 Shorac Kappock - M098 - M098 - 06M098 - 512 WEST 212 STREET","49e61462-31f4-ea11-b882-24ee9a37d45c",-73917814,40867741,"P.S. 98 - MANHATTAN","512 WEST 212 STREET"
2,1,1,"95886843-31f4-ea11-b882-24ee9a37d45c","P.S. 009 Sarah Anderson - M009 - M009 - 03M009 - 100 WEST 84 STREET","87886843-31f4-ea11-b882-24ee9a37d45c",-73974256,40785234,"P.S. 9 - MANHATTAN","100 WEST 84 STREET"
1,0,1,"9f3eb8c9-31f4-ea11-b882-24ee9a37d45c","P.S. 035 - M035 - MANJ - 75M035 - 462 1 AVENUE","a03eb8c9-31f4-ea11-b882-24ee9a37d45c",-73976863,40739181,"BELLEVUE HOSPITAL BUILDING","462 1 AVENUE"
2,0,2,"81a5db98-30f4-ea11-b882-24ee9a37d45c","P.S. 244 Richard R. Green - K244 - K244 - 18K244 - 5404 TILDEN AVENUE","7fa5db98-30f4-ea11-b882-24ee9a37d45c",-73925592,40647851,"P.S. 244 - BROOKLYN","5404 TILDEN AVENUE"
2,2,0,"20a6ba98-31f4-ea11-b882-24ee9a37d45c","Academy for Software Engineering - M546 - M460 - 02M546 - 40 IRVING PLACE","16a6ba98-31f4-ea11-b882-24ee9a37d45c",-73987064,40735361,"WASHINGTON IRVING HS - MANHATTAN","40 IRVING PLACE"
3,1,2,"555bc58c-30f4-ea11-b882-24ee9a37d45c","P.S. 216 Arturo Toscanini - K216 - K216 - 21K216 - 350 AVENUE X","565bc58c-30f4-ea11-b882-24ee9a37d45c",-73969647,40590000,"P.S. 216 - BROOKLYN","350 AVENUE X"
2,1,1,"4fa10a44-32f4-ea11-b882-24ee9a37d45c","P.S./I.S. 268 - Q268 - Q268 - 29Q268 - 92-07 175 STREET","4ea10a44-32f4-ea11-b882-24ee9a37d45c",-73785210,40707648,"P.S. 268 - QUEENS","92-07 175 STREET"
2,1,1,"29e61462-31f4-ea11-b882-24ee9a37d45c","P.S. 89 - M089 - M089 - 02M089 - 201 WARREN STREET","9741e65b-31f4-ea11-b882-24ee9a37d45c",-74013967,40717010,"P.S./I.S. 89 - MANHATTAN","201 WARREN STREET"
1,1,0,"87611579-4afb-ea11-b883-24ee9a37d459","Immanuel Genius - QBHM - QBHM -  - 253-01","88611579-4afb-ea11-b883-24ee9a37d459",-73735409,40770787,"Immanuel Genius","253-01"
2,2,0,"6741e65b-31f4-ea11-b882-24ee9a37d45c","N.Y.C. Museum School - M414 - M070 - 02M414 - 333 WEST 17 STREET","defab455-31f4-ea11-b882-24ee9a37d45c",-74002222,40742512,"I.S. 70 - MANHATTAN","333 WEST 17 STREET"
2,2,0,"a869c231-32f4-ea11-b882-24ee9a37d45c","P.S. 205 Alexander Graham Bell - Q205 - Q205 - 26Q205 - 75-25 BELL BOULEVARD","a769c231-32f4-ea11-b882-24ee9a37d45c",-73756374,40738008,"P.S. 205 - QUEENS","75-25 BELL BOULEVARD"
1,0,1,"17005d7a-31f4-ea11-b882-24ee9a37d45c","P.S. 155 William Paca - M155 - M155 - 04M155 - 319 EAST 117 STREET","15005d7a-31f4-ea11-b882-24ee9a37d45c",-73935895,40797507,"P.S. 155 - MANHATTAN","319 EAST 117 STREET"
1,0,1,"81593c87-33f4-ea11-b882-24ee9a37d45c","Bronx High School for the Visual Arts - X418 - X839 - 11X418 - 2040 ANTIN PL","80593c87-33f4-ea11-b882-24ee9a37d45c",-73864438,40851577,"BRONX HIGH SCHOOL FOR THE VISUAL ARTS","2040 ANTIN PL"
2,2,0,"f2ae0313-32f4-ea11-b882-24ee9a37d45c","P.S. 122 Mamie Fay - Q122 - Q122 - 30Q122 - 21-21 DITMARS BOULEVARD","cb2ff20c-32f4-ea11-b882-24ee9a37d45c",-73915785,40780507,"P.S. 122 - QUEENS","21-21 DITMARS BOULEVARD"
1,1,0,"b7b36d80-30f4-ea11-b882-24ee9a37d45c","P.S. K231 - K231 - K180 - 75K231 - 5601 16 AVENUE","b8b36d80-30f4-ea11-b882-24ee9a37d45c",-73989250,40626454,"P.S. 180 - BROOKLYN","5601 16 AVENUE"
9,6,3,"9cd810ab-31f4-ea11-b882-24ee9a37d45c","NYC iSchool - M376 - M615 - 02M376 - 131 AVENUE OF THE AMERICAS","9ad810ab-31f4-ea11-b882-24ee9a37d45c",-74005058,40724630,"CHELSEA VOC HS - MANHATTAN","131 AVENUE OF THE AMERICAS"
1,1,0,"35ebaa73-30f4-ea11-b882-24ee9a37d45c","P.S. 164 Caesar Rodney - K164 - K164 - 20K164 - 4211 14 AVENUE","36ebaa73-30f4-ea11-b882-24ee9a37d45c",-73985739,40637101,"P.S. 164 - BROOKLYN","4211 14 AVENUE"
3,3,0,"5588e6db-30f4-ea11-b882-24ee9a37d45c","New Utrecht High School - K445 - K445 - 20K445 - 1601 80 STREET","5488e6db-30f4-ea11-b882-24ee9a37d45c",-74002308,40613041,"NEW UTRECHT HS - K","1601 80 STREET"
2,2,0,"be56635c-33f4-ea11-b882-24ee9a37d45c","Bronx River High School - X349 - X405 - 08X349 - 3000 EAST TREMONT AVENUE","b556635c-33f4-ea11-b882-24ee9a37d45c",-73839583,40839775,"HERBERT H. LEHMAN HS - X","3000 EAST TREMONT AVENUE"
1,1,0,"9c2aa42b-33f4-ea11-b882-24ee9a37d45c","Academy of Applied Mathematics and Technology - X343 - X139 - 07X343 - 345 BROOK AVENUE","942aa42b-33f4-ea11-b882-24ee9a37d45c",-73918774,40810314,"J.H.S. 222 - BRONX","345 BROOK AVENUE"
10,8,2,"e68521d0-32f4-ea11-b882-24ee9a37d45c","I.S. 075 Frank D. Paulo - R075 - R075 - 31R075 - 455 HUGUENOT AVENUE","e28521d0-32f4-ea11-b882-24ee9a37d45c",-74197033,40544535,"I.S. 75 - STATEN ISLAND","455 HUGUENOT AVENUE"
1,0,1,"ded27c6d-30f4-ea11-b882-24ee9a37d45c","P.S. 373 - Brooklyn Transition Center - K373 - K148 - 75K373 - 185 ELLERY STREET","dcd27c6d-30f4-ea11-b882-24ee9a37d45c",-73945211,40699214,"P.S. 373 (OLD P148) - BROOKLYN","185 ELLERY STREET"
4,2,2,"58507380-31f4-ea11-b882-24ee9a37d45c","P.S./I.S. 187 Hudson Cliffs - M187 - M187 - 06M187 - 349 CABRINI BOULEVARD","59507380-31f4-ea11-b882-24ee9a37d45c",-73936840,40856239,"P.S./I.S. 187 - MANHATTAN","349 CABRINI BOULEVARD"
1,0,1,"17c73b4a-32f4-ea11-b882-24ee9a37d45c","P.S. 182 Samantha Smith - Q182 - Q277 - 28Q182 - 153-27 88th Avenue","15c73b4a-32f4-ea11-b882-24ee9a37d45c",-73803183,40706750,"PS 182 SAMANTHA SMITH - QUEENS","153-27 88th Avenue"
3,2,1,"cf2ff20c-32f4-ea11-b882-24ee9a37d45c","P.S./I.S. 116 William C. Hughley - Q116 - Q116 - 29Q116 - 107-25 WREN PLACE","d02ff20c-32f4-ea11-b882-24ee9a37d45c",-73781839,40700840,"P.S. 116 - QUEENS","107-25 WREN PLACE"
2,2,0,"a332c3fb-eaf6-ea11-b883-24ee9a37d459","P.S. 131 Abigail Adams - Q131 - Q131 - 29Q131 - 170-21 84 Avenue","0eaf0313-32f4-ea11-b882-24ee9a37d45c",-73794061,40717150,"P.S. 131 - QUEENS","170-21 84 Avenue"
1,1,0,"c50d3c5b-30f4-ea11-b882-24ee9a37d45c","I.S. 096 Seth Low - K096 - K096 - 21K096 - 99 AVENUE P","c10d3c5b-30f4-ea11-b882-24ee9a37d45c",-73984985,40608135,"I.S. 96 - BROOKLYN","99 AVENUE P"
1,1,0,"612f77fa-31f4-ea11-b882-24ee9a37d45c","I.S. 061 Leonardo Da Vinci - Q061 - Q061 - 24Q061 - 98-50 50 AVENUE","5f2f77fa-31f4-ea11-b882-24ee9a37d45c",-73862886,40741898,"I.S. 61 - QUEENS","98-50 50 AVENUE"
1,0,1,"83e03d56-33f4-ea11-b882-24ee9a37d45c","Morris Academy for Collaborative Studies - X297 - X400 - 09X297 - 1110 BOSTON ROAD","82e03d56-33f4-ea11-b882-24ee9a37d45c",-73903920,40827455,"MORRIS HS - X","1110 BOSTON ROAD"
2,1,1,"725bc58c-30f4-ea11-b882-24ee9a37d45c","Urban Assembly School for Leadership and Empowerment - K609 - K223 - 20K609 - 4200 16 AVENUE","735bc58c-30f4-ea11-b882-24ee9a37d45c",-73982424,40635100,"I.S. 223 - BROOKLYN","4200 16 AVENUE"
2,1,1,"c68442ee-31f4-ea11-b882-24ee9a37d45c","P.S. 031 Bayside - Q031 - Q031 - 26Q031 - 211-45 46 ROAD","c78442ee-31f4-ea11-b882-24ee9a37d45c",-73768994,40757701,"P.S. 31 - QUEENS","211-45 46 ROAD"
1,1,0,"43767649-31f4-ea11-b882-24ee9a37d45c","P.S. 033 Chelsea Prep - M033 - M033 - 02M033 - 281 9 AVENUE","42767649-31f4-ea11-b882-24ee9a37d45c",-74000238,40749014,"P.S. 33 - MANHATTAN","281 9 AVENUE"
1,0,1,"a2eb0e7b-33f4-ea11-b882-24ee9a37d45c","Crotona International High School - X524 - X660 - 10X524 - 2474 CROTONA AVENUE","a3eb0e7b-33f4-ea11-b882-24ee9a37d45c",-73882487,40855392,"GRACE H. DODGE VOC HS - X","2474 CROTONA AVENUE"
3,1,2,"d28442ee-31f4-ea11-b882-24ee9a37d45c","P.S. 035 Nathaniel Woodhull - Q035 - Q035 - 29Q035 - 90-01 191 Street","bb8442ee-31f4-ea11-b882-24ee9a37d45c",-73768894,40713438,"P.S. 35 - QUEENS","191-02 90 Avenue"
1,0,1,"3a68ee1e-31f4-ea11-b882-24ee9a37d45c","P.S. 007 Abraham Lincoln - K007 - K991 - 19K007 - 858 Jamaica Avenue","3b68ee1e-31f4-ea11-b882-24ee9a37d45c",-73872983,40689213,"P.S. 7 TRANSPORTABLE - K","858 Jamaica Avenue"
1,0,1,"862aa42b-33f4-ea11-b882-24ee9a37d45c","Bronx Park Middle School - X556 - X135 - 11X556 - 2441 WALLACE AVENUE","d4689025-33f4-ea11-b882-24ee9a37d45c",-73865028,40862098,"I.S. 135 - BRONX","2441 WALLACE AVENUE"
1,0,1,"76b50aa5-30f4-ea11-b882-24ee9a37d45c","P.S. 264 Bay Ridge Elementary School For The Arts - K264 - K264 - 20K264 - 371 89th Street","74b50aa5-30f4-ea11-b882-24ee9a37d45c",-74029444,40621025,"PS 264 BAY RIDGE ELEM SCL FOR THE ARTS - BROOKLYN","371 89th Street"
3,2,1,"abd810ab-31f4-ea11-b882-24ee9a37d45c","Stephen T. Mather Building Arts & Craftsmanship High School - M139 - M625 - 02M139 - 439 WEST 49TH STREET","a9d810ab-31f4-ea11-b882-24ee9a37d45c",-73990318,40763655,"HS OF GRAPHIC COMMUNICATION ARTS-M","439 WEST 49TH STREET"
2,2,0,"bebfa431-33f4-ea11-b882-24ee9a37d45c","South Bronx Preparatory: A College Board School - X221 - X149 - 07X221 - 360 EAST 145 STREET","bcbfa431-33f4-ea11-b882-24ee9a37d45c",-73920851,40813612,"J.H.S. 149 - BRONX","360 EAST 145 STREET"
2,0,2,"bd48b1f5-eaf6-ea11-b883-24ee9a37d459","Manhattan School for Career Development - M751 - M751 - 75M751 - 113 EAST 4TH STREET","6c0c1bb1-31f4-ea11-b882-24ee9a37d45c",-73987791,40725892,"P.S. 751 (CAR.DEV/OLD 25) - M","113 EAST 4TH STREET"
1,0,1,"882aa42b-33f4-ea11-b882-24ee9a37d45c","P186X Walter J. Damrosch School - X186 - X136 - 75X186 - 750 Jennings Street","892aa42b-33f4-ea11-b882-24ee9a37d45c",-73897797,40831388,"P.S. 186 (OLD J136) - BRONX","750 Jennings Street"
1,0,1,"0ab7c337-32f4-ea11-b882-24ee9a37d45c","P.S. 219 Paul Klapper - Q219 - Q219 - 25Q219 - 144-39 GRAVETT ROAD","0bb7c337-32f4-ea11-b882-24ee9a37d45c",-73823841,40737448,"P.S. 219 - QUEENS","144-39 GRAVETT ROAD"
1,0,1,"7907e99e-31f4-ea11-b882-24ee9a37d45c","Art and Design High School - M630 - M488 - 02M630 - 231-249 EAST 56 STREET","6d07e99e-31f4-ea11-b882-24ee9a37d45c",-73967204,40759248,"MIDTOWN EAST CAMPUS - MANHATTAN","231-249 EAST 56 STREET"
1,1,0,"9553dd74-33f4-ea11-b882-24ee9a37d45c","University Heights Secondary School - X495 - X470 - 07X495 - 701 ST. ANNS AVENUE","9253dd74-33f4-ea11-b882-24ee9a37d45c",-73911633,40818041,"SOUTH BRONX EDUCATIONAL CAMPUS (OLD 38) - X","701 ST. ANNS AVENUE"
3,2,1,"778d8486-31f4-ea11-b882-24ee9a37d45c","KIPP Infinity Charter School - M336 - M195 - 84M336 - 625 WEST 133 STREET","758d8486-31f4-ea11-b882-24ee9a37d45c",-73956814,40819793,"TERENCE D. TOLBERT EDUCATION COMPLEX - MANHATTAN","625 WEST 133 STREET"
2,2,0,"9241e65b-31f4-ea11-b882-24ee9a37d45c","Wadleigh Secondary School for the Performing & Visual Arts - M415 - M088 - 03M415 - 215 WEST 114 STREET","8841e65b-31f4-ea11-b882-24ee9a37d45c",-73954152,40802610,"I.S. 88 - MANHATTAN","215 WEST 114 STREET"
4,0,4,"4d3cbf01-ebf6-ea11-b883-24ee9a37d459","P.S. R373 - R373 - R040 - 75R373 - 91 HENDERSON AVENUE","97a9d9c3-32f4-ea11-b882-24ee9a37d45c",-74095454,40641180,"P.S. 373 (OLD P40) - STATEN ISLAND","91 HENDERSON AVENUE"
3,0,3,"e72ece86-32f4-ea11-b882-24ee9a37d45c","Civic Leadership Academy - Q293 - Q744 - 24Q293 - 45-10 94th Street","e22ece86-32f4-ea11-b882-24ee9a37d45c",-73871505,40743228,"ELMHURST EDUCATIONAL CAMPUS - Q","45-10 94th Street"
3,0,3,"3cde5eb7-30f4-ea11-b882-24ee9a37d45c","Brownsville Collaborative Middle School - K363 - K298 - 23K363 - 85 WATKINS STREET","3dde5eb7-30f4-ea11-b882-24ee9a37d45c",-73907718,40671015,"P.S. 298 - BROOKLYN","85 WATKINS STREET"
2,2,0,"4b6e70b7-31f4-ea11-b882-24ee9a37d45c","High School for Mathematics, Science and Engineering at City College - M692 - M812 - 05M692 - 240 CONVENT AVE","4c6e70b7-31f4-ea11-b882-24ee9a37d45c",-73950354,40820208,"HS FOR MATH, SCI & ENGINEERING-M","240 CONVENT AVE"
2,0,2,"d79319d7-ebf6-ea11-b883-24ee9a37d459","P.S. R373 - R373 - R061 - 75R373 - 445 CASTLETON AVENUE","460410ca-32f4-ea11-b882-24ee9a37d45c",-74097941,40634497,"I.S. 61 - STATEN ISLAND","445 CASTLETON AVENUE"
2,2,0,"e437fba4-31f4-ea11-b882-24ee9a37d45c","Urban Assembly Maker Academy - M282 - M520 - 02M282 - 411 PEARL STREET","e037fba4-31f4-ea11-b882-24ee9a37d45c",-74000851,40711441,"MURRY BERGTRAUM HS (ECF) - M","411 PEARL STREET"
3,2,1,"50fdc1bd-32f4-ea11-b882-24ee9a37d45c","P.S. 013 M. L. Lindemeyer - R013 - R013 - 31R013 - 191 VERMONT AVENUE","51fdc1bd-32f4-ea11-b882-24ee9a37d45c",-74068963,40613322,"P.S. 13 - STATEN ISLAND","191 VERMONT AVENUE"
1,1,0,"993aa668-33f4-ea11-b882-24ee9a37d45c","High School for Contemporary Arts - X544 - X425 - 11X544 - 800 EAST GUN HILL ROAD","699d7c62-33f4-ea11-b882-24ee9a37d45c",-73861649,40875172,"EVANDER CHILDS HS - X","800 EAST GUN HILL ROAD"
2,0,2,"4e6e70b7-31f4-ea11-b882-24ee9a37d45c","Community Health Academy of the Heights - M346 - M814 - 06M346 - 504 WEST 158TH STREET","4f6e70b7-31f4-ea11-b882-24ee9a37d45c",-73942074,40833695,"THE COMMUNITY HEALTH ACADEMY OF THE HEIGHTS - M","504 WEST 158TH STREET"
1,1,0,"6f2f77fa-31f4-ea11-b882-24ee9a37d45c","P.S. 066 Jacqueline Kennedy Onassis - Q066 - Q066 - 27Q066 - 85-11 102 Street","702f77fa-31f4-ea11-b882-24ee9a37d45c",-73846135,40697941,"P.S. 66 - QUEENS","85-11 102 Street"
2,2,0,"d6d27c6d-30f4-ea11-b882-24ee9a37d45c","P.S. 145 Andrew Jackson - K145 - K145 - 32K145 - 100 NOLL STREET","d7d27c6d-30f4-ea11-b882-24ee9a37d45c",-73932388,40701107,"P.S. 145 - BROOKLYN","100 NOLL STREET"
2,0,2,"53ffcc6e-33f4-ea11-b882-24ee9a37d45c","World View High School - X353 - X440 - 10X353 - 100 WEST MOSHOLU PARKWAY SOUTH","4cffcc6e-33f4-ea11-b882-24ee9a37d45c",-73889011,40879958,"DEWITT CLINTON HS - X","100 WEST MOSHOLU PARKWAY SOUTH"
3,3,0,"cd315367-30f4-ea11-b882-24ee9a37d45c","P.S. 127 Mckinley Park - K127 - K127 - 20K127 - 7805 7 Avenue","ce315367-30f4-ea11-b882-24ee9a37d45c",-74018429,40623687,"P.S. 127 - BROOKLYN","7805 7 Avenue"
1,0,1,"ed2d6c32-ebf6-ea11-b883-24ee9a37d459","P.S. K053 - K053 - K384 - 75K053 - 242 COOPER STREET","21e2abc9-30f4-ea11-b882-24ee9a37d45c",-73904695,40689883,"P.S. 384 - BROOKLYN","242 COOPER STREET"
2,1,1,"8b11b2e2-32f4-ea11-b882-24ee9a37d45c","Staten Island School of Civic Leadership - R861 - R861 - 31R861 - 280 REGIS DRIVE","8a11b2e2-32f4-ea11-b882-24ee9a37d45c",-74164427,40620310,"ELIZABETH A. CONNELLY CAMPUS - S.I.","280 REGIS DRIVE"
1,0,1,"26af0313-32f4-ea11-b882-24ee9a37d45c","P.S./M.S. 138 Sunrise - Q138 - Q138 - 29Q138 - 251-11 WELLER AVENUE","1aaf0313-32f4-ea11-b882-24ee9a37d45c",-73734342,40659876,"P.S. 138 - QUEENS","251-11 WELLER AVENUE"
3,3,0,"52474313-33f4-ea11-b882-24ee9a37d45c","M.S. X101 Edward R. Byrne - X101 - X101 - 08X101 - 2750 LAFAYETTE AVENUE","4e474313-33f4-ea11-b882-24ee9a37d45c",-73829211,40827080,"I.S. 101 - BRONX","2750 LAFAYETTE AVENUE"
1,0,1,"1fd8cf12-31f4-ea11-b882-24ee9a37d45c","P.S. 235 Janice Marie Knight School - K235 - K855 - 18K235 - 5811 DITMAS AVENUE","1bd8cf12-31f4-ea11-b882-24ee9a37d45c",-73921362,40644094,"P.S. 135/P.S. 235 ANNEX - K","5811 DITMAS AVENUE"
1,0,1,"5d2b3eee-30f4-ea11-b882-24ee9a37d45c","High School for Medical Professions - K633 - K500 - 18K633 - 1600 ROCKAWAY PARKWAY","5e2b3eee-30f4-ea11-b882-24ee9a37d45c",-73898601,40640543,"CANARSIE HS - K","1600 ROCKAWAY PARKWAY"
1,1,0,"848946f4-31f4-ea11-b882-24ee9a37d45c","P.S. 58 - The School of Heroes - Q058 - Q058 - 24Q058 - 72-24 GRAND AVENUE","808946f4-31f4-ea11-b882-24ee9a37d45c",-73890638,40728517,"P.S. 58 - QUEENS","72-24 GRAND AVENUE"
2,2,0,"f32ece86-32f4-ea11-b882-24ee9a37d45c","Queens High School for the Sciences at York College - Q687 - Q774 - 28Q687 - 94-50 159 Street","f42ece86-32f4-ea11-b882-24ee9a37d45c",-73798364,40700884,"QUEENS HIGH SCHOOL FOR THE SCIENCES","94-50 159 Street"
4,4,0,"9d69c231-32f4-ea11-b882-24ee9a37d45c","P.S. 203 Oakland Gardens - Q203 - Q203 - 26Q203 - 53-11 SPRINGFIELD BOULEVARD","9e69c231-32f4-ea11-b882-24ee9a37d45c",-73759822,40753606,"P.S. 203 - QUEENS","53-11 SPRINGFIELD BOULEVARD"
1,1,0,"629d7c62-33f4-ea11-b882-24ee9a37d45c","The Cinema School - X478 - X423 - 12X478 - 1551 EAST 172ND STREET","639d7c62-33f4-ea11-b882-24ee9a37d45c",-73878191,40832508,"JAMES MONROE HS CAMPUS ANNEX - BRONX","1551 EAST 172ND STREET"
5,1,4,"2c06003e-32f4-ea11-b882-24ee9a37d45c","P.S. 242 Leonard P. Stavisky Early Childhood School - Q242 - Q242 - 25Q242 - 29-66 137 STREET","2d06003e-32f4-ea11-b882-24ee9a37d45c",-73832005,40769752,"P.S. 242 - (ECC) - QUEENS","29-66 137 STREET"
1,0,1,"a70e6e25-32f4-ea11-b882-24ee9a37d45c","P.S. 181 Brookfield - Q181 - Q181 - 29Q181 - 148-15 230 Street","a80e6e25-32f4-ea11-b882-24ee9a37d45c",-73752948,40655674,"P.S. 181 - QUEENS","148-15 230 Street"
1,0,1,"66395a2c-ebf6-ea11-b883-24ee9a37d459","P.S. K053 - K053 - K296 - 75K053 - 125 COVERT STREET","99283fb1-30f4-ea11-b882-24ee9a37d45c",-73910589,40688647,"I.S. 296 - BROOKLYN","125 COVERT STREET"
1,0,1,"3788e6db-30f4-ea11-b882-24ee9a37d45c","FDNY - Captain Vernon A. Richard High School for Fire and Life Safety - K502 - K435 - 19K502 - 400 PENNSYLVANIA AVENUE","3688e6db-30f4-ea11-b882-24ee9a37d45c",-73895122,40666868,"THOMAS JEFFERSON HS - K","400 PENNSYLVANIA AVENUE"
4,4,0,"9672c880-32f4-ea11-b882-24ee9a37d45c","High School for Construction Trades, Engineering and Architecture - Q650 - Q650 - 27Q650 - 94-06 104TH STREET","8f72c880-32f4-ea11-b882-24ee9a37d45c",-73841475,40689177,"HS FOR CONST.TRADES,ENGG.,& ARCH-Q","94-06 104TH STREET"
1,1,0,"950e6e25-32f4-ea11-b882-24ee9a37d45c","P.S. 175 The Lynn Gross Discovery School - Q175 - Q175 - 28Q175 - 64-35 102 STREET","960e6e25-32f4-ea11-b882-24ee9a37d45c",-73852210,40731016,"P.S. 175 - QUEENS","64-35 102 STREET"
1,0,1,"8e34aa92-31f4-ea11-b882-24ee9a37d45c","New Design High School - M543 - M445 - 02M543 - 350 GRAND STREET","8834aa92-31f4-ea11-b882-24ee9a37d45c",-73989329,40717329,"SEWARD PARK HS - MANHATTAN","350 GRAND STREET"
3,2,1,"e68a0044-33f4-ea11-b882-24ee9a37d45c","I.S. 181 Pablo Casals - X181 - X181 - 11X181 - 800 BAYCHESTER AVENUE","e78a0044-33f4-ea11-b882-24ee9a37d45c",-73831669,40874035,"I.S. 181 - BRONX","800 BAYCHESTER AVENUE"
1,1,0,"8f11b2e2-32f4-ea11-b882-24ee9a37d45c","Bridge Preparatory Charter School - R076 - R880 - 84R076 - 715 OCEAN TERRACE","8e11b2e2-32f4-ea11-b882-24ee9a37d45c",-74105883,40607637,"P.S. 80 (PETR COMPL-BLDG B) - S.I.","715 OCEAN TERRACE"
2,1,1,"77c280bd-31f4-ea11-b882-24ee9a37d45c","The Clinton School - M260 - M868 - 02M260 - 10 East 15th Street","78c280bd-31f4-ea11-b882-24ee9a37d45c",-73992727,40736526,"THE CLINTON SCHOOL - MANHATTAN","10 East 15th Street"
2,2,0,"15f32ce2-31f4-ea11-b882-24ee9a37d45c","P.S. 018 Winchester - Q018 - Q018 - 26Q018 - 86-35 235 COURT","16f32ce2-31f4-ea11-b882-24ee9a37d45c",-73732290,40731853,"P.S. 18 - QUEENS","86-35 235 COURT"
1,0,1,"d1d81655-6a01-ed11-b8db-24ee9a37d45c","P.S. 958 - K958 - K671 - 15K958 - 836-841 5th Avenue","d2d81655-6a01-ed11-b8db-24ee9a37d45c",-74002162,40653344,"P.S. @ 836-841 5TH AVENUE - BROOKLYN","836-841 5th Avenue"
8,6,2,"692b3eee-30f4-ea11-b882-24ee9a37d45c","Franklin Delano Roosevelt High School - K505 - K505 - 20K505 - 5800 20 AVENUE","682b3eee-30f4-ea11-b882-24ee9a37d45c",-73982583,40621299,"FRANKLIN D. ROOSEVELT HS - K","5800 20 AVENUE"
1,0,1,"5f6e70b7-31f4-ea11-b882-24ee9a37d45c","High School of Economics and Finance - M489 - M833 - 02M489 - 100 TRINITY PLACE","606e70b7-31f4-ea11-b882-24ee9a37d45c",-74012328,40709270,"HS FOR ECONOMICS & FINANCE - M","100 TRINITY PLACE"
2,1,1,"45e61462-31f4-ea11-b882-24ee9a37d45c","Bard High School Early College - M696 - M097 - 01M696 - 525 EAST HOUSTON STREET","46e61462-31f4-ea11-b882-24ee9a37d45c",-73976093,40718276,"BARD COLLEGE HS (OLD M097) - M","525 EAST HOUSTON STREET"
1,1,0,"6941e65b-31f4-ea11-b882-24ee9a37d45c","M.S. 250 West Side Collaborative Middle School - M250 - M075 - 03M250 - 735 WEST END AVENUE","6a41e65b-31f4-ea11-b882-24ee9a37d45c",-73973996,40795109,"P.S. 75 - MANHATTAN","735 WEST END AVENUE"
4,1,3,"24e2abc9-30f4-ea11-b882-24ee9a37d45c","KIPP Always Mentally Prepared Charter School - K357 - K390 - 84K357 - 1224 PARK PLACE","25e2abc9-30f4-ea11-b882-24ee9a37d45c",-73937601,40672290,"I.S. 390 - BROOKLYN","1224 PARK PLACE"
2,0,2,"693cbf01-ebf6-ea11-b883-24ee9a37d459","P.S. X017 - X017 - X184 - 75X017 - 778 FOREST AVENUE","f88a0044-33f4-ea11-b882-24ee9a37d45c",-73905389,40818703,"I.S. 184 - BRONX","778 FOREST AVENUE"
6,0,6,"f8d10307-33f4-ea11-b882-24ee9a37d45c","The Vida Bogart School for All Children - X352 - X074 - 75X352 - 730 BRYANT AVENUE","f9d10307-33f4-ea11-b882-24ee9a37d45c",-73885284,40815827,"I.S. 201 - BRONX","730 BRYANT AVENUE"
1,0,1,"752f77fa-31f4-ea11-b882-24ee9a37d45c","P.S. 068 Cambridge - Q068 - Q068 - 24Q068 - 59-09 SAINT FELIX AVENUE","762f77fa-31f4-ea11-b882-24ee9a37d45c",-73897372,40696961,"P.S. 68 - QUEENS","59-09 SAINT FELIX AVENUE"
1,1,0,"378dbfcf-30f4-ea11-b882-24ee9a37d45c","P.S. 770 New American Academy - K770 - K398 - 17K770 - 60 EAST 94 STREET","308dbfcf-30f4-ea11-b882-24ee9a37d45c",-73927979,40663388,"P.S. 398 (UDC) - BROOKLYN","60 EAST 94 STREET"
2,2,0,"1c7eed06-32f4-ea11-b882-24ee9a37d45c","P.S. 090 Horace Mann - Q090 - Q090 - 27Q090 - 86-50 109 STREET","1d7eed06-32f4-ea11-b882-24ee9a37d45c",-73839517,40696653,"P.S. 90 - QUEENS","86-50 109 STREET"
2,1,1,"e7201dab-30f4-ea11-b882-24ee9a37d45c","J.H.S. 278 Marine Park - K278 - K278 - 22K278 - 1925 STUART STREET","e8201dab-30f4-ea11-b882-24ee9a37d45c",-73938721,40606745,"I.S. 278 - BROOKLYN","1925 STUART STREET"
2,0,2,"690067b2-ebf6-ea11-b883-24ee9a37d459","P.S. Q993 - Q993 - Q452 - 75Q993 - 14-30 BROADWAY","81476368-32f4-ea11-b882-24ee9a37d45c",-73933907,40765881,"LONG ISLAND CITY HS(NEW)-Q","14-30 BROADWAY"
1,1,0,"8407e99e-31f4-ea11-b882-24ee9a37d45c","Manhattan / Hunter Science High School - M541 - M490 - 03M541 - 122 AMSTERDAM AVENUE","7c07e99e-31f4-ea11-b882-24ee9a37d45c",-73985608,40774891,"MARTIN LUTHER KING, JR. HS - M","122 AMSTERDAM AVENUE"
2,1,1,"5536d900-33f4-ea11-b882-24ee9a37d45c","P.S. 049 Willis Avenue - X049 - X049 - 07X049 - 383 EAST 139 STREET","4d36d900-33f4-ea11-b882-24ee9a37d45c",-73922730,40810413,"P.S. 49 - BRONX","383 EAST 139 STREET"
3,2,1,"b7ab074a-33f4-ea11-b882-24ee9a37d45c","P.S./M.S. 194 - X194 - X194 - 11X194 - 2365 WATERBURY AVENUE","b6ab074a-33f4-ea11-b882-24ee9a37d45c",-73846594,40835410,"P.S./I.S. 194 - BRONX","2365 WATERBURY AVENUE"
3,2,1,"0b7eed06-32f4-ea11-b882-24ee9a37d45c","P.S. 084 Steinway - Q084 - Q084 - 30Q084 - 22-45 41 STREET","0c7eed06-32f4-ea11-b882-24ee9a37d45c",-73906117,40771154,"P.S. 84 - QUEENS","22-45 41 STREET"
2,0,2,"aaeb6056-32f4-ea11-b882-24ee9a37d45c","The Hector Figueroa School - Q398 - Q398 - 30Q398 - 69-01 34TH AVENUE","abeb6056-32f4-ea11-b882-24ee9a37d45c",-73896705,40752773,"P.S. 398 - QUEENS","69-01 34TH AVENUE"
4,1,3,"9a778cb8-ebf6-ea11-b883-24ee9a37d459","P.S. Q993 - Q993 - Q499 - 75Q993 - 148-20 REEVES AVENUE","8bbc9674-32f4-ea11-b882-24ee9a37d45c",-73820821,40738599,"P.S./I.S. 499 - QUEENS","148-20 REEVES AVENUE"
4,2,2,"e7f22ce2-31f4-ea11-b882-24ee9a37d45c","I.S. 5 - The Walter Crowley Intermediate School - Q005 - Q005 - 24Q005 - 50-40 JACOBUS STREET","9adc32dc-31f4-ea11-b882-24ee9a37d45c",-73888133,40737405,"I.S. 5 - QUEENS","50-40 JACOBUS STREET"
2,2,0,"a132c3fb-eaf6-ea11-b883-24ee9a37d459","P.S. 085 Judge Charles Vallone - Q085 - Q085 - 30Q085 - 23-70 31 STREET","0a7eed06-32f4-ea11-b882-24ee9a37d45c",-73915039,40773126,"P.S. 85 - QUEENS","23-70 31 STREET"
1,1,0,"38e61462-31f4-ea11-b882-24ee9a37d45c","P.S. 092 Mary McLeod Bethune - M092 - M092 - 05M092 - 222 WEST 134 STREET","36e61462-31f4-ea11-b882-24ee9a37d45c",-73945838,40814917,"P.S. 92 - MANHATTAN","222 WEST 134 STREET"
2,1,1,"277eed06-32f4-ea11-b882-24ee9a37d45c","P.S. 094 David D. Porter - Q094 - Q094 - 26Q094 - 41-77 Little Neck Parkway","287eed06-32f4-ea11-b882-24ee9a37d45c",-73738703,40771258,"P.S. 94 - QUEENS","41-77 Little Neck Parkway"
5,1,4,"48507380-31f4-ea11-b882-24ee9a37d45c","Amistad Dual Language School - M311 - M176 - 06M311 - 4862 BROADWAY","46507380-31f4-ea11-b882-24ee9a37d45c",-73923818,40866381,"P.S./I.S. 176 - MANHATTAN","4862 BROADWAY"
1,1,0,"d9968d36-30f4-ea11-b882-24ee9a37d45c","P.S. 020 Clinton Hill - K020 - K020 - 13K020 - 225 ADELPHI STREET","d1968d36-30f4-ea11-b882-24ee9a37d45c",-73970896,40690742,"P.S. 20 - BROOKLYN","225 ADELPHI STREET"
1,0,1,"016ce65b-49fb-ea11-b883-24ee9a37d459","MARIBER COLON - APT1P - MBEM - MAXR -  - 9 SHERMAN AVENUE","026ce65b-49fb-ea11-b883-24ee9a37d459",-73928816,40862224,"9 SHERMAN AVENUE","9 SHERMAN AVENUE"
1,1,0,"d8315367-30f4-ea11-b882-24ee9a37d45c","P.S. 131 Brooklyn - K131 - K131 - 15K131 - 4305 FT HAMILTON PARKWAY","d9315367-30f4-ea11-b882-24ee9a37d45c",-73993247,40640728,"P.S. 131 - BROOKLYN","4305 FT HAMILTON PARKWAY"
4,3,1,"45507380-31f4-ea11-b882-24ee9a37d45c","Muscota - M314 - M176 - 06M314 - 4862 BROADWAY","46507380-31f4-ea11-b882-24ee9a37d45c",-73923818,40866381,"P.S./I.S. 176 - MANHATTAN","4862 BROADWAY"
4,3,1,"4be61462-31f4-ea11-b882-24ee9a37d45c","M.S. 224 Manhattan East School for Arts & Academics - M224 - M099 - 04M224 - 410 EAST 100 STREET","3de61462-31f4-ea11-b882-24ee9a37d45c",-73942154,40785107,"I.S. 99 - MANHATTAN","410 EAST 100 STREET"
2,1,1,"aebf14dd-ebf6-ea11-b883-24ee9a37d459","South Richmond High School I.S./P.S. 25 - R025 - R826 - 75R025 - 6581 Hylan Boulevard","7dbe7adc-32f4-ea11-b882-24ee9a37d45c",-74218688,40512019,"P.S. 3 ANNEX - STATEN ISLAND","6581 Hylan Boulevard"
1,0,1,"40b4977a-32f4-ea11-b882-24ee9a37d45c","Queens Technical High School - Q600 - Q600 - 24Q600 - 37-02 47 AVENUE","41b4977a-32f4-ea11-b882-24ee9a37d45c",-73927995,40741658,"QUEENS VOC HS - Q","37-02 47 AVENUE"
1,0,1,"762b3eee-30f4-ea11-b882-24ee9a37d45c","Academy for Conservation and the Environment - K637 - K515 - 18K637 - 6565 FLATLANDS AVENUE","6d2b3eee-30f4-ea11-b882-24ee9a37d45c",-73916927,40634451,"SOUTH SHORE EDUCATIONAL CAMPUS - K","6565 FLATLANDS AVENUE"
2,2,0,"1f7eed06-32f4-ea11-b882-24ee9a37d45c","P.S. 091 Richard Arkwright - Q091 - Q091 - 24Q091 - 68-10 CENTRAL AVE","207eed06-32f4-ea11-b882-24ee9a37d45c",-73883995,40703503,"P.S. 91 - QUEENS","68-10 CENTRAL AVE"
1,0,1,"13b7c337-32f4-ea11-b882-24ee9a37d45c","P.S. Q222 - Fire Fighter Christopher A. Santora School - Q222 - Q222 - 30Q222 - 86-15 37 AVENUE","14b7c337-32f4-ea11-b882-24ee9a37d45c",-73879991,40750442,"P.S. 222 (ECC) - QUEENS","86-15 37 AVENUE"
1,0,1,"509f4974-31f4-ea11-b882-24ee9a37d45c","P.S. 146 Ann M. Short - M146 - M146 - 04M146 - 421 EAST 106 STREET","4f9f4974-31f4-ea11-b882-24ee9a37d45c",-73938727,40789535,"P.S. 146 - MANHATTAN","421 EAST 106 STREET"
2,0,2,"0a9c4c1f-32f4-ea11-b882-24ee9a37d45c","P.S. 165 Edith K. Bergtraum - Q165 - Q165 - 25Q165 - 70-35 150 Street","0b9c4c1f-32f4-ea11-b882-24ee9a37d45c",-73816966,40729746,"P.S. 165 - QUEENS","70-35 150 Street"
1,1,0,"9c4f8d2e-f7fe-eb11-b8b3-24ee9a37d45c","Oikos Community Corporation - QCDO - QAIK -  - 43-00 171 STREET","9d4f8d2e-f7fe-eb11-b8b3-24ee9a37d45c",-73796163,40757615,"YESHIVA INSTITUTE OF GREATER QUEENS","43-00 171 STREET"
3,2,1,"9969c231-32f4-ea11-b882-24ee9a37d45c","J.H.S. 202 Robert H. Goddard - Q202 - Q202 - 27Q202 - 138-30 LAFAYETTE STREET","9169c231-32f4-ea11-b882-24ee9a37d45c",-73845992,40670905,"I.S. 202 - QUEENS","138-30 LAFAYETTE STREET"
3,2,1,"cf56635c-33f4-ea11-b882-24ee9a37d45c","Bronx High School of Business - X412 - X410 - 09X412 - 240 EAST 172 STREET","c856635c-33f4-ea11-b882-24ee9a37d45c",-73911366,40839307,"WILLIAM H. TAFT HS - X","240 EAST 172 STREET"
2,1,1,"8d41e65b-31f4-ea11-b882-24ee9a37d45c","P.S. 087 William Sherman - M087 - M087 - 03M087 - 160 WEST 78 STREET","8e41e65b-31f4-ea11-b882-24ee9a37d45c",-73978020,40781710,"P.S. 87 - MANHATTAN","160 WEST 78 STREET"
5,5,0,"5c2f77fa-31f4-ea11-b882-24ee9a37d45c","P.S. 060 Woodhaven - Q060 - Q060 - 27Q060 - 91-02 88 AVENUE","8e8946f4-31f4-ea11-b882-24ee9a37d45c",-73852792,40691467,"P.S. 60 - QUEENS","91-02 88 AVENUE"
1,0,1,"2da10a44-32f4-ea11-b882-24ee9a37d45c","P.S. 128 The Lorraine Tuzzo, Juniper Valley Elementary School - Q128 - Q247 - 24Q128 - 69-10 65th Drive","2ca10a44-32f4-ea11-b882-24ee9a37d45c",-73885974,40715005,"PS/IS 128","69-10 65th Drive"
3,2,1,"af0e6e25-32f4-ea11-b882-24ee9a37d45c","P.S. 184 Flushing Manor - Q184 - Q184 - 25Q184 - 163-15 21 ROAD","b00e6e25-32f4-ea11-b882-24ee9a37d45c",-73799158,40778334,"P.S. 184 - QUEENS","163-15 21 ROAD"
1,1,0,"722b3eee-30f4-ea11-b882-24ee9a37d45c","Victory Collegiate High School - K576 - K515 - 18K576 - 6565 FLATLANDS AVENUE","6d2b3eee-30f4-ea11-b882-24ee9a37d45c",-73916927,40634451,"SOUTH SHORE EDUCATIONAL CAMPUS - K","6565 FLATLANDS AVENUE"
2,1,1,"21e85c61-30f4-ea11-b882-24ee9a37d45c","P.S. 112 Lefferts Park - K112 - K112 - 20K112 - 7115 15 AVENUE","22e85c61-30f4-ea11-b882-24ee9a37d45c",-74000565,40619417,"P.S. 112 - BROOKLYN","7115 15 AVENUE"
5,1,4,"377c21b7-32f4-ea11-b882-24ee9a37d45c","P.S. 004 Maurice Wollin - R004 - R004 - 31R004 - 200 NEDRA LANE","337c21b7-32f4-ea11-b882-24ee9a37d45c",-74195281,40552059,"P.S. 4 - STATEN ISLAND","200 NEDRA LANE"
1,1,0,"6ac130ae-6c0c-ed11-b091-088e901ef405","P.S. X012 Lewis and Clark School - X012 - X045 - 75X012 - 2502 LORILLARD PLACE","2203cefa-32f4-ea11-b882-24ee9a37d45c",-73887026,40858389,"I.S. 45 - BRONX","2502 LORILLARD PLACE"
7,6,1,"f6f57030-30f4-ea11-b882-24ee9a37d45c","P.S. 015 Patrick F. Daly - K015 - K015 - 15K015 - 71 SULLIVAN STREET","f5f57030-30f4-ea11-b882-24ee9a37d45c",-74011864,40677085,"P.S. 15 - BROOKLYN","71 SULLIVAN STREET"
2,0,2,"210410ca-32f4-ea11-b882-24ee9a37d45c","P.S. 046 Albert V. Maniscalco - R046 - R046 - 31R046 - 41 REID AVENUE","220410ca-32f4-ea11-b882-24ee9a37d45c",-74080829,40594455,"P.S. 46 - STATEN ISLAND","41 REID AVENUE"
1,1,0,"5907e99e-31f4-ea11-b882-24ee9a37d45c","High School for Health Professions and Human Services - M420 - M475 - 02M420 - 345 East 15th Street","5607e99e-31f4-ea11-b882-24ee9a37d45c",-73982590,40732665,"HEALTH PROFESSIONS HS (OL STY) - M","345 East 15th Street"
2,2,0,"9d886843-31f4-ea11-b882-24ee9a37d45c","P.S. 011: The Sarah J. Garnet Elementary School - M011 - M011 - 02M011 - 320 WEST 21 STREET","9e886843-31f4-ea11-b882-24ee9a37d45c",-74000743,40744186,"P.S. 11 - MANHATTAN","320 WEST 21 STREET"
4,3,1,"5ca5db98-30f4-ea11-b882-24ee9a37d45c","P.S. 236 Mill Basin - K236 - K236 - 22K236 - 6302 AVENUE U","5ba5db98-30f4-ea11-b882-24ee9a37d45c",-73912005,40615494,"P.S. 236 - BROOKLYN","6302 AVENUE U"
3,1,2,"c70d3c5b-30f4-ea11-b882-24ee9a37d45c","Success Academy Charter School - Bensonhurst - K772 - K096 - 84K772 - 99 AVENUE P","c10d3c5b-30f4-ea11-b882-24ee9a37d45c",-73984985,40608135,"I.S. 96 - BROOKLYN","99 AVENUE P"
1,1,0,"d38521d0-32f4-ea11-b882-24ee9a37d45c","The Kathleen Grimm School for Leadership and Sustainability - R062 - R062 - 31R062 - 644 Bloomingdale Road","d48521d0-32f4-ea11-b882-24ee9a37d45c",-74217934,40541563,"K.GRIMM SCL FOR LDRSHP&SUSTAINABLTY@SANDY GR -S.I.","644 Bloomingdale Road"
2,2,0,"22d8cf12-31f4-ea11-b882-24ee9a37d45c","Success Academy Charter School - Bergen Beach - K781 - K864 - 84K781 - 3109 NEWKIRK AVENUE","23d8cf12-31f4-ea11-b882-24ee9a37d45c",-73947025,40640551,"P.S. 361 (OLD 89) - BROOKLYN","3109 NEWKIRK AVENUE"
2,2,0,"26a198c3-30f4-ea11-b882-24ee9a37d45c","M.S. 890 - K890 - K338 - 22K890 - 21 HINCKLEY PLACE","27a198c3-30f4-ea11-b882-24ee9a37d45c",-73971010,40644861,"P.S. 338 - Brooklyn","21 HINCKLEY PLACE"
1,1,0,"47a10a44-32f4-ea11-b882-24ee9a37d45c","P.S./I.S. 295 - Q295 - Q263 - 29Q295 - 222-14 JAMAICA AVENUE","41a10a44-32f4-ea11-b882-24ee9a37d45c",-73731398,40720617,"P.S. /I.S 295 - QUEENS","222-14 JAMAICA AVENUE"
1,0,1,"cfc88e4f-31f4-ea11-b882-24ee9a37d45c","47 The American Sign Language and English Secondary School - M047 - M047 - 02M047 - 223 EAST 23 STREET","d0c88e4f-31f4-ea11-b882-24ee9a37d45c",-73981329,40738374,"J.H.S. 47 (SCH FOR THE DEAF) - M","223 EAST 23 STREET"
1,0,1,"7f593c87-33f4-ea11-b882-24ee9a37d45c","P.S. X811 - X811 - X839 - 75X811 - 2040 ANTIN PL","80593c87-33f4-ea11-b882-24ee9a37d45c",-73864438,40851577,"BRONX HIGH SCHOOL FOR THE VISUAL ARTS","2040 ANTIN PL"
1,0,1,"c78da2a3-4afb-ea11-b883-24ee9a37d459","SAINT SIMON STOCK ELEMENTARY SCHOOL - XAEN - XAEN -  - 2195 VALENTINE AVENUE","c88da2a3-4afb-ea11-b883-24ee9a37d459",-73899181,40855213,"SAINT SIMON STOCK SCHOOL","2195 VALENTINE AVENUE"
5,0,5,"00d1de79-30f4-ea11-b882-24ee9a37d45c","Brooklyn Gardens Elementary School - K557 - K174 - 19K557 - 574 DUMONT AVENUE","fbd0de79-30f4-ea11-b882-24ee9a37d45c",-73897604,40665446,"P.S. 174 - BROOKLYN","574 DUMONT AVENUE"
1,0,1,"da1f145d-51e6-eb11-b8b1-24ee9a37d45c","Success Academy Charter School - Rosedale - Q337 - Q390 - 84Q337 - 109-55 128 Street","db1f145d-51e6-eb11-b8b1-24ee9a37d45c",-73813926,40683802,"SAINT TERESA OF AVILA SCHOOL - QUEENS","109-55 128 Street"
1,0,1,"3ce61462-31f4-ea11-b882-24ee9a37d45c","Success Academy Charter School - Harlem 3 - M385 - M099 - 84M385 - 410 EAST 100 STREET","3de61462-31f4-ea11-b882-24ee9a37d45c",-73942154,40785107,"I.S. 99 - MANHATTAN","410 EAST 100 STREET"
1,0,1,"75b50aa5-30f4-ea11-b882-24ee9a37d45c","P.S. K231 - K231 - K264 - 75K231 - 371 89th Street","74b50aa5-30f4-ea11-b882-24ee9a37d45c",-74029444,40621025,"PS 264 BAY RIDGE ELEM SCL FOR THE ARTS - BROOKLYN","371 89th Street"
1,0,1,"92283fb1-30f4-ea11-b882-24ee9a37d45c","Success Academy Charter School - Cobble Hill - K129 - K293 - 84K129 - 284 Baltic Street","91283fb1-30f4-ea11-b882-24ee9a37d45c",-73993293,40685006,"J.H.S. 293 - BROOKLYN","284 Baltic Street"
1,1,0,"6507e99e-31f4-ea11-b882-24ee9a37d45c","Manhattan International High School - M459 - M480 - 02M459 - 317 EAST 67 STREET","6007e99e-31f4-ea11-b882-24ee9a37d45c",-73959777,40765638,"JULIA RICHMAN ED. COMPLEX - M","317 EAST 67 STREET"
2,0,2,"686e70b7-31f4-ea11-b882-24ee9a37d45c","West End Secondary School - M291 - M837 - 03M291 - 227-243 West 61st Street","696e70b7-31f4-ea11-b882-24ee9a37d45c",-73988338,40772608,"BEACON HS - MANHATTAN","227-243 West 61st Street"
2,1,1,"6934aa92-31f4-ea11-b882-24ee9a37d45c","Success Academy Charter School - Washington Heights - M265 - M387 - 84M265 - 701 Fort Washington Avenue","6a34aa92-31f4-ea11-b882-24ee9a37d45c",-73935231,40857650,"Success Academy - Washington Heights","701 Fort Washington Avenue"
1,1,0,"40953aac-ebf6-ea11-b883-24ee9a37d459","The Riverview School - Q277 - Q322 - 75Q277 - 89-11 43rd Avenue","ec454b50-32f4-ea11-b882-24ee9a37d45c",-73876706,40742891,"PS 14 Annex","89-11 43rd Avenue"
3,2,1,"57042f6f-ebf6-ea11-b883-24ee9a37d459","Success Academy Charter School - Harlem 1 - M351 - M620 - 84M351 - 111 EAST 33RD STREET","a0d810ab-31f4-ea11-b882-24ee9a37d45c",-73981070,40746510,"NORMAN THOMAS HS (ECF) - MANHATTAN","111 EAST 33RD STREET"
2,1,1,"00cf496e-31f4-ea11-b882-24ee9a37d45c","P.S. 129 John H. Finley - M129 - M129 - 05M129 - 425 WEST 130 STREET","fece496e-31f4-ea11-b882-24ee9a37d45c",-73952020,40814914,"P.S. 129 - MANHATTAN","425 WEST 130 STREET"
3,1,2,"b9edf392-32f4-ea11-b882-24ee9a37d45c","P.S. 099 Kew Gardens - Q099 - Q866 - 28Q099 - 83-34 Kew Gardens Road","baedf392-32f4-ea11-b882-24ee9a37d45c",-73827276,40709492,"P.S. 99 ANNEX - QUEENS","83-34 Kew Gardens Road"
1,1,0,"da201dab-30f4-ea11-b882-24ee9a37d45c","Metropolitan Diploma Plus High School - K647 - K275 - 23K647 - 985 ROCKAWAY AVENUE","d2201dab-30f4-ea11-b882-24ee9a37d45c",-73906662,40655644,"I.S. 275 - BROOKLYN","985 ROCKAWAY AVENUE"
1,1,0,"cee8ce00-32f4-ea11-b882-24ee9a37d45c","J.H.S. 074 Nathaniel Hawthorne - Q074 - Q074 - 26Q074 - 61-15 Oceania Street","cfe8ce00-32f4-ea11-b882-24ee9a37d45c",-73766653,40744743,"I.S. 74 - QUEENS","61-15 Oceania Street"
2,2,0,"d6ed94c3-31f4-ea11-b882-24ee9a37d45c","Repertory Company High School for Theatre Arts - M531 - M896 - 02M531 - 123 WEST 43 STREET","d7ed94c3-31f4-ea11-b882-24ee9a37d45c",-73984381,40756089,"NYC PUBLIC SCHOOL REPERTORY CO - M","123 WEST 43 STREET"
1,1,0,"38005d7a-31f4-ea11-b882-24ee9a37d45c","J.H.S. 167 Robert F. Wagner - M167 - M167 - 02M167 - 220 EAST 76 STREET","39005d7a-31f4-ea11-b882-24ee9a37d45c",-73957827,40771541,"I.S. 167 - MANHATTAN","220 EAST 76 STREET"
1,1,0,"1c005d7a-31f4-ea11-b882-24ee9a37d45c","Yorkville East Middle School - M177 - M158 - 02M177 - 1458 YORK AVENUE","1d005d7a-31f4-ea11-b882-24ee9a37d45c",-73950745,40770215,"P.S. 158 - MANHATTAN","1458 YORK AVENUE"
3,3,0,"cd689025-33f4-ea11-b882-24ee9a37d45c","Success Academy Charter School - Bronx 4 - X464 - X131 - 84X464 - 885 Bolton Avenue","c8689025-33f4-ea11-b882-24ee9a37d45c",-73859998,40822925,"I.S. 131 - BRONX","885 Bolton Avenue"
4,2,2,"7ea5db98-30f4-ea11-b882-24ee9a37d45c","Brooklyn Science and Engineering Academy - K763 - K244 - 18K763 - 5404 TILDEN AVENUE","7fa5db98-30f4-ea11-b882-24ee9a37d45c",-73925592,40647851,"P.S. 244 - BROOKLYN","5404 TILDEN AVENUE"
2,0,2,"367eed06-32f4-ea11-b882-24ee9a37d45c","P.S. 099 Kew Gardens - Q099 - Q099 - 28Q099 - 82-37 KEW GARDENS ROAD","377eed06-32f4-ea11-b882-24ee9a37d45c",-73827722,40711502,"P.S. 99 - QUEENS","82-37 KEW GARDENS ROAD"
1,1,0,"48627cc7-f81e-eb11-b885-24ee9a37d45c","D25 REC @ 123-07 22ND AVENUE - QC05 - Q454 -  - 123-07 22nd Avenue","8a476368-32f4-ea11-b882-24ee9a37d45c",-73844811,40780363,"PRE-K CENTER @22ND AVENUE - QUEENS","123-07 22nd Avenue"
2,1,1,"49ebaa73-30f4-ea11-b882-24ee9a37d45c","The East New York Arts and Civics High School - K953 - K166 - 19K953 - 800 VAN SICLEN AVE","41ebaa73-30f4-ea11-b882-24ee9a37d45c",-73885704,40659934,"I.S. 166 - BROOKLYN","800 VAN SICLEN AVE"
2,0,2,"88a6bd0b-e8fe-eb11-b8b2-24ee9a37d45c","ALMOND TREE GROUP FAMILY DAYCARE, LLC - - KDYV - KDSV -  - 211 Ocean Avenue","89a6bd0b-e8fe-eb11-b8b2-24ee9a37d45c",-73961984,40655560,"211 OCEAN AVENUE","211 Ocean Avenue"
2,1,1,"8a41e65b-31f4-ea11-b882-24ee9a37d45c","P.S. 084 Lillian Weber - M084 - M084 - 03M084 - 32 West 92 Street","8b41e65b-31f4-ea11-b882-24ee9a37d45c",-73968419,40789479,"P.S. 84 - MANHATTAN","32 West 92 Street"
1,1,0,"1de85c61-30f4-ea11-b882-24ee9a37d45c","Achievement First East New York Charter School - K358 - K111 - 84K358 - 35 STARR STREET","18e85c61-30f4-ea11-b882-24ee9a37d45c",-73927938,40700810,"I.S. 111 - BROOKLYN","35 STARR STREET"
5,1,4,"eef22ce2-31f4-ea11-b882-24ee9a37d45c","P.S. 007 Louis F. Simeone - Q007 - Q007 - 24Q007 - 80-55 CORNISH AVENUE","ecf22ce2-31f4-ea11-b882-24ee9a37d45c",-73882446,40739644,"P.S. 7 - QUEENS","80-55 CORNISH AVENUE"
3,2,1,"c98442ee-31f4-ea11-b882-24ee9a37d45c","P.S. 032 State Street - Q032 - Q032 - 25Q032 - 171-11 35 AVENUE","ca8442ee-31f4-ea11-b882-24ee9a37d45c",-73794323,40765459,"P.S. 32 - QUEENS","171-11 35 AVENUE"
1,0,1,"16af1f69-ebf6-ea11-b883-24ee9a37d459","Teachers College Community School - M517 - M484 - 05M517 - 223-233 WEST 132 STREET","6f07e99e-31f4-ea11-b882-24ee9a37d45c",-73946027,40814020,"Teacher’s College Community School Annex – Manhatt","223-233 WEST 132 STREET"
1,0,1,"ca85f462-ebf6-ea11-b883-24ee9a37d459","P.S. M811 - Mickey Mantle School - M811 - M149 - 75M811 - 34 West 118 Street","539f4974-31f4-ea11-b882-24ee9a37d45c",-73948088,40802649,"P.S. 149 (TANDEM M207) - MANHATTAN","34 West 118 Street"
2,1,1,"397eed06-32f4-ea11-b882-24ee9a37d45c","P.S. 100 Glen Morris - Q100 - Q100 - 27Q100 - 111-11 118 Street","267eed06-32f4-ea11-b882-24ee9a37d45c",-73821545,40679694,"P.S. 100 - QUEENS","111-11 118 Street"
1,0,1,"2b474313-33f4-ea11-b882-24ee9a37d45c","The Vida Bogart School for All Children - X352 - X092 - 75X352 - 700 EAST 179 STREET","27474313-33f4-ea11-b882-24ee9a37d45c",-73889602,40846205,"P.S. 92 - BRONX","700 EAST 179 STREET"
3,3,0,"72e2635c-32f4-ea11-b882-24ee9a37d45c","District 25 PRE-K Center - Q409 - Q409 - 25Q409 - 14-45 143rd Street","73e2635c-32f4-ea11-b882-24ee9a37d45c",-73826154,40785787,"DDC UPK CENTER @143RD STREET - QUEENS","14-45 143rd Street"
3,2,1,"1e06003e-32f4-ea11-b882-24ee9a37d45c","East-West School of International Studies - Q281 - Q237 - 25Q281 - 46-21 COLDEN STREET","1b06003e-32f4-ea11-b882-24ee9a37d45c",-73821402,40749430,"J.H.S. 237 - QUEENS","46-21 COLDEN STREET"
1,1,0,"daab074a-33f4-ea11-b882-24ee9a37d45c","P.S./I.S. 218 Rafael Hernandez Dual Language Magnet School - X218 - X235 - 09X218 - 1220 GERARD AVENUE","d8ab074a-33f4-ea11-b882-24ee9a37d45c",-73919571,40835681,"P.S./I.S. 218 - BRONX","1220 GERARD AVENUE"
1,1,0,"52767649-31f4-ea11-b882-24ee9a37d45c","P.S. 041 Greenwich Village - M041 - M041 - 02M041 - 116 WEST 11 STREET","53767649-31f4-ea11-b882-24ee9a37d45c",-73999094,40735450,"P.S. 41 - MANHATTAN","116 WEST 11 STREET"
1,1,0,"c82ff20c-32f4-ea11-b882-24ee9a37d45c","P.S./M.S. 114 Belle Harbor - Q114 - Q114 - 27Q114 - 134-01 CRONSTON AVENUE","c12ff20c-32f4-ea11-b882-24ee9a37d45c",-73854364,40577552,"P.S. 114 - QUEENS","134-01 CRONSTON AVENUE"
2,2,0,"8c886843-31f4-ea11-b882-24ee9a37d45c","P.S. 006 Lillie D. Blake - M006 - M006 - 02M006 - 45 EAST 81 STREET","8d886843-31f4-ea11-b882-24ee9a37d45c",-73960427,40777737,"P.S. 6 - MANHATTAN","45 EAST 81 STREET"
11,9,2,"90bc9674-32f4-ea11-b882-24ee9a37d45c","Hillcrest High School - Q505 - Q505 - 28Q505 - 160-05 HIGHLAND AVENUE","8fbc9674-32f4-ea11-b882-24ee9a37d45c",-73803001,40709461,"HILLCREST HS - Q","160-05 HIGHLAND AVENUE"
1,1,0,"ac2aa42b-33f4-ea11-b882-24ee9a37d45c","The New School for Leadership and Journalism - X244 - X143 - 10X244 - 120 WEST 231 STREET","ad2aa42b-33f4-ea11-b882-24ee9a37d45c",-73901565,40875636,"I.S. 143 - BRONX","120 WEST 231 STREET"
2,1,1,"b5bfa431-33f4-ea11-b882-24ee9a37d45c","Kappa - X215 - X148 - 09X215 - 3630 THIRD AVENUE","b0bfa431-33f4-ea11-b882-24ee9a37d45c",-73903951,40833493,"I.S. 219 (OLD 148) - BRONX","3630 THIRD AVENUE"
1,0,1,"d0ba3c50-33f4-ea11-b882-24ee9a37d45c","Young Voices Academy of the Bronx - X357 - X292 - 11X357 - 800 LYDIG AVENUE","d1ba3c50-33f4-ea11-b882-24ee9a37d45c",-73863733,40854423,"THE DOMINIC CASTORE EDUCATIONAL CAMPUS - BRONX","800 LYDIG AVENUE"
3,3,0,"4a9d7c62-33f4-ea11-b882-24ee9a37d45c","Bronxdale High School - X508 - X415 - 11X508 - 925 ASTOR AVENUE","439d7c62-33f4-ea11-b882-24ee9a37d45c",-73860729,40860443,"CHRISTOPHER COLUMBUS HS - X","925 ASTOR AVENUE"
2,0,2,"a2d810ab-31f4-ea11-b882-24ee9a37d45c","Manhattan Academy For Arts & Language - M427 - M620 - 02M427 - 111 EAST 33RD STREET","a0d810ab-31f4-ea11-b882-24ee9a37d45c",-73981070,40746510,"NORMAN THOMAS HS (ECF) - MANHATTAN","111 EAST 33RD STREET"
2,2,0,"176e3d68-31f4-ea11-b882-24ee9a37d45c","KIPP NYC Washington Heights Academy Charter School - M068 - M115 - 84M068 - 586 WEST 177 STREET","166e3d68-31f4-ea11-b882-24ee9a37d45c",-73935140,40846116,"P.S. 115 - MANHATTAN","586 WEST 177 STREET"
1,1,0,"d82ff20c-32f4-ea11-b882-24ee9a37d45c","P.S./I.S. 119 The Glendale - Q119 - Q119 - 24Q119 - 74-01 78 AVENUE","d92ff20c-32f4-ea11-b882-24ee9a37d45c",-73875073,40705187,"I.S. 119 - QUEENS","74-01 78 AVENUE"
1,0,1,"c556635c-33f4-ea11-b882-24ee9a37d45c","Herbert H. Lehman High School - X405 - X406 - 08X405 - 3000 East Tremont Avenue","c656635c-33f4-ea11-b882-24ee9a37d45c",-73839583,40839775,"LEHMAN AF - BRONX","3000 East Tremont Avenue"
5,5,0,"b669c231-32f4-ea11-b882-24ee9a37d45c","P.S. 209 Clearview Gardens - Q209 - Q209 - 25Q209 - 16-10 Utopia Parkway","b569c231-32f4-ea11-b882-24ee9a37d45c",-73795845,40783777,"P.S. 209 - QUEENS","16-10 Utopia Parkway"
1,1,0,"acdab801-ecf6-ea11-b883-24ee9a37d459","Rose Hill Pre-K Center - X535 - X443 - 10X535 - 3605 SEDGWICK AVENUE","5effcc6e-33f4-ea11-b882-24ee9a37d45c",-73896483,40881542,"PRE-K CENTER @SEDGWICK AVENUE - BRONX","3605 SEDGWICK AVENUE"
2,2,0,"ef201dab-30f4-ea11-b882-24ee9a37d45c","M.S. 442 Carroll Gardens School for Innovation - K442 - K280 - 15K442 - 500 19 STREET","ed201dab-30f4-ea11-b882-24ee9a37d45c",-73983116,40656952,"PRE-K CENTER @ 500 19TH STREET - BROOKLYN","500 19 STREET"
6,4,2,"7deb0e7b-33f4-ea11-b882-24ee9a37d45c","P.S./M.S. 11X498 - Van Nest Academy - X498 - X498 - 11X498 - 1640 BRONXDALE AVE","7eeb0e7b-33f4-ea11-b882-24ee9a37d45c",-73857989,40845023,"THE LT. CURTIS MEYRAN AND JOHN BELLEW ED COMPLEX","1640 BRONXDALE AVE"
1,0,1,"d1b36d80-30f4-ea11-b882-24ee9a37d45c","P.S. 186 Dr. Irving A Gladstone - K186 - K186 - 20K186 - 7601 19 AVENUE","d2b36d80-30f4-ea11-b882-24ee9a37d45c",-73994258,40610917,"P.S. 186 - BROOKLYN","7601 19 AVENUE"
2,1,1,"240b210d-33f4-ea11-b882-24ee9a37d45c","P.S. 076 The Bennington School - X076 - X076 - 11X076 - 900 ADEE AVENUE","250b210d-33f4-ea11-b882-24ee9a37d45c",-73860928,40869059,"P.S. 76 - BRONX","900 ADEE AVENUE"
1,1,0,"1ee2abc9-30f4-ea11-b882-24ee9a37d45c","J.H.S. 383 Philippa Schuyler - K383 - K383 - 32K383 - 1300 GREENE AVENUE","1de2abc9-30f4-ea11-b882-24ee9a37d45c",-73919088,40697898,"I.S. 383 - BROOKLYN","1300 GREENE AVENUE"
1,1,0,"9748b1f5-eaf6-ea11-b883-24ee9a37d459","P.S. 372 -The Children's School - K372 - K834 - 75K372 - 512 CARROLL STREET","fcd7cf12-31f4-ea11-b882-24ee9a37d45c",-73985500,40676198,"P.S. 372 (OUR LADY OF PEACE)-K","512 CARROLL STREET"
3,3,0,"538dbfcf-30f4-ea11-b882-24ee9a37d45c","Abraham Lincoln High School - K410 - K410 - 21K410 - 2800 OCEAN PARKWAY","518dbfcf-30f4-ea11-b882-24ee9a37d45c",-73968733,40582627,"ABRAHAM LINCOLN HS - K","2800 OCEAN PARKWAY"
1,0,1,"69c130ae-6c0c-ed11-b091-088e901ef405","P.S. X010 - X010 - X104 - 75X010 - 1449 SHAKESPEARE AVENUE","360d6d19-33f4-ea11-b882-24ee9a37d45c",-73920826,40843453,"P.S. 199 - BRONX","1449 SHAKESPEARE AVENUE"
1,1,0,"ec09e2e1-30f4-ea11-b882-24ee9a37d45c","East Williamsburg Scholars Academy - K477 - K450 - 14K477 - 850 GRAND STREET","e909e2e1-30f4-ea11-b882-24ee9a37d45c",-73938921,40711134,"GRAND STREET CAMPUS (OLD E.D.HS)- K","850 GRAND STREET"
1,1,0,"29a198c3-30f4-ea11-b882-24ee9a37d45c","P.S. 889 - K889 - K338 - 22K889 - 21 HINCKLEY PLACE","27a198c3-30f4-ea11-b882-24ee9a37d45c",-73971010,40644861,"P.S. 338 - Brooklyn","21 HINCKLEY PLACE"
3,3,0,"15a6ba98-31f4-ea11-b882-24ee9a37d45c","Gramercy Arts High School - M374 - M460 - 02M374 - 40 IRVING PLACE","16a6ba98-31f4-ea11-b882-24ee9a37d45c",-73987064,40735361,"WASHINGTON IRVING HS - MANHATTAN","40 IRVING PLACE"
4,4,0,"0baf0313-32f4-ea11-b882-24ee9a37d45c","P.S. 130 - Q130 - Q130 - 25Q130 - 200-01 42 AVENUE","04af0313-32f4-ea11-b882-24ee9a37d45c",-73784009,40760219,"P.S. 130 - QUEENS","200-01 42 AVENUE"
6,0,6,"652f77fa-31f4-ea11-b882-24ee9a37d45c","P. S. 62 - Chester Park School - Q062 - Q062 - 27Q062 - 97-25 108 STREET","642f77fa-31f4-ea11-b882-24ee9a37d45c",-73835567,40688359,"P.S. 62 - QUEENS","97-25 108 STREET"
2,1,1,"f9b6c337-32f4-ea11-b882-24ee9a37d45c","P.S. 213 The Carl Ullman School - Q213 - Q213 - 26Q213 - 231-02 67 AVENUE","f8b6c337-32f4-ea11-b882-24ee9a37d45c",-73745390,40747457,"P.S. 213 - QUEENS","231-02 67 AVENUE"
1,1,0,"78283fb1-30f4-ea11-b882-24ee9a37d45c","P.S. 288 The Shirley Tanyhill - K288 - K288 - 21K288 - 2950 WEST 25 STREET","79283fb1-30f4-ea11-b882-24ee9a37d45c",-73992393,40574029,"P.S. 288 - BROOKLYN","2950 WEST 25 STREET"
1,1,0,"9f476368-32f4-ea11-b882-24ee9a37d45c","Flushing High School - Q460 - Q460 - 25Q460 - 35-01 UNION STREET","97476368-32f4-ea11-b882-24ee9a37d45c",-73826811,40764892,"FLUSHING HS - Q","35-01 UNION STREET"
2,1,1,"c3e0838c-31f4-ea11-b882-24ee9a37d45c","P.S./I.S. 217 Roosevelt Island - M217 - M271 - 02M217 - 645 MAIN STREET","b8e0838c-31f4-ea11-b882-24ee9a37d45c",-73956435,40753598,"P.S./I.S. 217 - MANHATTAN","645 MAIN STREET"
2,0,2,"dfa2f813-ebf6-ea11-b883-24ee9a37d459","P.S. K369 - Coy L. Cox School - K369 - K067 - 75K369 - 51 SAINT EDWARDS STREET","d179df48-30f4-ea11-b882-24ee9a37d45c",-73977674,40695339,"P.S. 67 - BROOKLYN","51 SAINT EDWARDS STREET"
1,0,1,"0b04d718-31f4-ea11-b882-24ee9a37d45c","P.S. 274 Kosciusko - K274 - K876 - 32K274 - 800 BUSHWICK AVENUE","0c04d718-31f4-ea11-b882-24ee9a37d45c",-73928180,40694179,"P.S. 274 MINISCHOOL - BROOKLYN","800 BUSHWICK AVENUE"
1,1,0,"b20e93d5-49fb-ea11-b883-24ee9a37d459","Resurrection Ascension Catholic Academy - QAEN - QAEN -  - 85-25 61 ROAD","b30e93d5-49fb-ea11-b883-24ee9a37d459",-73872227,40728136,"RESURRECTION ASCENSION SCHOOL","85-25 61 ROAD"
1,1,0,"99d810ab-31f4-ea11-b882-24ee9a37d45c","Chelsea Career and Technical Education High School - M615 - M615 - 02M615 - 131 AVENUE OF THE AMERICAS","9ad810ab-31f4-ea11-b882-24ee9a37d45c",-74005058,40724630,"CHELSEA VOC HS - MANHATTAN","131 AVENUE OF THE AMERICAS"
1,1,0,"fc9b4c1f-32f4-ea11-b882-24ee9a37d45c","P.S. 161 Arthur Ashe School - Q161 - Q161 - 28Q161 - 101-33 124 STREET","fb9b4c1f-32f4-ea11-b882-24ee9a37d45c",-73821080,40690439,"P.S. 161 - QUEENS","101-33 124 STREET"
3,2,1,"c8edf392-32f4-ea11-b882-24ee9a37d45c","P.S. 007 Louis F. Simeone - Q007 - Q877 - 24Q007 - 76-05 51 AVENUE","c9edf392-32f4-ea11-b882-24ee9a37d45c",-73887011,40737222,"51ST AVENUE ACADEMY - QUEENS","76-05 51 AVENUE"
2,2,0,"1923f4ed-49fb-ea11-b883-24ee9a37d459","Sunny Skies Preschool at 720 Washington - KCLC - KCGM -  - 720 Washington Avenue","1a23f4ed-49fb-ea11-b883-24ee9a37d459",0,0,"Sunny Skies Preschool at 720 Washington","720 Washington Avenue"
1,1,0,"d8d10307-33f4-ea11-b882-24ee9a37d45c","Academic Leadership Charter School - X491 - X065 - 84X491 - 677 EAST 141 STREET","d9d10307-33f4-ea11-b882-24ee9a37d45c",-73912557,40807916,"P.S. 65 - BRONX","677 EAST 141 STREET"
1,0,1,"e39b4c1f-32f4-ea11-b882-24ee9a37d45c","P.S. 154 Queens - Q154 - Q154 - 25Q154 - 75-02 162 Street","d69b4c1f-32f4-ea11-b882-24ee9a37d45c",-73807750,40726473,"P.S. 154 - QUEENS","75-02 162 Street"
3,2,1,"8b476368-32f4-ea11-b882-24ee9a37d45c","Newtown High School - Q455 - Q455 - 24Q455 - 48-01 90 STREET","8c476368-32f4-ea11-b882-24ee9a37d45c",-73874129,40740824,"NEWTOWN HS - Q","48-01 90 STREET"
3,2,1,"1baf0313-32f4-ea11-b882-24ee9a37d45c","The Bellaire School - Q135 - Q135 - 29Q135 - 207-11 89 AVENUE","1caf0313-32f4-ea11-b882-24ee9a37d45c",-73757591,40720864,"P.S. 135 - QUEENS","207-11 89 AVENUE"
4,3,1,"f83159fa-30f4-ea11-b882-24ee9a37d45c","Transit Tech Career and Technical Education High School - K615 - K615 - 19K615 - 1 WELLS STREET","f93159fa-30f4-ea11-b882-24ee9a37d45c",-73875328,40678780,"E NY VOC HS OF TRANSIT TECH.-K","1 WELLS STREET"
2,2,0,"d917b7f4-32f4-ea11-b882-24ee9a37d45c","PS/MS 20 P.O.George J. Werdann, III - X020 - X020 - 10X020 - 3050 WEBSTER AVENUE","d817b7f4-32f4-ea11-b882-24ee9a37d45c",-73878731,40869482,"P.S. 20 - BRONX","3050 WEBSTER AVENUE"
1,0,1,"24e85c61-30f4-ea11-b882-24ee9a37d45c","M.S. 113 Ronald Edmonds Learning Center - K113 - K113 - 13K113 - 300 ADELPHI STREET","1fe85c61-30f4-ea11-b882-24ee9a37d45c",-73971474,40688769,"I.S. 113 - BROOKLYN","300 ADELPHI STREET"
3,0,3,"a932c3fb-eaf6-ea11-b883-24ee9a37d459","P.S. Q004 - Q004 - Q179 - 75Q004 - 196-25 Peck Avenue","9c0e6e25-32f4-ea11-b882-24ee9a37d45c",-73778118,40741700,"P.S. 179 - QUEENS","196-25 Peck Avenue"
3,2,1,"8128a20c-31f4-ea11-b882-24ee9a37d45c","Achievement First Endeavor Charter School - K508 - K784 - 84K508 - 510 WAVERLY AVENUE","8228a20c-31f4-ea11-b882-24ee9a37d45c",-73965928,40682422,"ACHIEVEMENT FIRST ENDEAVOR CHARTER SCHOOL - K","510 WAVERLY AVENUE"
2,0,2,"bc689025-33f4-ea11-b882-24ee9a37d45c","Linden Tree Elementary School - X567 - X127 - 11X567 - 1560 PURDY STREET","b9689025-33f4-ea11-b882-24ee9a37d45c",-73853203,40838759,"I.S. 127 - BRONX","1560 PURDY STREET"
1,1,0,"445bc58c-30f4-ea11-b882-24ee9a37d45c","P.S. 212 Lady Deborah Moody - K212 - K212 - 21K212 - 87 BAY 49 STREET","455bc58c-30f4-ea11-b882-24ee9a37d45c",-73985368,40587612,"P.S. 212 - BROOKLYN","87 BAY 49 STREET"
1,0,1,"d7fab455-31f4-ea11-b882-24ee9a37d45c","P.S. 064 Robert Simon - M064 - M064 - 01M064 - 600 EAST 6 STREET","d3fab455-31f4-ea11-b882-24ee9a37d45c",-73981597,40723130,"P.S. 64 (OLD 71) - MANHATTAN","600 EAST 6 STREET"
1,1,0,"7407e99e-31f4-ea11-b882-24ee9a37d45c","Jacqueline Kennedy Onassis High School - M529 - M486 - 02M529 - 120 WEST 46 STREET","7507e99e-31f4-ea11-b882-24ee9a37d45c",-73983460,40757626,"J. K. ONASSIS HS FOR INT CAREERS-M","120 WEST 46 STREET"
1,0,1,"e622f4ed-49fb-ea11-b883-24ee9a37d459","Strong Place for Hope Day Care Center/DBA Strong Place for Hope Day Care - KBFN - KBIY -  - 333 2 STREET","e722f4ed-49fb-ea11-b883-24ee9a37d459",-73983488,40673996,"ALONZO A. DAUGHTRY MEMORIAL DAY CARE CENTER SITE 2","333 2 STREET"
2,1,1,"43474313-33f4-ea11-b882-24ee9a37d45c","J.H.S. 098 Herman Ridder - X098 - X098 - 12X098 - 1619 BOSTON ROAD","3c474313-33f4-ea11-b882-24ee9a37d45c",-73890591,40836245,"I.S. 98 - BRONX","1619 BOSTON ROAD"
3,1,2,"cd8521d0-32f4-ea11-b882-24ee9a37d45c","I.S. 061 William A Morris - R061 - R061 - 31R061 - 445 CASTLETON AVENUE","460410ca-32f4-ea11-b882-24ee9a37d45c",-74097941,40634497,"I.S. 61 - STATEN ISLAND","445 CASTLETON AVENUE"
1,1,0,"320b210d-33f4-ea11-b882-24ee9a37d45c","School for Environmental Citizenship - X386 - X079 - 10X386 - 125 EAST 181 STREET","2c0b210d-33f4-ea11-b882-24ee9a37d45c",-73903139,40855337,"P.S. 79 - BRONX","125 EAST 181 STREET"
1,1,0,"30c15a75-ebf6-ea11-b883-24ee9a37d459","Adult and Continuing Education - K755 - M827 - 79K755 - 500 8 AVENUE","576e70b7-31f4-ea11-b882-24ee9a37d45c",-73992405,40753038,"AUX. SERV-MAN. LEARNING CENTER - M","500 8 AVENUE"
1,1,0,"817e21a6-ebf6-ea11-b883-24ee9a37d459","P.S. 009 - Q009 - Q268 - 75Q009 - 92-07 175 STREET","4ea10a44-32f4-ea11-b882-24ee9a37d45c",-73785210,40707648,"P.S. 268 - QUEENS","92-07 175 STREET"
3,3,0,"e59aeff9-49fb-ea11-b883-24ee9a37d459","UNIVERSITY SETTLEMENT EARLY CHILDHOOD CENTER - MAUB - MAUB -  - 184 ELDRIDGE STREET","e69aeff9-49fb-ea11-b883-24ee9a37d459",-73990519,40720543,"UNIVERSITY SETTLEMENT EARLY CHILDHOOD CENTER","184 ELDRIDGE STREET"
2,1,1,"339ebaee-32f4-ea11-b882-24ee9a37d45c","P.S. 016 Wakefield - X016 - X016 - 11X016 - 4550 CARPENTER AVENUE","349ebaee-32f4-ea11-b882-24ee9a37d45c",-73854231,40902311,"P.S. 16 - BRONX","4550 CARPENTER AVENUE"
1,1,0,"28474313-33f4-ea11-b882-24ee9a37d45c","P.S. 091 Bronx - X091 - X091 - 10X091 - 2200 AQUEDUCT AVENUE","29474313-33f4-ea11-b882-24ee9a37d45c",-73907494,40858286,"P.S. 91 - BRONX","2200 AQUEDUCT AVENUE"
3,3,0,"8d01ce37-33f4-ea11-b882-24ee9a37d45c","Dr. Richard Izquierdo Health and Science Charter School - X482 - X158 - 84X482 - 800 HOME STREET","8601ce37-33f4-ea11-b882-24ee9a37d45c",-73900593,40826933,"I.S. 158 - BRONX","800 HOME STREET"
1,1,0,"63fdc1bd-32f4-ea11-b882-24ee9a37d45c","P.S. 020 Port Richmond - R020 - R020 - 31R020 - 161 PARK AVENUE","64fdc1bd-32f4-ea11-b882-24ee9a37d45c",-74132382,40636729,"P.S. 20 - STATEN ISLAND","161 PARK AVENUE"
1,0,1,"0206003e-32f4-ea11-b882-24ee9a37d45c","The Ivan Lafayette Early Childhood School of the Arts - Q228 - Q228 - 30Q228 - 32-63 93 STREET","0306003e-32f4-ea11-b882-24ee9a37d45c",-73874947,40756931,"P.S. 228 (ECC) - QUEENS","32-63 93 STREET"
1,0,1,"3d3cbf01-ebf6-ea11-b883-24ee9a37d459","John F. Kennedy Jr. School - Q721 - Q722 - 75Q721 - 57-12 94 STREET","b172c880-32f4-ea11-b882-24ee9a37d45c",-73867882,40735613,"JOHN F. KENNEDY JR. SCHOOL - QUEENS","57-12 94 STREET"
2,1,1,"c7315367-30f4-ea11-b882-24ee9a37d45c","John Ericsson Middle School 126 - K126 - K126 - 14K126 - 424 LEONARD STREET","c3315367-30f4-ea11-b882-24ee9a37d45c",-73947932,40719818,"J.H.S. 126 - BROOKLYN","424 LEONARD STREET"
1,1,0,"8de04648-53e6-eb11-b8b1-24ee9a37d45c","Success Academy Charter School - Bronx 3 - X380 - M043 - 84X380 - 509 WEST 129 STREET","59767649-31f4-ea11-b882-24ee9a37d45c",-73955520,40815747,"I.S. 172 (OLD 43) - MANHATTAN","509 WEST 129 STREET"
1,0,1,"b332c3fb-eaf6-ea11-b883-24ee9a37d459","Mosaic Pre-K Center - Q331 - Q392 - 24Q331 - 68-20 Myrtle Avenue","a2eb6056-32f4-ea11-b882-24ee9a37d45c",-73883878,40701694,"PRE-K CENTER @ 68-20 MYRTLE AVENUE - QUEENS","68-20 Myrtle Avenue"
4,2,2,"a8d810ab-31f4-ea11-b882-24ee9a37d45c","Success Academy Charter School - Hell's Kitchen - M170 - M625 - 84M170 - 439 WEST 49TH STREET","a9d810ab-31f4-ea11-b882-24ee9a37d45c",-73990318,40763655,"HS OF GRAPHIC COMMUNICATION ARTS-M","439 WEST 49TH STREET"
1,0,1,"7c8d8486-31f4-ea11-b882-24ee9a37d45c","P.S. 197 John B. Russwurm - M197 - M197 - 05M197 - 2230 5 AVENUE","7b8d8486-31f4-ea11-b882-24ee9a37d45c",-73938347,40813532,"P.S. 197 - MANHATTAN","2230 5 AVENUE"
3,2,1,"16ba8b86-30f4-ea11-b882-24ee9a37d45c","P.S. 207 Elizabeth G. Leary - K207 - K207 - 22K207 - 4011 FILLMORE AVENUE","17ba8b86-30f4-ea11-b882-24ee9a37d45c",-73930485,40613981,"P.S. 207 - BROOKLYN","4011 FILLMORE AVENUE"
1,1,0,"0dbdc8e1-49fb-ea11-b883-24ee9a37d459","Saint Sebastian Catholic Academy - QAGP - QAGP -  - 39-76 58 STREET","0ebdc8e1-49fb-ea11-b883-24ee9a37d459",-73906669,40745982,"SAINT SEBASTIAN SCHOOL","39-76 58 STREET"
1,0,1,"e8d10307-33f4-ea11-b882-24ee9a37d45c","P.S. 068 Bronx - X068 - X068 - 11X068 - 4011 MONTICELLO AVENUE","e9d10307-33f4-ea11-b882-24ee9a37d45c",-73838880,40891603,"P.S. 68 - BRONX","4011 MONTICELLO AVENUE"
1,0,1,"0f497593-33f4-ea11-b882-24ee9a37d45c","P.S. 076 The Bennington School - X076 - X926 - 11X076 - 900 ADEE AVENUE","10497593-33f4-ea11-b882-24ee9a37d45c",-73860928,40869059,"P.S. 76 TEMP. C.R. BLDG. - X","900 ADEE AVENUE"
2,1,1,"dff57030-30f4-ea11-b882-24ee9a37d45c","P.S. 011 Purvis J. Behan - K011 - K011 - 13K011 - 419 WAVERLY AVENUE","e0f57030-30f4-ea11-b882-24ee9a37d45c",-73965890,40685896,"P.S. 11 - BROOKLYN","419 WAVERLY AVENUE"
1,1,0,"8783ff9e-30f4-ea11-b882-24ee9a37d45c","Success Academy Charter School - Crown Heights - K741 - K246 - 84K741 - 72 VERONICA PLACE","8483ff9e-30f4-ea11-b882-24ee9a37d45c",-73953480,40648352,"I.S. 246 - BROOKLYN","72 VERONICA PLACE"
1,0,1,"58e61462-31f4-ea11-b882-24ee9a37d45c","P.S. 102 Jacques Cartier - M102 - M102 - 04M102 - 315 EAST 113 STREET","56e61462-31f4-ea11-b882-24ee9a37d45c",-73938418,40795000,"P.S. 102 - MANHATTAN","315 EAST 113 STREET"
1,1,0,"47474313-33f4-ea11-b882-24ee9a37d45c","Bronx Envision Academy - X511 - X098 - 12X511 - 1619 BOSTON ROAD","3c474313-33f4-ea11-b882-24ee9a37d45c",-73890591,40836245,"I.S. 98 - BRONX","1619 BOSTON ROAD"
2,2,0,"141bad3c-30f4-ea11-b882-24ee9a37d45c","I.S. 98 Bay Academy - K098 - K043 - 21K098 - 1401 EMMONS AVENUE","151bad3c-30f4-ea11-b882-24ee9a37d45c",-73954047,40583893,"I.S. 98 - BROOKLYN","1401 EMMONS AVENUE"
3,3,0,"790e6e25-32f4-ea11-b882-24ee9a37d45c","P.S. 166 Henry Gradstein - Q166 - Q166 - 30Q166 - 33-09 35 AVENUE","7a0e6e25-32f4-ea11-b882-24ee9a37d45c",-73926249,40757497,"P.S. 166 - QUEENS","33-09 35 AVENUE"
1,0,1,"9a2aa42b-33f4-ea11-b882-24ee9a37d45c","International Community High School - X334 - X139 - 07X334 - 345 BROOK AVENUE","942aa42b-33f4-ea11-b882-24ee9a37d45c",-73918774,40810314,"J.H.S. 222 - BRONX","345 BROOK AVENUE"
3,3,0,"8653dd74-33f4-ea11-b882-24ee9a37d45c","Harry S Truman High School - X455 - X455 - 11X455 - 750 BAYCHESTER AVENUE","8253dd74-33f4-ea11-b882-24ee9a37d45c",-73831669,40874035,"HARRY S. TRUMAN HS - X","750 BAYCHESTER AVENUE"
1,0,1,"e18fd20d-ebf6-ea11-b883-24ee9a37d459","The Joan Snow Pre-K Center - K853 - K042 - 22K853 - 3610 GLENWOOD ROAD","121bad3c-30f4-ea11-b882-24ee9a37d45c",-73941795,40634360,"PRE-K CENTER @3610 GLENWOOD ROAD - BROOKLYN","3610 GLENWOOD ROAD"
4,4,0,"24b4977a-32f4-ea11-b882-24ee9a37d45c","Middle College High School at LaGuardia Community College - Q520 - Q520 - 24Q520 - 45-35 VAN DAM STREET","22b4977a-32f4-ea11-b882-24ee9a37d45c",-73933316,40743253,"MIDDLE COLLEGE CAMPUS - QUEENS","45-35 VAN DAM STREET"
1,1,0,"e880b5c9-df1e-eb11-b885-24ee9a37d45c","MS 936 Arts Off 3rd - K936 - K746 - 20K936 - 270 59th Street","e980b5c9-df1e-eb11-b885-24ee9a37d45c",-74020748,40642914,"P.S. @ 270 59TH STREET- BROOKLYN","270 59th Street"
3,3,0,"920e6e25-32f4-ea11-b882-24ee9a37d45c","P.S. 174 William Sidney Mount - Q174 - Q174 - 28Q174 - 65-10 DIETERLE CRESCENT","930e6e25-32f4-ea11-b882-24ee9a37d45c",-73861462,40720583,"P.S. 174 - QUEENS","65-10 DIETERLE CRESCENT"
1,0,1,"1430f69f-ebf6-ea11-b883-24ee9a37d459","P.S. Q224 - Q224 - Q205 - 75Q224 - 75-25 BELL BOULEVARD","a769c231-32f4-ea11-b882-24ee9a37d45c",-73756374,40738008,"P.S. 205 - QUEENS","75-25 BELL BOULEVARD"
5,2,3,"db2ff20c-32f4-ea11-b882-24ee9a37d45c","P.S. 120 Queens - Q120 - Q120 - 25Q120 - 58-01 136 STREET","dc2ff20c-32f4-ea11-b882-24ee9a37d45c",-73828674,40745215,"P.S. 120 - QUEENS","58-01 136 STREET"
1,0,1,"e94356d0-48fb-ea11-b883-24ee9a37d459","Woodmere Day Care Center Inc - KCOH - KCOH -  - 927 McDonald Avenue","ea4356d0-48fb-ea11-b883-24ee9a37d459",-73977301,40631520,"Sweet Home Day Care Center","927 McDonald Avenue"
3,1,2,"d8e8ce00-32f4-ea11-b882-24ee9a37d45c","P.S. 079 Francis Lewis - Q079 - Q079 - 25Q079 - 147-27 15 DRIVE","d7e8ce00-32f4-ea11-b882-24ee9a37d45c",-73817338,40786201,"P.S. 79 - QUEENS","147-27 15 DRIVE"
3,1,2,"10ba8b86-30f4-ea11-b882-24ee9a37d45c","P.S. 205 Clarion - K205 - K205 - 20K205 - 6701 20 AVENUE","11ba8b86-30f4-ea11-b882-24ee9a37d45c",-73986792,40614737,"P.S. 205 - BROOKLYN","6701 20 AVENUE"
3,1,2,"d4e8ce00-32f4-ea11-b882-24ee9a37d45c","P.S. 076 William Hallet - Q076 - Q076 - 30Q076 - 36-36 10 Street","d2e8ce00-32f4-ea11-b882-24ee9a37d45c",-73941630,40760862,"P.S. 76 - QUEENS","36-36 10 Street"
1,1,0,"380d6d19-33f4-ea11-b882-24ee9a37d45c","P.S. 105 Sen Abraham Bernstein - X105 - X105 - 11X105 - 725 Brady Avenue","390d6d19-33f4-ea11-b882-24ee9a37d45c",-73866264,40853075,"P.S. 105 - BRONX","725 Brady Avenue"
1,1,0,"0f68ee1e-31f4-ea11-b882-24ee9a37d45c","P.S. 230 Doris L. Cohen - K230 - K908 - 15K230 - 425 Mcdonald Avenue","1068ee1e-31f4-ea11-b882-24ee9a37d45c",-73979161,40643512,"P.S. 230 ANNEX - BROOKLYN","425 Mcdonald Avenue"
2,1,1,"e60d3c5b-30f4-ea11-b882-24ee9a37d45c","P.S. 107 John W. Kimball - K107 - K107 - 15K107 - 1301 8 AVENUE","e70d3c5b-30f4-ea11-b882-24ee9a37d45c",-73981181,40662945,"P.S. 107 - BROOKLYN","1301 8 AVENUE"
3,2,1,"d211f898-32f4-ea11-b882-24ee9a37d45c","P.S. 65 - The Raymond York Elementary School - Q065 - Q884 - 27Q065 - 103-22 99 STREET","d111f898-32f4-ea11-b882-24ee9a37d45c",-73841675,40682293,"P.S. 65 - QUEENS","103-22 99 STREET"
4,3,1,"7d53dd74-33f4-ea11-b882-24ee9a37d45c","Bronx Compass High School - X561 - X450 - 08X561 - 1980 LAFAYETTE AVENUE","62ffcc6e-33f4-ea11-b882-24ee9a37d45c",-73855930,40821218,"Adlai E. Stevenson Educational Campus","1980 LAFAYETTE AVENUE"
2,1,1,"f721d292-30f4-ea11-b882-24ee9a37d45c","P.S. 230 Doris L. Cohen - K230 - K230 - 15K230 - 1 ALBEMARLE ROAD","f321d292-30f4-ea11-b882-24ee9a37d45c",-73980515,40645609,"P.S. 230 - BROOKLYN","1 ALBEMARLE ROAD"
1,1,0,"28ebaa73-30f4-ea11-b882-24ee9a37d45c","P.S. 158 Warwick - K158 - K158 - 19K158 - 400 ASHFORD STREET","29ebaa73-30f4-ea11-b882-24ee9a37d45c",-73885214,40672590,"P.S. 158 - BROOKLYN","400 ASHFORD STREET"
1,1,0,"ffae0313-32f4-ea11-b882-24ee9a37d45c","Albert Shanker School for Visual and Performing Arts - Q126 - Q126 - 30Q126 - 31-51 21 STREET","f5ae0313-32f4-ea11-b882-24ee9a37d45c",-73929990,40766008,"I.S. 126 - QUEENS","31-51 21 STREET"
1,0,1,"69e9a5af-4afb-ea11-b883-24ee9a37d459","YMCA OF GREATER NEW YORK - FLUSHING - QAJR - QAJR -  - 138-46 Northern Boulevard","6ae9a5af-4afb-ea11-b883-24ee9a37d459",-73827142,40764119,"Flushing YMCA UPK","138-46 Northern Boulevard"
1,1,0,"c0fc24e8-31f4-ea11-b882-24ee9a37d45c","I.S. 025 Adrien Block - Q025 - Q025 - 25Q025 - 34-65 192 STREET","befc24e8-31f4-ea11-b882-24ee9a37d45c",-73789365,40764884,"J.H.S. 25 - QUEENS","34-65 192 STREET"
1,1,0,"e28442ee-31f4-ea11-b882-24ee9a37d45c","P.S. 040 Samuel Huntington - Q040 - Q040 - 28Q040 - 109-20 Union Hall Street","dd8442ee-31f4-ea11-b882-24ee9a37d45c",-73790975,40693559,"P.S. 40 (D28) - QUEENS","109-20 Union Hall Street"
1,1,0,"31e61462-31f4-ea11-b882-24ee9a37d45c","M.S. 319 - Maria Teresa - M319 - M090 - 06M319 - 21 JUMEL PLACE","2ce61462-31f4-ea11-b882-24ee9a37d45c",-73935815,40839139,"I.S. 90 - MANHATTAN","21 JUMEL PLACE"
1,0,1,"3d0410ca-32f4-ea11-b882-24ee9a37d45c","P.S. 56 The Louis Desario School - R056 - R056 - 31R056 - 250 KRAMER AVENUE","3e0410ca-32f4-ea11-b882-24ee9a37d45c",-74213943,40541856,"P.S. 56 - STATEN ISLAND","250 KRAMER AVENUE"
1,0,1,"2b2ed53d-33f4-ea11-b882-24ee9a37d45c","P.S. 236 Langston Hughes - X236 - X173 - 09X236 - 1871 WALTON AVENUE","2c2ed53d-33f4-ea11-b882-24ee9a37d45c",-73909936,40848907,"P.S. 236 (P173 ECC) - BRONX","1871 WALTON AVENUE"
1,1,0,"2278931f-33f4-ea11-b882-24ee9a37d45c","The School for Inquiry and Social Justice - X337 - X123 - 08X337 - 1025 MORRISON AVENUE","2378931f-33f4-ea11-b882-24ee9a37d45c",-73874162,40824989,"I.S. 123 - BRONX","1025 MORRISON AVENUE"
2,1,1,"42e61462-31f4-ea11-b882-24ee9a37d45c","P.S. 096 Joseph Lanzetta - M096 - M096 - 04M096 - 216 EAST 120 STREET","43e61462-31f4-ea11-b882-24ee9a37d45c",-73937179,40799690,"P.S. 96 - MANHATTAN","216 EAST 120 STREET"
1,1,0,"96abe919-ecf6-ea11-b883-24ee9a37d459","Restart Academy - M973 - XAXF -  - 1161 Taylor Avenue","9e845cb8-33f4-ea11-b882-24ee9a37d45c",-73864790,40829164,"NON DOE building for -M973","1161 Taylor Avenue"
4,4,0,"df2ece86-32f4-ea11-b882-24ee9a37d45c","Bard High School Early College Queens - Q299 - Q735 - 24Q299 - 30-20 THOMSON AVENUE","db2ece86-32f4-ea11-b882-24ee9a37d45c",-73937004,40744175,"QUEENS HIGH SCHOOL COMPLEX - Q","30-20 THOMSON AVENUE"
1,0,1,"a4bf14dd-ebf6-ea11-b883-24ee9a37d459","South Richmond High School I.S./P.S. 25 - R025 - R455 - 75R025 - 100 LUTEN AVENUE","605b4cd6-32f4-ea11-b882-24ee9a37d45c",-74193431,40528152,"TOTTENVILLE HS - S. I.","100 LUTEN AVENUE"
1,0,1,"25e0d393-ebf6-ea11-b883-24ee9a37d459","P.S. Q993 - Q993 - Q130 - 75Q993 - 200-01 42 AVENUE","04af0313-32f4-ea11-b882-24ee9a37d45c",-73784009,40760219,"P.S. 130 - QUEENS","200-01 42 AVENUE"
1,1,0,"720c1bb1-31f4-ea11-b882-24ee9a37d45c","Harvey Milk High School - M586 - M807 - 02M586 - 2-10 ASTOR PLACE","710c1bb1-31f4-ea11-b882-24ee9a37d45c",-73992343,40729661,"HARVEY MILK SCHOOL - MANHATTAN","2-10 ASTOR PLACE"
1,0,1,"0bbdc8e1-49fb-ea11-b883-24ee9a37d459","John Coker DCC - KBOS - KBRX -  - 1375 BUSHWICK AVENUE","9ad91731-31f4-ea11-b882-24ee9a37d45c",-73910428,40685471,"JOHN COKER DAY CARE CENTER","1375 BUSHWICK AVENUE"
1,1,0,"2b0410ca-32f4-ea11-b882-24ee9a37d45c","P.S. 050 Frank Hankinson - R050 - R050 - 31R050 - 200 ADELAIDE AVENUE","2c0410ca-32f4-ea11-b882-24ee9a37d45c",-74124332,40560954,"P.S. 50 - STATEN ISLAND","200 ADELAIDE AVENUE"
1,1,0,"1402926e-32f4-ea11-b882-24ee9a37d45c","Academy of Medical Technology: A College Board School - Q309 - Q465 - 27Q309 - 8-21 BAY 25 STREET","0b02926e-32f4-ea11-b882-24ee9a37d45c",-73763995,40601537,"FAR ROCKAWAY HS - Q","8-21 BAY 25 STREET"
3,1,2,"ba689025-33f4-ea11-b882-24ee9a37d45c","J.H.S. 127 The Castle Hill - X127 - X127 - 11X127 - 1560 PURDY STREET","b9689025-33f4-ea11-b882-24ee9a37d45c",-73853203,40838759,"I.S. 127 - BRONX","1560 PURDY STREET"
1,0,1,"58fdc1bd-32f4-ea11-b882-24ee9a37d45c","Fort Hill Collaborative Elementary School - R010 - R016 - 31R010 - 195 DANIEL LOW TERRACE","56fdc1bd-32f4-ea11-b882-24ee9a37d45c",-74079594,40639638,"P.S. 16 - STATEN ISLAND","195 DANIEL LOW TERRACE"
3,1,2,"14e85c61-30f4-ea11-b882-24ee9a37d45c","P.S. 110 The Monitor - K110 - K110 - 14K110 - 124 MONITOR STREET","e50d3c5b-30f4-ea11-b882-24ee9a37d45c",-73941926,40723743,"P.S. 110 - BROOKLYN","124 MONITOR STREET"
3,3,0,"a52aa42b-33f4-ea11-b882-24ee9a37d45c","Riverdale / Kingsbridge Academy (Middle School / High School 141) - X141 - X141 - 10X141 - 660 West 237 Street","a62aa42b-33f4-ea11-b882-24ee9a37d45c",-73914141,40887407,"M.S./H.S. 141 - BRONX","660 West 237 Street"
5,3,2,"89e657bd-30f4-ea11-b882-24ee9a37d45c","The Urban Assembly School for Law and Justice - K483 - K313 - 13K483 - 283 ADAMS STREET","82e657bd-30f4-ea11-b882-24ee9a37d45c",-73988323,40694629,"ADAMS STREET EDUCATIONAL CAMPUS - K","283 ADAMS STREET"
1,1,0,"9ae657bd-30f4-ea11-b882-24ee9a37d45c","P.S. 133 William A. Butler - K133 - K317 - 13K133 - 610 Baltic Street","99e657bd-30f4-ea11-b882-24ee9a37d45c",-73980455,40679916,"P.S. 133 WILLIAM A. BUTLER - BROOKLYN","610 Baltic Street"
1,0,1,"b348b1f5-eaf6-ea11-b883-24ee9a37d459","P.S. M094 - M094 - M276 - 75M094 - 55 BATTERY PLACE","c6e0838c-31f4-ea11-b882-24ee9a37d45c",-74017456,40706384,"P.S./I.S. 276 - MANHATTAN","55 BATTERY PLACE"
1,0,1,"0a03cefa-32f4-ea11-b882-24ee9a37d45c","The Vida Bogart School for All Children - X352 - X040 - 75X352 - 468 EAST 140 STREET","0b03cefa-32f4-ea11-b882-24ee9a37d45c",-73919773,40809080,"P.S. 220 - BRONX","468 EAST 140 STREET"
4,0,4,"f7724844-8e3d-eb11-b88a-24ee9a37d45c","Sunnyside Community Services - QBGO - QBGO -  - 3901 Queens Boulevard","f8724844-8e3d-eb11-b88a-24ee9a37d45c",-73926004,40744021,"Sunnyside Community Services","3901 Queens Boulevard"
1,1,0,"8d32c3fb-eaf6-ea11-b883-24ee9a37d459","Special Music School - M859 - M932 - 03M859 - 129 WEST 67 STREET","f2ed94c3-31f4-ea11-b882-24ee9a37d45c",-73982976,40775256,"P.S. 199 ANNEX - MANHATTAN","129 WEST 67 STREET"
13,10,3,"d2b66262-32f4-ea11-b882-24ee9a37d45c","Forest Hills High School - Q440 - Q440 - 28Q440 - 67-01 110 STREET","d3b66262-32f4-ea11-b882-24ee9a37d45c",-73843972,40730017,"FOREST HILLS HS - Q","67-01 110 STREET"
1,1,0,"83332a24-4afb-ea11-b883-24ee9a37d459","Aim High Children's Services New Life Child Dev Cn - KBGU - KBGU -  - 295 Woodbine Street","84332a24-4afb-ea11-b883-24ee9a37d459",-73913276,40696425,"New Life Child Development Center 1","295 Woodbine Street"
3,3,0,"6907e99e-31f4-ea11-b882-24ee9a37d45c","Urban Academy Laboratory High School - M565 - M480 - 02M565 - 317 EAST 67 STREET","6007e99e-31f4-ea11-b882-24ee9a37d45c",-73959777,40765638,"JULIA RICHMAN ED. COMPLEX - M","317 EAST 67 STREET"
1,0,1,"bcbf14dd-ebf6-ea11-b883-24ee9a37d459","The David Marquis School of the Arts - R037 - R880 - 75R037 - 715 OCEAN TERRACE","8e11b2e2-32f4-ea11-b882-24ee9a37d45c",-74105883,40607637,"P.S. 80 (PETR COMPL-BLDG B) - S.I.","715 OCEAN TERRACE"
3,3,0,"10b7c337-32f4-ea11-b882-24ee9a37d45c","P.S. 221 The North Hills School - Q221 - Q221 - 26Q221 - 57-40 MARATHON PARKWAY","11b7c337-32f4-ea11-b882-24ee9a37d45c",-73731518,40758808,"P.S. 221 - QUEENS","57-40 MARATHON PARKWAY"
1,0,1,"ba79df48-30f4-ea11-b882-24ee9a37d45c","P.S. 059 William Floyd - K059 - K059 - 14K059 - 211 THROOP AVENUE","b579df48-30f4-ea11-b882-24ee9a37d45c",-73943279,40697619,"P.S. 59 - BROOKLYN","211 THROOP AVENUE"
1,0,1,"ba05be56-ebf6-ea11-b883-24ee9a37d459","P.S. M094 - M094 - M015 - 75M094 - 333 EAST 4 STREET","a5886843-31f4-ea11-b882-24ee9a37d45c",-73978747,40722075,"P.S. 15 - MANHATTAN","333 EAST 4 STREET"
5,2,3,"8603194f-30f4-ea11-b882-24ee9a37d45c","Brooklyn Landmark Elementary School - K599 - K073 - 23K599 - 251 MAC DOUGAL STREET","8503194f-30f4-ea11-b882-24ee9a37d45c",-73910719,40680679,"P.S. 73 - BROOKLYN","251 MAC DOUGAL STREET"
1,1,0,"362f7d06-31f4-ea11-b882-24ee9a37d45c","Brooklyn Studio Secondary School - K690 - K721 - 21K690 - 8310 21ST AVENUE","56416e00-31f4-ea11-b882-24ee9a37d45c",-73995084,40604980,"BROOKLYN STUDIO (TANDEM K128) - K","8310 21ST AVENUE"
1,0,1,"86c1797b-ebf6-ea11-b883-24ee9a37d459","P.S. M094 - M094 - M971 - 75M094 - 12 SPRUCE STREET","01ee94c3-31f4-ea11-b882-24ee9a37d45c",-74005473,40711321,"THE SPRUCE STREET EDUCATIONAL CAMPUS","12 SPRUCE STREET"
2,1,1,"08af0313-32f4-ea11-b882-24ee9a37d45c","P.S. 129 Patricia Larkin - Q129 - Q129 - 25Q129 - 128-02 7 Avenue","09af0313-32f4-ea11-b882-24ee9a37d45c",-73839505,40789926,"P.S. 129 - QUEENS","128-02 7 Avenue"
4,3,1,"fef22ce2-31f4-ea11-b882-24ee9a37d45c","P.S. 011 Kathryn Phelan - Q011 - Q011 - 30Q011 - 54-25 SKILLMAN AVENUE","fff22ce2-31f4-ea11-b882-24ee9a37d45c",-73909032,40746127,"P.S. 11 - QUEENS","54-25 SKILLMAN AVENUE"
3,2,1,"b68442ee-31f4-ea11-b882-24ee9a37d45c","P.S. 026 Rufus King - Q026 - Q026 - 26Q026 - 195-02 69 AVENUE","c5fc24e8-31f4-ea11-b882-24ee9a37d45c",-73777607,40735935,"P.S. 26 - QUEENS","195-02 69 AVENUE"
1,0,1,"533cbf01-ebf6-ea11-b883-24ee9a37d459","South Richmond High School I.S./P.S. 25 - R025 - R825 - 75R025 - 6581 HYLAN BOULEVARD","77be7adc-32f4-ea11-b882-24ee9a37d45c",-74218688,40512019,"P.S. 25 (MOUNT LORETTO) - S.I.","6581 HYLAN BOULEVARD"
1,0,1,"0c03cefa-32f4-ea11-b882-24ee9a37d45c","P.S. 179 - X179 - X040 - 07X179 - 468 EAST 140 STREET","0b03cefa-32f4-ea11-b882-24ee9a37d45c",-73919773,40809080,"P.S. 220 - BRONX","468 EAST 140 STREET"
2,1,1,"76886843-31f4-ea11-b882-24ee9a37d45c","P.S. 002 Meyer London - M002 - M002 - 02M002 - 122 Henry Street","77886843-31f4-ea11-b882-24ee9a37d45c",-73991523,40712907,"P.S. 2 - MANHATTAN","122 Henry Street"
1,0,1,"0dba8b86-30f4-ea11-b882-24ee9a37d45c","P.S. 204 Vince Lombardi - K204 - K204 - 20K204 - 8101 15 AVENUE","0eba8b86-30f4-ea11-b882-24ee9a37d45c",-74006137,40613535,"P.S. 204 - BROOKLYN","8101 15 AVENUE"
1,0,1,"453cbf01-ebf6-ea11-b883-24ee9a37d459","P.S./I.S. 78Q - Q078 - Q868 - 30Q078 - 48-09 CENTER BOULEVARD","bcedf392-32f4-ea11-b882-24ee9a37d45c",-73957177,40744368,"P.S. 78 - QUEENS","48-09 CENTER BOULEVARD"
2,1,1,"e621d292-30f4-ea11-b882-24ee9a37d45c","P.S. K225 - The Eileen E. Zaglin - K225 - K225 - 21K225 - 1075 OCEAN VIEW AVENUE","e521d292-30f4-ea11-b882-24ee9a37d45c",-73955856,40580260,"P.S. 225 - BROOKLYN","1075 OCEAN VIEW AVENUE"
1,0,1,"88c1797b-ebf6-ea11-b883-24ee9a37d459","Restart Academy - M973 - MAKG -  - 411 WEST 114 STREET","8a3eb8c9-31f4-ea11-b882-24ee9a37d45c",-73960923,40805305,"CARES","411 WEST 114 STREET"
1,0,1,"907e21a6-ebf6-ea11-b883-24ee9a37d459","P.S./I.S. 78Q - Q078 - Q312 - 30Q078 - 46-08 5TH STREET","cf454b50-32f4-ea11-b882-24ee9a37d45c",-73955145,40747077,"P.S./.IS. 78 - QUEENS","46-08 5TH STREET"
1,0,1,"4de61462-31f4-ea11-b882-24ee9a37d45c","Innovation Charter High School - M433 - M099 - 84M433 - 410 EAST 100 STREET","3de61462-31f4-ea11-b882-24ee9a37d45c",-73942154,40785107,"I.S. 99 - MANHATTAN","410 EAST 100 STREET"
12,2,10,"553cbf01-ebf6-ea11-b883-24ee9a37d459","The David Marquis School of the Arts - R037 - R840 - 75R037 - 15 Fairfield Street","81be7adc-32f4-ea11-b882-24ee9a37d45c",-74151368,40564100,"P.S. 37 ( OLD I24X)-STATEN ISLAND","15 Fairfield Street"
2,2,0,"340b210d-33f4-ea11-b882-24ee9a37d45c","Creston Academy - X447 - X079 - 10X447 - 125 EAST 181 STREET","2c0b210d-33f4-ea11-b882-24ee9a37d45c",-73903139,40855337,"P.S. 79 - BRONX","125 EAST 181 STREET"
1,1,0,"c979df48-30f4-ea11-b882-24ee9a37d45c","Achievement First East New York Charter School - K358 - K065 - 84K358 - 158 RICHMOND STREET","ca79df48-30f4-ea11-b882-24ee9a37d45c",-73877256,40683399,"P.S. 65 - BROOKLYN","158 RICHMOND STREET"
1,0,1,"290b210d-33f4-ea11-b882-24ee9a37d45c","P.S. 196 - X196 - X077 - 12X196 - 1250 WARD AVENUE","230b210d-33f4-ea11-b882-24ee9a37d45c",-73877305,40830811,"P.S. 195 - BRONX","1250 WARD AVENUE"
1,1,0,"f59b4c1f-32f4-ea11-b882-24ee9a37d45c","P.S. 159 - Q159 - Q159 - 26Q159 - 205-01 33 AVENUE","f69b4c1f-32f4-ea11-b882-24ee9a37d45c",-73783973,40770108,"P.S. 159 - QUEENS","205-01 33 AVENUE"
1,0,1,"ffb98b86-30f4-ea11-b882-24ee9a37d45c","P.S. 200 Benson School - K200 - K200 - 20K200 - 1940 BENSON AVENUE","00ba8b86-30f4-ea11-b882-24ee9a37d45c",-74001915,40602809,"P.S. 200 - BROOKLYN","1940 BENSON AVENUE"
3,1,2,"73593c87-33f4-ea11-b882-24ee9a37d45c","P.S. 196 - X196 - X823 - 12X196 - 1025 Morrison Avenue","34a31781-33f4-ea11-b882-24ee9a37d45c",-73874162,40824989,"I.S. 123 MINISCHOOL - BRONX","1025 Morrison Avenue"
1,0,1,"d2883319-32f4-ea11-b882-24ee9a37d45c","Queens Transition Center - Q752 - Q142 - 75Q752 - 142-10 LINDEN BOULEVARD","2eaf0313-32f4-ea11-b882-24ee9a37d45c",-73800875,40683473,"P.S. 752 (OLD J142) - QUEENS","142-10 LINDEN BOULEVARD"
1,0,1,"3fde5eb7-30f4-ea11-b882-24ee9a37d45c","P.S. 298 Dr. Betty Shabazz - K298 - K298 - 23K298 - 85 WATKINS STREET","3dde5eb7-30f4-ea11-b882-24ee9a37d45c",-73907718,40671015,"P.S. 298 - BROOKLYN","85 WATKINS STREET"
7,6,1,"8c72c880-32f4-ea11-b882-24ee9a37d45c","Thomas A. Edison Career and Technical Education High School - Q620 - Q620 - 28Q620 - 165-65 84 AVENUE","49b4977a-32f4-ea11-b882-24ee9a37d45c",-73799692,40716071,"THOMAS A. EDISON VOC HS - Q","165-65 84 AVENUE"
2,2,0,"237eed06-32f4-ea11-b882-24ee9a37d45c","I.S. 093 Ridgewood - Q093 - Q093 - 24Q093 - 66-56 FOREST AVENUE","0f7eed06-32f4-ea11-b882-24ee9a37d45c",-73903057,40705609,"I.S. 93 - QUEENS","66-56 FOREST AVENUE"
1,1,0,"2d7c21b7-32f4-ea11-b882-24ee9a37d45c","P.S. 001 Tottenville - R001 - R001 - 31R001 - 58 SUMMIT STREET","2e7c21b7-32f4-ea11-b882-24ee9a37d45c",-74243950,40508638,"P.S. 1 - STATEN ISLAND","58 SUMMIT STREET"
1,1,0,"798d8486-31f4-ea11-b882-24ee9a37d45c","KIPP S.T.A.R. College Preparatory Charter School - M726 - M195 - 84M726 - 625 WEST 133 STREET","758d8486-31f4-ea11-b882-24ee9a37d45c",-73956814,40819793,"TERENCE D. TOLBERT EDUCATION COMPLEX - MANHATTAN","625 WEST 133 STREET"
1,0,1,"d385f462-ebf6-ea11-b883-24ee9a37d459","P.S. M094 - M094 - M188 - 75M094 - 442 EAST HOUSTON STREET","4b507380-31f4-ea11-b882-24ee9a37d45c",-73977380,40719888,"P.S. 188 - MANHATTAN","442 EAST HOUSTON STREET"
2,0,2,"fcbffb05-4afb-ea11-b883-24ee9a37d459","OPEN DOOR CHILD CARE CENTER - MAVN - MAVN -  - 820 COLUMBUS AVENUE","fdbffb05-4afb-ea11-b883-24ee9a37d459",-73965699,40797114,"OPEN DOOR CHILD CARE CENTER","820 COLUMBUS AVENUE"
2,2,0,"a732c3fb-eaf6-ea11-b883-24ee9a37d459","P.S. Q177 - Q177 - Q177 - 75Q177 - 56-37 188 STREET","8b0e6e25-32f4-ea11-b882-24ee9a37d45c",-73787419,40743400,"P.S. 177 - QUEENS","56-37 188 STREET"
1,1,0,"d479df48-30f4-ea11-b882-24ee9a37d45c","Community Roots Charter School - K536 - K067 - 84K536 - 51 SAINT EDWARDS STREET","d179df48-30f4-ea11-b882-24ee9a37d45c",-73977674,40695339,"P.S. 67 - BROOKLYN","51 SAINT EDWARDS STREET"
2,1,1,"e6b98b86-30f4-ea11-b882-24ee9a37d45c","P.S. 193 Gil Hodges - K193 - K193 - 22K193 - 2515 AVENUE L","e5b98b86-30f4-ea11-b882-24ee9a37d45c",-73950321,40622080,"P.S. 193 - BROOKLYN","2515 AVENUE L"
3,2,1,"3e7c21b7-32f4-ea11-b882-24ee9a37d45c","P.S. 005 Huguenot - R005 - R005 - 31R005 - 348 DEISIUS STREET","3f7c21b7-32f4-ea11-b882-24ee9a37d45c",-74187276,40529389,"P.S. 5 - STATEN ISLAND","348 DEISIUS STREET"
6,0,6,"3088e6db-30f4-ea11-b882-24ee9a37d45c","Brooklyn Technical High School - K430 - K430 - 13K430 - 29 FT GREENE PLACE","3188e6db-30f4-ea11-b882-24ee9a37d45c",-73976435,40688896,"BROOKLYN TECH HS - K","29 FT GREENE PLACE"
1,0,1,"7d8946f4-31f4-ea11-b882-24ee9a37d45c","P.S. 055 Maure - Q055 - Q055 - 28Q055 - 131-10 97 Avenue","7b8946f4-31f4-ea11-b882-24ee9a37d45c",-73816156,40693610,"P.S. 55 - QUEENS","131-10 97 Avenue"
2,2,0,"107eed06-32f4-ea11-b882-24ee9a37d45c","P.S. Q086 - Q086 - Q086 - 28Q086 - 87-41 PARSONS BOULEVARD","117eed06-32f4-ea11-b882-24ee9a37d45c",-73803001,40709461,"P.S. 86 - QUEENS","87-41 PARSONS BOULEVARD"
2,2,0,"df0d3c5b-30f4-ea11-b882-24ee9a37d45c","P.S. 105 The Blythebourne - K105 - K105 - 20K105 - 1031 59 STREET","e00d3c5b-30f4-ea11-b882-24ee9a37d45c",-74003635,40633320,"P.S. 105 - BROOKLYN","1031 59 STREET"
1,1,0,"b1eb6056-32f4-ea11-b882-24ee9a37d45c","August Martin High School - Q400 - Q400 - 27Q400 - 156-10 BAISLEY BOULEVARD","a9eb6056-32f4-ea11-b882-24ee9a37d45c",-73782684,40673949,"AUGUST MARTIN HS - QUEENS","156-10 BAISLEY BOULEVARD"
4,0,4,"fdd10307-33f4-ea11-b882-24ee9a37d45c","Leaders In Our Neighborhood Charter School - X345 - X074 - 84X345 - 730 BRYANT AVENUE","f9d10307-33f4-ea11-b882-24ee9a37d45c",-73885284,40815827,"I.S. 201 - BRONX","730 BRYANT AVENUE"
1,0,1,"c1ab074a-33f4-ea11-b882-24ee9a37d45c","P.S. 205 Fiorello LaGuardia - X205 - X205 - 10X205 - 2475 Southern Boulevard","c2ab074a-33f4-ea11-b882-24ee9a37d45c",-73881753,40855759,"P.S. 205A (ECF) - BRONX","2475 Southern Boulevard"
4,4,0,"8b01ce37-33f4-ea11-b882-24ee9a37d45c","Bronx Latin - X267 - X158 - 12X267 - 800 HOME STREET","8601ce37-33f4-ea11-b882-24ee9a37d45c",-73900593,40826933,"I.S. 158 - BRONX","800 HOME STREET"
2,0,2,"aa2ff20c-32f4-ea11-b882-24ee9a37d45c","P.S. 104 The Bays Water - Q104 - Q104 - 27Q104 - 26-01 MOTT AVENUE","3c7eed06-32f4-ea11-b882-24ee9a37d45c",-73764621,40608002,"P.S. 104 - QUEENS","26-01 MOTT AVENUE"
1,1,0,"d9e0a4fb-ebf6-ea11-b883-24ee9a37d459","P.S. 723 - X723 - X189 - 75X723 - 3441 STEENWICK AVENUE","018b0044-33f4-ea11-b882-24ee9a37d45c",-73830616,40882778,"P.S./I.S. 189 - BRONX","3441 STEENWICK AVENUE"
3,3,0,"39a6ba98-31f4-ea11-b882-24ee9a37d45c","Frank McCourt High School - M417 - M470 - 03M417 - 145 WEST 84 STREET","33a6ba98-31f4-ea11-b882-24ee9a37d45c",-73974483,40786134,"LOUIS D. BRANDEIS HS - MANHATTAN","145 WEST 84 STREET"
2,2,0,"1ea6ba98-31f4-ea11-b882-24ee9a37d45c","Union Square Academy for Health Sciences - M533 - M460 - 02M533 - 40 IRVING PLACE","16a6ba98-31f4-ea11-b882-24ee9a37d45c",-73987064,40735361,"WASHINGTON IRVING HS - MANHATTAN","40 IRVING PLACE"
1,0,1,"402682ef-ebf6-ea11-b883-24ee9a37d459","Bronx Charter School for Better Learning - X718 - X111 - 84X718 - 3740 Baychester Avenue","4d0d6d19-33f4-ea11-b882-24ee9a37d45c",-73839288,40884371,"P.S. 111 - BRONX","3740 Baychester Avenue"
3,2,1,"45416e00-31f4-ea11-b882-24ee9a37d45c","District 20 Pre-K Center - K768 - K678 - 20K768 - 1423 62ND STREET","46416e00-31f4-ea11-b882-24ee9a37d45c",-73996423,40625978,"PRE-K CENTER @62ND STREET - BROOKLYN","1423 62ND STREET"
2,2,0,"2d767649-31f4-ea11-b882-24ee9a37d45c","P.S. 020 Anna Silver - M020 - M020 - 01M020 - 166 ESSEX STREET","2e767649-31f4-ea11-b882-24ee9a37d45c",-73986312,40721305,"P.S. 20 - MANHATTAN","166 ESSEX STREET"
1,0,1,"89886843-31f4-ea11-b882-24ee9a37d45c","P.S. 005 Ellen Lurie - M005 - M005 - 06M005 - 3703 TENTH AVENUE","8a886843-31f4-ea11-b882-24ee9a37d45c",-73922277,40857633,"P.S. 5 - MANHATTAN","3703 TENTH AVENUE"
3,3,0,"e38521d0-32f4-ea11-b882-24ee9a37d45c","I.S. 072 Rocco Laurie - R072 - R072 - 31R072 - 33 FERNDALE AVENUE","e48521d0-32f4-ea11-b882-24ee9a37d45c",-74158618,40592132,"I.S. 72 - STATEN ISLAND","33 FERNDALE AVENUE"
2,2,0,"4c88e6db-30f4-ea11-b882-24ee9a37d45c","International High School at Prospect Heights - K524 - K440 - 17K524 - 883 CLASSON AVENUE","4a88e6db-30f4-ea11-b882-24ee9a37d45c",-73960689,40669805,"PROSPECT HEIGHTS HS - K","883 CLASSON AVENUE"
1,1,0,"ce92e6d5-30f4-ea11-b882-24ee9a37d45c","Cypress Hills Collegiate Preparatory School - K659 - K420 - 19K659 - 999 JAMAICA AVENUE","c692e6d5-30f4-ea11-b882-24ee9a37d45c",-73869305,40693002,"FRANKLIN K. LANE HS - K","999 JAMAICA AVENUE"
1,1,0,"7d2f77fa-31f4-ea11-b882-24ee9a37d45c","P.S. 070 - Q070 - Q070 - 30Q070 - 30-44 43rd Street","7b2f77fa-31f4-ea11-b882-24ee9a37d45c",-73913964,40761762,"P.S. 70 - QUEENS","30-44 43rd Street"
1,0,1,"70e03d56-33f4-ea11-b882-24ee9a37d45c","The Bronxwood Preparatory Academy - X514 - X362 - 11X514 - 921 EAST 228TH STREET","6ce03d56-33f4-ea11-b882-24ee9a37d45c",-73852714,40888242,"I.S./H.S. 362 - BRONX","921 EAST 228TH STREET"
2,2,0,"5de61462-31f4-ea11-b882-24ee9a37d45c","J.H.S. 104 Simon Baruch - M104 - M104 - 02M104 - 330 EAST 21 STREET","5ee61462-31f4-ea11-b882-24ee9a37d45c",-73981034,40735879,"I.S. 104 - MANHATTAN","330 EAST 21 STREET"
3,2,1,"c837fba4-31f4-ea11-b882-24ee9a37d45c","Park East High School - M495 - M495 - 04M495 - 230 EAST 105 STREET","c737fba4-31f4-ea11-b882-24ee9a37d45c",-73944092,40790191,"PARK EAST HS - MANHATTAN","230 EAST 105 STREET"
3,3,0,"4c5b4cd6-32f4-ea11-b882-24ee9a37d45c","Staten Island Technical High School - R605 - R440 - 31R605 - 485 CLAWSON STREET","4b5b4cd6-32f4-ea11-b882-24ee9a37d45c",-74117086,40568299,"STATEN ISLAND TECHNICAL HS - S.I.","485 CLAWSON STREET"
2,2,0,"2102926e-32f4-ea11-b882-24ee9a37d45c","Queens Collegiate: A College Board School - Q310 - Q470 - 28Q310 - 167-01 GOTHIC DRIVE","1f02926e-32f4-ea11-b882-24ee9a37d45c",-73798658,40714551,"JAMAICA HS - Q","167-01 GOTHIC DRIVE"
2,0,2,"4e9d7c62-33f4-ea11-b882-24ee9a37d45c","Pelham Preparatory Academy - X542 - X415 - 11X542 - 925 ASTOR AVENUE","439d7c62-33f4-ea11-b882-24ee9a37d45c",-73860729,40860443,"CHRISTOPHER COLUMBUS HS - X","925 ASTOR AVENUE"
1,1,0,"f037fba4-31f4-ea11-b882-24ee9a37d45c","P.S. 138 - M138 - M535 - 75M138 - 525 WEST 50TH STREET","f137fba4-31f4-ea11-b882-24ee9a37d45c",-73992700,40765474,"PARK WEST HS (ECF) - MANHATTAN","525 WEST 50TH STREET"
1,1,0,"b3fc24e8-31f4-ea11-b882-24ee9a37d45c","P.S. 022 Thomas Jefferson - Q022 - Q022 - 25Q022 - 153-33 SANFORD AVENUE","b1fc24e8-31f4-ea11-b882-24ee9a37d45c",-73811373,40761744,"P.S. 22 - QUEENS","153-33 SANFORD AVENUE"
10,7,3,"435b4cd6-32f4-ea11-b882-24ee9a37d45c","New Dorp High School - R440 - R435 - 31R440 - 465 NEW DORP LANE","fb8521d0-32f4-ea11-b882-24ee9a37d45c",-74105878,40570909,"NEW DORP HS (NEW) - S. I.","465 NEW DORP LANE"
2,2,0,"9601ce37-33f4-ea11-b882-24ee9a37d45c","P.S. 160 Walt Disney - X160 - X160 - 11X160 - 4140 HUTCHINSON RIVER PKWAY EA","9501ce37-33f4-ea11-b882-24ee9a37d45c",-73823816,40864073,"P.S. 160 - BRONX","4140 HUTCHINSON RIVER PKWAY EA"
2,2,0,"a472c880-32f4-ea11-b882-24ee9a37d45c","Metropolitan Expeditionary Learning School - Q167 - Q686 - 28Q167 - 91-30 METROPOLITAN AVENUE","a372c880-32f4-ea11-b882-24ee9a37d45c",-73855543,40708431,"METROPOLITAN AVENUE CAMPUS - QUEENS","91-30 METROPOLITAN AVENUE"
2,1,1,"9069c231-32f4-ea11-b882-24ee9a37d45c","Robert H. Goddard High School of Communication Arts and Technology - Q308 - Q202 - 27Q308 - 138-30 LAFAYETTE STREET","9169c231-32f4-ea11-b882-24ee9a37d45c",-73845992,40670905,"I.S. 202 - QUEENS","138-30 LAFAYETTE STREET"
1,1,0,"a5edf392-32f4-ea11-b882-24ee9a37d45c","Joseph F. Quinn Intermediate School 77 - Q077 - Q849 - 24Q077 - 976 Seneca Avenue","a4edf392-32f4-ea11-b882-24ee9a37d45c",-73902147,40699101,"I.S. 77 - QUEENS","976 Seneca Avenue"
2,2,0,"33474313-33f4-ea11-b882-24ee9a37d45c","Ampark Neighborhood - X344 - X095 - 10X344 - 3961 HILLMAN AVENUE","34474313-33f4-ea11-b882-24ee9a37d45c",-73891664,40883049,"P.S. 95 - BRONX","3961 HILLMAN AVENUE"
1,0,1,"3902fdd0-ebf6-ea11-b883-24ee9a37d459","The David Marquis School of the Arts - R037 - R004 - 75R037 - 200 NEDRA LANE","337c21b7-32f4-ea11-b882-24ee9a37d45c",-74195281,40552059,"P.S. 4 - STATEN ISLAND","200 NEDRA LANE"
1,0,1,"8801ce37-33f4-ea11-b882-24ee9a37d45c","P.S. 157 Grove Hill - X157 - X157 - 07X157 - 757 CAULDWELL AVENUE","8901ce37-33f4-ea11-b882-24ee9a37d45c",-73908965,40819419,"P.S. 157 - BRONX","757 CAULDWELL AVENUE"
1,1,0,"f8ce496e-31f4-ea11-b882-24ee9a37d45c","Castle Bridge School - M513 - M128 - 06M513 - 560 WEST 169 STREET","f9ce496e-31f4-ea11-b882-24ee9a37d45c",-73938701,40841032,"P.S. 128 - MANHATTAN","560 WEST 169 STREET"
1,0,1,"f6ae0313-32f4-ea11-b882-24ee9a37d45c","P.S. 123 - Q123 - Q123 - 27Q123 - 145-01 119 AVENUE","f7ae0313-32f4-ea11-b882-24ee9a37d45c",-73795571,40678913,"P.S. 123 - QUEENS","145-01 119 AVENUE"
4,3,1,"46de5eb7-30f4-ea11-b882-24ee9a37d45c","Vista Academy - K661 - K302 - 19K661 - 350 LINWOOD STREET","42de5eb7-30f4-ea11-b882-24ee9a37d45c",-73884211,40677112,"I.S. 302 - BROOKLYN","350 LINWOOD STREET"
1,1,0,"470d6d19-33f4-ea11-b882-24ee9a37d45c","P.S. 109 Sedgwick - X109 - X109 - 09X109 - 1771 POPHAM AVENUE","480d6d19-33f4-ea11-b882-24ee9a37d45c",-73918991,40851661,"P.S. 109 - BRONX","1771 POPHAM AVENUE"
1,1,0,"4f474313-33f4-ea11-b882-24ee9a37d45c","P.S. 100 Isaac Clason - X100 - X100 - 08X100 - 800 TAYLOR AVENUE","50474313-33f4-ea11-b882-24ee9a37d45c",-73862760,40822552,"P.S. 100 - BRONX","800 TAYLOR AVENUE"
1,0,1,"3b3cbf01-ebf6-ea11-b883-24ee9a37d459","P.S. Q233 - Q233 - Q686 - 75Q233 - 91-30 METROPOLITAN AVENUE","a372c880-32f4-ea11-b882-24ee9a37d45c",-73855543,40708431,"METROPOLITAN AVENUE CAMPUS - QUEENS","91-30 METROPOLITAN AVENUE"
1,0,1,"30e61462-31f4-ea11-b882-24ee9a37d45c","P.S. 138 - M138 - M090 - 75M138 - 21 JUMEL PLACE","2ce61462-31f4-ea11-b882-24ee9a37d45c",-73935815,40839139,"I.S. 90 - MANHATTAN","21 JUMEL PLACE"
2,2,0,"04f32ce2-31f4-ea11-b882-24ee9a37d45c","P.S. 013 Clement C. Moore - Q013 - Q013 - 24Q013 - 55-01 94 STREET","05f32ce2-31f4-ea11-b882-24ee9a37d45c",-73867662,40737441,"P.S. 13 - QUEENS","55-01 94 STREET"
1,1,0,"e4b36d80-30f4-ea11-b882-24ee9a37d45c","P.S. 192 - The Magnet School for Math and Science Inquiry - K192 - K192 - 20K192 - 4715 18 AVENUE","e5b36d80-30f4-ea11-b882-24ee9a37d45c",-73979540,40628800,"P.S. 192 - BROOKLYN","4715 18 AVENUE"
2,2,0,"8f0e6e25-32f4-ea11-b882-24ee9a37d45c","P.S. 173 Fresh Meadows - Q173 - Q173 - 26Q173 - 174-10 67 AVENUE","900e6e25-32f4-ea11-b882-24ee9a37d45c",-73795651,40734097,"P.S. 173 - QUEENS","174-10 67 AVENUE"
1,0,1,"524977dc-48fb-ea11-b883-24ee9a37d459","BASILIA CABRAL - KDPC - KDHN -  - 105-32 75th Street","534977dc-48fb-ea11-b883-24ee9a37d459",-73862333,0,"105-32 75TH STREET","105-32 75th Street"
1,0,1,"15a31781-33f4-ea11-b882-24ee9a37d45c","P.S. X188 - X188 - X790 - 75X188 - 730 CONCOURSE VILLAGE WEST","0ea31781-33f4-ea11-b882-24ee9a37d45c",-73922366,40821828,"MOTT HAVEN EDUCATIONAL CAMPUS - BRONX","730 CONCOURSE VILLAGE WEST"
1,0,1,"c0e0838c-31f4-ea11-b882-24ee9a37d45c","East Side Elementary School, PS 267 - M267 - M267 - 02M267 - 213 EAST 63RD STREET","c1e0838c-31f4-ea11-b882-24ee9a37d45c",-73963861,40763883,"P.S. 59 - (MEETH) -MANHATTAN","213 EAST 63RD STREET"
1,0,1,"f3f22ce2-31f4-ea11-b882-24ee9a37d45c","J.H.S. 008 Richard S. Grossley - Q008 - Q008 - 28Q008 - 108-35 167 STREET","f1f22ce2-31f4-ea11-b882-24ee9a37d45c",-73786403,40696910,"J.H.S. 8 - QUEENS","108-35 167 STREET"
1,0,1,"b6689025-33f4-ea11-b882-24ee9a37d45c","P.S. 126 Dr Marjorie H Dunbar - X126 - X126 - 09X126 - 175 WEST 166 STREET","b5689025-33f4-ea11-b882-24ee9a37d45c",-73928200,40835866,"P.S. 126 (ECF) - BRONX","175 WEST 166 STREET"
1,0,1,"f902cefa-32f4-ea11-b882-24ee9a37d45c","P.S. X188 - X188 - X034 - 75X188 - 770 GROTE STREET","fa02cefa-32f4-ea11-b882-24ee9a37d45c",-73883877,40850168,"P.S. 34 - BRONX","770 GROTE STREET"
1,0,1,"45767649-31f4-ea11-b882-24ee9a37d45c","M.S. 255 Salk School of Science - M255 - M040 - 02M255 - 320 EAST 20TH STREET","46767649-31f4-ea11-b882-24ee9a37d45c",-73981536,40735328,"P.S. 40 - MANHATTAN","320 EAST 20TH STREET"
1,1,0,"f9b98b86-30f4-ea11-b882-24ee9a37d45c","P.S. 198 Brooklyn - K198 - K198 - 22K198 - 4105 FARRAGUT ROAD","fab98b86-30f4-ea11-b882-24ee9a37d45c",-73937083,40637601,"P.S. 198 - BROOKLYN","4105 FARRAGUT ROAD"
1,0,1,"13e2abc9-30f4-ea11-b882-24ee9a37d45c","P.S. 376 - K376 - K376 - 32K376 - 194 HARMAN STREET","14e2abc9-30f4-ea11-b882-24ee9a37d45c",-73920187,40698050,"P.S. 376A - BROOKLYN","194 HARMAN STREET"
2,0,2,"26bef08c-32f4-ea11-b882-24ee9a37d45c","P.S. 199 Maurice A. Fitzgerald - Q199 - Q841 - 24Q199 - 48-25 37th Street","27bef08c-32f4-ea11-b882-24ee9a37d45c",-73928640,40739438,"P.S. 199 ANNEX - QUEENS","48-25 37th Street"
12,8,4,"ed1aad3c-30f4-ea11-b882-24ee9a37d45c","P.S. 029 John M. Harrigan - K029 - K029 - 15K029 - 425 HENRY STREET","ee1aad3c-30f4-ea11-b882-24ee9a37d45c",-73997447,40686843,"P.S. 29 - BROOKLYN","425 HENRY STREET"
2,1,1,"7a34aa92-31f4-ea11-b882-24ee9a37d45c","James Baldwin School, The: A School for Expeditionary Learning - M313 - M440 - 02M313 - 351 WEST 18 STREET","7834aa92-31f4-ea11-b882-24ee9a37d45c",-74002540,40743407,"BAYARD RUSTIN EDUCATIONAL COMP-M","351 WEST 18 STREET"
1,1,0,"efc1392a-30f4-ea11-b882-24ee9a37d45c","P.S. 003 The Bedford Village - K003 - K003 - 13K003 - 50 JEFFERSON AVENUE","f0c1392a-30f4-ea11-b882-24ee9a37d45c",-73955219,40682311,"P.S. 3 - BROOKLYN","50 JEFFERSON AVENUE"
1,1,0,"97845cb8-33f4-ea11-b882-24ee9a37d45c","KIPP Academy Charter School - X704 - XAVN - 84X704 - 201 EAST 144TH STREET","96845cb8-33f4-ea11-b882-24ee9a37d45c",-73926486,40816100,"KIPP High School Building","201 EAST 144TH STREET"
2,1,1,"d03159fa-30f4-ea11-b882-24ee9a37d45c","Sunset Park High School - K667 - K564 - 15K667 - 153 35 Street","18fc3df4-30f4-ea11-b882-24ee9a37d45c",-74004342,40655583,"SUNSET PARK HS - BROOKLYN","153 35 Street"
2,0,2,"db21d292-30f4-ea11-b882-24ee9a37d45c","P.S. 222 Katherine R. Snyder - K222 - K222 - 22K222 - 3301 QUENTIN ROAD","dc21d292-30f4-ea11-b882-24ee9a37d45c",-73939205,40614005,"P.S. 222 - BROOKLYN","3301 QUENTIN ROAD"
3,3,0,"399ebaee-32f4-ea11-b882-24ee9a37d45c","P.S. 019 Judith K. Weiss - X019 - X019 - 11X019 - 311 East 237 Street","319ebaee-32f4-ea11-b882-24ee9a37d45c",-73866949,40899351,"P.S. 19 - BRONX","311 East 237 Street"
3,2,1,"30ebaa73-30f4-ea11-b882-24ee9a37d45c","Success Academy Charter School - Crown Heights - K741 - K161 - 84K741 - 330 CROWN STREET","31ebaa73-30f4-ea11-b882-24ee9a37d45c",-73949243,40665757,"P.S. 161 - BROOKLYN","330 CROWN STREET"
3,0,3,"492b3eee-30f4-ea11-b882-24ee9a37d45c","High School of Telecommunication Arts and Technology - K485 - K485 - 20K485 - 350 67 STREET","bf9c11e8-30f4-ea11-b882-24ee9a37d45c",-74023419,40636721,"TELECOM. ARTS & TECH. - K","350 67 STREET"
2,0,2,"cdc88e4f-31f4-ea11-b882-24ee9a37d45c","P.S. 046 Arthur Tappan - M046 - M046 - 05M046 - 2987 FREDERICK DOUGLASS BOULEVARD","ccc88e4f-31f4-ea11-b882-24ee9a37d45c",-73936300,40830400,"P.S. 46 - MANHATTAN","2987 FREDERICK DOUGLASS BOULEVARD"
1,0,1,"19e85c61-30f4-ea11-b882-24ee9a37d45c","I.S. 347 School of Humanities - K347 - K111 - 32K347 - 35 STARR STREET","18e85c61-30f4-ea11-b882-24ee9a37d45c",-73927938,40700810,"I.S. 111 - BROOKLYN","35 STARR STREET"
1,1,0,"6ee5bc26-6c0c-ed11-b091-088e901ef405","Gotham Tech High School - Q417 - Q450 - 30Q417 - 28-01 41 AVENUE","dab66262-32f4-ea11-b882-24ee9a37d45c",-73936592,40751838,"NEWCOMERS HIGH SCHOOL (OLD LIC)-Q","28-01 41 AVENUE"
1,0,1,"748946f4-31f4-ea11-b882-24ee9a37d45c","Success Academy Charter School - Far Rockaway - Q375 - Q053 - 84Q375 - 10-45 NAMEOKE STREET","648946f4-31f4-ea11-b882-24ee9a37d45c",-73749891,40604019,"I.S. 53 - QUEENS","10-45 NAMEOKE STREET"
1,0,1,"6b26a88b-6d0c-ed11-b091-088e901ef405","Success Academy Charter School – Bronx 5 Lower - X637 - XCKH - 84X637 - 604 East 139 Street","6926a88b-6d0c-ed11-b091-088e901ef405",-73915228,40806741,"604 East 139 Street","604 East 139 Street"
2,2,0,"200b210d-33f4-ea11-b882-24ee9a37d45c","P.S. 75 School of Research and Discovery - X075 - X075 - 08X075 - 984 FAILE STREET","1f0b210d-33f4-ea11-b882-24ee9a37d45c",-73888948,40822314,"P.S. 75 - BRONX","984 FAILE STREET"
1,1,0,"d4fa079f-32f4-ea11-b882-24ee9a37d45c","P.S. 206 The Horace Harding School - Q206 - Q956 - 28Q206 - 61-21 97 PLACE","d5fa079f-32f4-ea11-b882-24ee9a37d45c",-73861004,40734040,"P.S. 206 TRANSPORTABLE - Q","61-21 97 PLACE"
1,0,1,"369f4974-31f4-ea11-b882-24ee9a37d45c","Manhattan Charter School - M320 - M142 - 84M320 - 100 ATTORNEY STREET","379f4974-31f4-ea11-b882-24ee9a37d45c",-73984116,40718121,"P.S. 142 - MANHATTAN","100 ATTORNEY STREET"
1,1,0,"038b0044-33f4-ea11-b882-24ee9a37d45c","Cornerstone Academy for Social Action - X189 - X189 - 11X189 - 3441 STEENWICK AVENUE","018b0044-33f4-ea11-b882-24ee9a37d45c",-73830616,40882778,"P.S./I.S. 189 - BRONX","3441 STEENWICK AVENUE"
3,0,3,"7f283fb1-30f4-ea11-b882-24ee9a37d45c","P.S. 290 Juan Morel Campos - K290 - K290 - 19K290 - 135 Schenck Avenue","7e283fb1-30f4-ea11-b882-24ee9a37d45c",-73889375,40678182,"P.S. 290 - BROOKLYN","135 Schenck Avenue"
1,0,1,"1a9ebaee-32f4-ea11-b882-24ee9a37d45c","P.S. 008 Isaac Varian - X008 - X008 - 10X008 - 3010 BRIGGS AVENUE","1b9ebaee-32f4-ea11-b882-24ee9a37d45c",-73883339,40872259,"P.S. 8 - BRONX","3010 BRIGGS AVENUE"
1,0,1,"e2ce496e-31f4-ea11-b882-24ee9a37d45c","Success Academy Charter School - Harlem 5 - M482 - M123 - 84M482 - 301 WEST 140 STREET","e3ce496e-31f4-ea11-b882-24ee9a37d45c",-73944551,40820216,"P.S. 123 - MANHATTAN","301 WEST 140 STREET"
3,2,1,"fa77931f-33f4-ea11-b882-24ee9a37d45c","Academy For Personal Leadership And Excellence - X363 - X115 - 10X363 - 120 EAST 184 STREET","5b0d6d19-33f4-ea11-b882-24ee9a37d45c",-73900490,40859496,"I.S. 399 (OLD X HS/X115) - BRONX","120 EAST 184 STREET"
3,0,3,"f0883319-32f4-ea11-b882-24ee9a37d45c","P.S. 148 Queens - Q148 - Q148 - 30Q148 - 89-02 32 AVENUE","ef883319-32f4-ea11-b882-24ee9a37d45c",-73878638,40757629,"P.S. 148 - QUEENS","89-02 32 AVENUE"
1,0,1,"c9315367-30f4-ea11-b882-24ee9a37d45c","Northside Charter High School - K693 - K126 - 84K693 - 424 LEONARD STREET","c3315367-30f4-ea11-b882-24ee9a37d45c",-73947932,40719818,"J.H.S. 126 - BROOKLYN","424 LEONARD STREET"
1,1,0,"438dbfcf-30f4-ea11-b882-24ee9a37d45c","Life Academy High School for Film and Music - K559 - K400 - 21K559 - 2630 BENSON AVENUE","3a8dbfcf-30f4-ea11-b882-24ee9a37d45c",-73986313,40593028,"Lafayette Educational Campus","2630 BENSON AVENUE"
1,0,1,"6df297b3-dcfe-eb11-b8b2-24ee9a37d45c","Giggles of Bay Ridge - 1FL - KCOY - KCOY -  - 128 95 Street","6ef297b3-dcfe-eb11-b8b2-24ee9a37d45c",0,0,"128 95 Street","128 95 Street"
1,0,1,"56275a30-4afb-ea11-b883-24ee9a37d459","BROOKLYN CHINESE AMERICAN ASSOCIATION - KBMM - KBMM -  - 812 54TH STREET","57275a30-4afb-ea11-b883-24ee9a37d459",-74005822,0,"BROOKLYN CHINESE AMERICAN ASSOCIATION","812 54TH STREET"
1,1,0,"fbce496e-31f4-ea11-b882-24ee9a37d45c","P.S. 128 Audubon - M128 - M128 - 06M128 - 560 WEST 169 STREET","f9ce496e-31f4-ea11-b882-24ee9a37d45c",-73938701,40841032,"P.S. 128 - MANHATTAN","560 WEST 169 STREET"
1,1,0,"f5f22ce2-31f4-ea11-b882-24ee9a37d45c","The Emerson School - Q287 - Q008 - 28Q287 - 108-35 167 STREET","f1f22ce2-31f4-ea11-b882-24ee9a37d45c",-73786403,40696910,"J.H.S. 8 - QUEENS","108-35 167 STREET"
1,0,1,"2803cefa-32f4-ea11-b882-24ee9a37d45c","P.S. 046 Edgar Allan Poe - X046 - X046 - 10X046 - 2760 BRIGGS AVENUE","2703cefa-32f4-ea11-b882-24ee9a37d45c",-73890402,40867169,"P.S. 46 - BRONX","279 EAST 196 STREET"
1,0,1,"cc2ff20c-32f4-ea11-b882-24ee9a37d45c","The James J. Ambrose School - Q115 - Q115 - 26Q115 - 80-51 261 STREET","cd2ff20c-32f4-ea11-b882-24ee9a37d45c",-73709404,40744201,"The James J. Ambrose School","80-51 261 STREET"
2,1,1,"286e3d68-31f4-ea11-b882-24ee9a37d45c","P.S. 333 Manhattan School for Children - M333 - M118 - 03M333 - 154 WEST 93 STREET","246e3d68-31f4-ea11-b882-24ee9a37d45c",-73971011,40791395,"I.S. 118 - MANHATTAN","154 WEST 93 STREET"
4,3,1,"4f36d900-33f4-ea11-b882-24ee9a37d45c","P.S. 047 John Randolph - X047 - X047 - 12X047 - 1794 EAST 172 STREET","5036d900-33f4-ea11-b882-24ee9a37d45c",-73866974,40832529,"P.S. 47 - BRONX","1794 EAST 172 STREET"
1,1,0,"bb48b1f5-eaf6-ea11-b883-24ee9a37d459","School for Cooperative Technical Education - M645 - M646 - 79M645 - 321 East 96 Street","5e0c1bb1-31f4-ea11-b882-24ee9a37d45c",-73945647,40784112,"SCL COOP TECH ED (MNH VOC HS) - M","321 East 96 Street"
1,1,0,"bab36d80-30f4-ea11-b882-24ee9a37d45c","The SEEALL Academy - K180 - K180 - 20K180 - 5601 16 AVENUE","b8b36d80-30f4-ea11-b882-24ee9a37d45c",-73989250,40626454,"P.S. 180 - BROOKLYN","5601 16 AVENUE"
1,0,1,"668946f4-31f4-ea11-b882-24ee9a37d45c","P.S. 049 Dorothy Bonawit Kole - Q049 - Q049 - 24Q049 - 63-60 80th Street","678946f4-31f4-ea11-b882-24ee9a37d45c",-73875493,40719567,"P.S./I.S. 49 - QUEENS","63-60 80th Street"
1,1,0,"ad32c3fb-eaf6-ea11-b883-24ee9a37d459","P.S. Q993 - Q993 - Q191 - 75Q993 - 85-15 258 STREET","7b977d2b-32f4-ea11-b882-24ee9a37d45c",-73708617,40734266,"P.S. 191 - QUEENS","85-15 258 STREET"
1,0,1,"6f41e65b-31f4-ea11-b882-24ee9a37d45c","P.S. 075 Emily Dickinson - M075 - M075 - 03M075 - 735 WEST END AVENUE","6a41e65b-31f4-ea11-b882-24ee9a37d45c",-73973996,40795109,"P.S. 75 - MANHATTAN","735 WEST END AVENUE"
1,1,0,"70977d2b-32f4-ea11-b882-24ee9a37d45c","J.H.S. 189 Daniel Carter Beard - Q189 - Q189 - 25Q189 - 144-80 BARCLAY AVENUE","6b977d2b-32f4-ea11-b882-24ee9a37d45c",-73818399,40759963,"J.H.S. 189 - QUEENS","144-80 BARCLAY AVENUE"
1,0,1,"0fc0c20d-ecf6-ea11-b883-24ee9a37d459","P.S. 723 - X723 - X909 - 75X723 - 516 EAST TREMONT AVENUE","48ff3d8d-33f4-ea11-b882-24ee9a37d45c",-73896596,40846495,"Arthur Avenue Educational Building","516 EAST TREMONT AVENUE"
1,0,1,"9683ff9e-30f4-ea11-b882-24ee9a37d45c","P.S. 251 Paerdegat - K251 - K251 - 22K251 - 1037 EAST 54 STREET","8c83ff9e-30f4-ea11-b882-24ee9a37d45c",-73923894,40631950,"P.S. 251 - BROOKLYN","1037 EAST 54 STREET"
1,0,1,"dde0a4fb-ebf6-ea11-b883-24ee9a37d459","P.S. X010 - X010 - X234 - 75X010 - 2050 PROSPECT AVENUE","d4ab074a-33f4-ea11-b882-24ee9a37d45c",-73886721,40846128,"P.S. 234 (PAIRED W I129) - BRONX","2050 PROSPECT AVENUE"
1,0,1,"45474313-33f4-ea11-b882-24ee9a37d45c","Explorations Academy H.S. - X251 - X098 - 12X251 - 1619 BOSTON ROAD","3c474313-33f4-ea11-b882-24ee9a37d45c",-73890591,40836245,"I.S. 98 - BRONX","1619 BOSTON ROAD"
1,0,1,"fa8052e9-ebf6-ea11-b883-24ee9a37d459","P.S. 723 - X723 - X049 - 75X723 - 383 EAST 139 STREET","4d36d900-33f4-ea11-b882-24ee9a37d45c",-73922730,40810413,"P.S. 49 - BRONX","383 EAST 139 STREET"
1,0,1,"6f8d8486-31f4-ea11-b882-24ee9a37d45c","Harlem Village Academy West Charter School - M709 - M194 - 84M709 - 244 WEST 144 STREET","708d8486-31f4-ea11-b882-24ee9a37d45c",-73941111,40821208,"P.S. 194 - MANHATTAN","244 WEST 144 STREET"
1,0,1,"d90d3c5b-30f4-ea11-b882-24ee9a37d45c","P.S. 102 The Bayview - K102 - K102 - 20K102 - 211 72 STREET","da0d3c5b-30f4-ea11-b882-24ee9a37d45c",-74028758,40634318,"P.S. 102 - BROOKLYN","211 72 STREET"
1,0,1,"5e8946f4-31f4-ea11-b882-24ee9a37d45c","P.S. 046 Alley Pond - Q046 - Q046 - 26Q046 - 64-45 218 STREET","5f8946f4-31f4-ea11-b882-24ee9a37d45c",-73758042,40745744,"P.S. 46 - QUEENS","64-45 218 STREET"
1,0,1,"87cab8ee-48fb-ea11-b883-24ee9a37d459","MERCEDES VIDAL - FL1 - KDFI - KDFI -  - 1378 MADISON STREET","88cab8ee-48fb-ea11-b883-24ee9a37d459",-73910556,40697272,"1378 MADISON STREET","1378 MADISON STREET"
4,3,1,"a40e6e25-32f4-ea11-b882-24ee9a37d45c","Scholars' Academy - Q323 - Q180 - 27Q323 - 320 BEACH 104TH STREET","a50e6e25-32f4-ea11-b882-24ee9a37d45c",-73825162,40584543,"I.S. 323 (OLD IS 180) - QUEENS","320 BEACH 104TH STREET"
1,1,0,"410d6d19-33f4-ea11-b882-24ee9a37d45c","Mott Hall III - X128 - X110 - 09X128 - 580 CROTONA PARK SOUTH","420d6d19-33f4-ea11-b882-24ee9a37d45c",-73900654,40834470,"P.S. 110 - BRONX","580 CROTONA PARK SOUTH"
1,1,0,"18af1f69-ebf6-ea11-b883-24ee9a37d459","Special Music School - M859 - M490 - 03M859 - 122 AMSTERDAM AVENUE","7c07e99e-31f4-ea11-b882-24ee9a37d45c",-73985608,40774891,"MARTIN LUTHER KING, JR. HS - M","122 AMSTERDAM AVENUE"
5,5,0,"39474313-33f4-ea11-b882-24ee9a37d45c","P.S. 095 Sheila Mencher - X095 - X095 - 10X095 - 3961 HILLMAN AVENUE","34474313-33f4-ea11-b882-24ee9a37d45c",-73891664,40883049,"P.S. 95 - BRONX","3961 HILLMAN AVENUE"
2,0,2,"1c0b210d-33f4-ea11-b882-24ee9a37d45c","Bronx Academy for Multi-Media - X424 - X074 - 08X424 - 730 BRYANT AVENUE","f9d10307-33f4-ea11-b882-24ee9a37d45c",-73885284,40815827,"I.S. 201 - BRONX","730 BRYANT AVENUE"
2,1,1,"74a9d9c3-32f4-ea11-b882-24ee9a37d45c","P.S. 026 The Carteret School - R026 - R026 - 31R026 - 4108 VICTORY BOULEVARD","75a9d9c3-32f4-ea11-b882-24ee9a37d45c",-74190093,40591546,"P.S. 26 - STATEN ISLAND","4108 VICTORY BOULEVARD"
1,0,1,"ab48b1f5-eaf6-ea11-b883-24ee9a37d459","P.S. M169 - Robert F. Kennedy - M169 - M169 - 75M169 - 110 East 88 Street","34005d7a-31f4-ea11-b882-24ee9a37d45c",-73955594,40780798,"P.S. 169 (ECF) - MANHATTAN","110 East 88 Street"
3,2,1,"100410ca-32f4-ea11-b882-24ee9a37d45c","P.S. 042 Eltingville - R042 - R042 - 31R042 - 380 GENESEE AVENUE","110410ca-32f4-ea11-b882-24ee9a37d45c",-74169038,40552213,"P.S. 42 - STATEN ISLAND","380 GENESEE AVENUE"
1,1,0,"38c73b4a-32f4-ea11-b882-24ee9a37d45c","Corona Arts & Sciences Academy - Q311 - Q311 - 24Q311 - 98-11 44TH AVENUE","36c73b4a-32f4-ea11-b882-24ee9a37d45c",-73865239,40745920,"P.S./ I.S. 311 - QUEENS","98-11 44TH AVENUE"
1,0,1,"17af1f69-ebf6-ea11-b883-24ee9a37d459","P.S. M169 - Robert F. Kennedy - M169 - M488 - 75M169 - 231-249 EAST 56 STREET","6d07e99e-31f4-ea11-b882-24ee9a37d45c",-73967204,40759248,"MIDTOWN EAST CAMPUS - MANHATTAN","231-249 EAST 56 STREET"
1,0,1,"c885f462-ebf6-ea11-b883-24ee9a37d459","P.S. M169 - Robert F. Kennedy - M169 - M146 - 75M169 - 421 EAST 106 STREET","4f9f4974-31f4-ea11-b882-24ee9a37d45c",-73938727,40789535,"P.S. 146 - MANHATTAN","421 EAST 106 STREET"
1,0,1,"d6968d36-30f4-ea11-b882-24ee9a37d45c","Brooklyn Arbor Elementary School - K414 - K019 - 14K414 - 325 SOUTH 3 STREET","d7968d36-30f4-ea11-b882-24ee9a37d45c",-73954678,40710107,"P.S. 19 - BROOKLYN","325 SOUTH 3 STREET"
1,1,0,"c08442ee-31f4-ea11-b882-24ee9a37d45c","P.S. 029 Queens - Q029 - Q029 - 25Q029 - 125-10 23 AVENUE","c18442ee-31f4-ea11-b882-24ee9a37d45c",-73842967,40778029,"P.S. 29 - QUEENS","125-10 23 AVENUE"
1,0,1,"5ade5eb7-30f4-ea11-b882-24ee9a37d45c","P.S. 306 Ethan Allen - K306 - K306 - 19K306 - 970 VERMONT STREET","59de5eb7-30f4-ea11-b882-24ee9a37d45c",-73886620,40655340,"P.S. 306 - BROOKLYN","970 VERMONT STREET"
1,0,1,"68507380-31f4-ea11-b882-24ee9a37d45c","P.S. 452 - M452 - M191 - 03M452 - 210 WEST 61 STREET","69507380-31f4-ea11-b882-24ee9a37d45c",-73987515,40771603,"P.S. 191 - MANHATTAN","210 WEST 61 STREET"
1,1,0,"9c51be13-ecf6-ea11-b883-24ee9a37d459","P.S. 723 - X723 - XAHW - 75X723 - 595 GERARD AVENUE","3bb205ac-33f4-ea11-b882-24ee9a37d45c",-73929008,40820861,"BRONX CHILDRENS PSYC CENTER","595 GERARD AVENUE"
1,1,0,"bb3aa668-33f4-ea11-b882-24ee9a37d45c","Bronx High School for Law and Community Service - X439 - X435 - 10X439 - 500 EAST FORDHAM ROAD","b03aa668-33f4-ea11-b882-24ee9a37d45c",-73888625,40859466,"THEODORE ROOSEVELT EDUCATIONAL CAMPUS - X","500 EAST FORDHAM ROAD"
1,0,1,"89d810ab-31f4-ea11-b882-24ee9a37d45c","Urban Assembly School of Design and Construction, The - M300 - M535 - 02M300 - 525 WEST 50TH STREET","f137fba4-31f4-ea11-b882-24ee9a37d45c",-73992700,40765474,"PARK WEST HS (ECF) - MANHATTAN","525 WEST 50TH STREET"
2,0,2,"e417b7f4-32f4-ea11-b882-24ee9a37d45c","Bronx Writing Academy - X323 - X022 - 09X323 - 270 EAST 167 STREET","de17b7f4-32f4-ea11-b882-24ee9a37d45c",-73914350,40832022,"I.S. 22 - BRONX","270 EAST 167 STREET"
1,0,1,"1b78931f-33f4-ea11-b882-24ee9a37d45c","P.S. 121 Throop - X121 - X121 - 11X121 - 2750 THROOP AVENUE","1c78931f-33f4-ea11-b882-24ee9a37d45c",-73850510,40866474,"P.S. 121 - BRONX","2750 THROOP AVENUE"
1,1,0,"2fa198c3-30f4-ea11-b882-24ee9a37d45c","Frederick Douglass Academy VIII Middle School - K452 - K346 - 19K452 - 1400 PENNSYLVANIA AVENUE","30a198c3-30f4-ea11-b882-24ee9a37d45c",-73881997,40646640,"P.S. 346 - BROOKLYN","1400 PENNSYLVANIA AVENUE"
1,1,0,"82283fb1-30f4-ea11-b882-24ee9a37d45c","Bushwick Community High School - K564 - K291 - 32K564 - 231 PALMETTO STREET","83283fb1-30f4-ea11-b882-24ee9a37d45c",-73915217,40695875,"I.S. 291 - BROOKLYN","231 PALMETTO STREET"
1,0,1,"493cbf01-ebf6-ea11-b883-24ee9a37d459","P.S. Q023 @ Queens Children Center - Q023 - QAPM - 75Q023 - 74-03 COMMONWEALTH BOULEVARD","419215a5-32f4-ea11-b882-24ee9a37d45c",-73723644,40747914,"Queens Children's Center","74-03 COMMONWEALTH BOULEVARD"
3,2,1,"3e02fdd0-ebf6-ea11-b883-24ee9a37d459","The Michael J. Petrides School - R080 - R010 - 31R080 - 715 OCEAN TERRACE","4bfdc1bd-32f4-ea11-b882-24ee9a37d45c",-74105883,40607637,"P.S. 80 (PETRIDES COMPLEX) AF - STATEN ISLAND","715 OCEAN TERRACE"
1,1,0,"2d7eed06-32f4-ea11-b882-24ee9a37d45c","P.S. 096 - Q096 - Q096 - 27Q096 - 130-01 ROCKAWAY BOULEVARD","2e7eed06-32f4-ea11-b882-24ee9a37d45c",-73808128,40675369,"P.S. 96 - QUEENS","130-01 ROCKAWAY BOULEVARD"
1,0,1,"858d8486-31f4-ea11-b882-24ee9a37d45c","P.S. 199 Jessie Isador Straus - M199 - M199 - 03M199 - 270 WEST 70 STREET","868d8486-31f4-ea11-b882-24ee9a37d45c",-73984423,40777603,"P.S. 199 - MANHATTAN","270 WEST 70 STREET"
2,2,0,"f8454b50-32f4-ea11-b882-24ee9a37d45c","P.S. 377 - Q377 - Q335 - 27Q377 - 150-15 RALEIGH STREET","f4454b50-32f4-ea11-b882-24ee9a37d45c",-73836850,40668083,"Centreville Educational Building","150-15 RALEIGH STREET"
1,0,1,"a327ba50-ebf6-ea11-b883-24ee9a37d459","P.S. K721 - Brooklyn Occupational Training Center - K721 - KBSQ - 75K721 - 585 SCHENECTADY AVENUE","9cd91731-31f4-ea11-b882-24ee9a37d45c",-73933800,40659576,"KINGSBROOK JEWISH","585 SCHENECTADY AVENUE"
4,2,2,"74f4a0ef-eaf6-ea11-b883-24ee9a37d459","P.S. 370 - K370 - K370 - 75K370 - 3000 WEST 1 STREET","0be2abc9-30f4-ea11-b882-24ee9a37d45c",-73969872,40577709,"P.S. 370 - BROOKLYN","3000 WEST 1 STREET"
1,0,1,"1203cefa-32f4-ea11-b882-24ee9a37d45c","P.S. 041 Gun Hill Road - X041 - X041 - 11X041 - 3352 OLINVILLE AVENUE","1303cefa-32f4-ea11-b882-24ee9a37d45c",-73867834,40874754,"P.S. 41 - BRONX","3352 OLINVILLE AVENUE"
2,0,2,"0ee2abc9-30f4-ea11-b882-24ee9a37d45c","P.S. 371 - Lillian L. Rashkis - K371 - K371 - 75K371 - 355 37 STREET","0de2abc9-30f4-ea11-b882-24ee9a37d45c",-74005168,40654306,"P.S. 371 (OLD 615) - BROOKLYN","355 37 STREET"
3,0,3,"f3a2f813-ebf6-ea11-b883-24ee9a37d459","P.S. 370 - K370 - K100 - 75K370 - 2951 WEST 3 STREET","ca0d3c5b-30f4-ea11-b882-24ee9a37d45c",-73970830,40577591,"P.S. 100 - BROOKLYN","2951 WEST 3 STREET"
1,0,1,"4a005d7a-31f4-ea11-b882-24ee9a37d45c","Success Academy Charter School - Harlem 5 - M482 - M175 - 84M482 - 175 WEST 134 STREET","47005d7a-31f4-ea11-b882-24ee9a37d45c",-73942706,40814388,"P.S. 175 - MANHATTAN","175 WEST 134 STREET"
2,0,2,"57ebaa73-30f4-ea11-b882-24ee9a37d45c","Ralph A. Fabrizio School - K170 - K170 - 20K170 - 619 72ND STREET","58ebaa73-30f4-ea11-b882-24ee9a37d45c",-74018719,40630373,"P.S. 170 - BROOKLYN","619 72ND STREET"
2,2,0,"7201ce37-33f4-ea11-b882-24ee9a37d45c","P.S. 154 Jonathan D. Hyatt - X154 - X154 - 07X154 - 333 EAST 135 STREET","7101ce37-33f4-ea11-b882-24ee9a37d45c",-73925459,40808194,"P.S. 154 - BRONX","333 EAST 135 STREET"
2,2,0,"0ffc3df4-30f4-ea11-b882-24ee9a37d45c","All City Leadership Secondary School - K554 - K554 - 32K554 - 321 Palmetto Street","10fc3df4-30f4-ea11-b882-24ee9a37d45c",-73913172,40697378,"ALL CITY LEADERSHIP SECONDARY SCHOOL - BROOKLYN","321 Palmetto Street"
1,0,1,"c9c88e4f-31f4-ea11-b882-24ee9a37d45c","Harlem Village Academy East Charter School - M335 - M045 - 84M335 - 2351 FIRST AVENUE","c6c88e4f-31f4-ea11-b882-24ee9a37d45c",-73933740,40799265,"I.S. 45 - MANHATTAN","2351 FIRST AVENUE"
1,0,1,"b256635c-33f4-ea11-b882-24ee9a37d45c","Bronx Regional High School - X480 - X401 - 12X480 - 1010 REV. J. A. POLITE AVENUE","8ce03d56-33f4-ea11-b882-24ee9a37d45c",-73898265,40823124,"BRONX REGIONAL HS (OLD 133) - X","1010 REV. J. A. POLITE AVENUE"
4,3,1,"f717b7f4-32f4-ea11-b882-24ee9a37d45c","M.S. 390 - X390 - X026 - 10X390 - 1930 ANDREWS AVENUE","e917b7f4-32f4-ea11-b882-24ee9a37d45c",-73913016,40854335,"P.S. 396 - BRONX","1930 ANDREWS AVENUE"
6,6,0,"64bc9674-32f4-ea11-b882-24ee9a37d45c","Richmond Hill High School - Q475 - Q475 - 27Q475 - 89-30 114 Street","3002926e-32f4-ea11-b882-24ee9a37d45c",-73833815,40695171,"RICHMOND HILL HS - Q","89-30 114 Street"
1,0,1,"4d29a44a-ebf6-ea11-b883-24ee9a37d459","P.S. 370 - K370 - K807 - 75K370 - 109 BAY 14TH STREET","9b28a20c-31f4-ea11-b882-24ee9a37d45c",-74007469,40606739,"P.S./ I.S. 163 - BROOKLYN","109 BAY 14TH STREET"
1,0,1,"19e63126-ebf6-ea11-b883-24ee9a37d459","P.S. 370 - K370 - K237 - 75K370 - 50 AVENUE P","5fa5db98-30f4-ea11-b882-24ee9a37d45c",-73986678,40606994,"LUCRETIA MARCIGLIANO CAMPUS - K","50 AVENUE P"
6,5,1,"f421d292-30f4-ea11-b882-24ee9a37d45c","P.S. 229 Dyker - K229 - K229 - 20K229 - 1400 BENSON AVENUE","f521d292-30f4-ea11-b882-24ee9a37d45c",-74013585,40610331,"P.S. 229 - BROOKLYN","1400 BENSON AVENUE"
1,0,1,"897e21a6-ebf6-ea11-b883-24ee9a37d459","The Riverview School - Q277 - Q290 - 75Q277 - 55-20 METROPOLITAN AVENUE","24c73b4a-32f4-ea11-b882-24ee9a37d45c",-73908307,40713030,"THE GERALDINE FERRARO CAMPUS - QUEENS","55-20 METROPOLITAN AVENUE"
1,1,0,"3370f999-ebf6-ea11-b883-24ee9a37d459","The Riverview School - Q277 - Q204 - 75Q277 - 36-41 28 STREET","9c69c231-32f4-ea11-b882-24ee9a37d45c",-73932628,40756471,"I.S. 204 - QUEENS","36-41 28 STREET"
2,1,1,"e8c1392a-30f4-ea11-b882-24ee9a37d45c","Explore Charter School - K704 - K002 - 84K704 - 655 Parkside Avenue","dfc1392a-30f4-ea11-b882-24ee9a37d45c",-73951575,40656423,"I.S. 2 - BROOKLYN","655 Parkside Avenue"
1,0,1,"60fdc1bd-32f4-ea11-b882-24ee9a37d45c","P.S. 019 The Curtis School - R019 - R019 - 31R019 - 780 Post Avenue","61fdc1bd-32f4-ea11-b882-24ee9a37d45c",-74126851,40630563,"P.S. 19 - STATEN ISLAND","780 Post Avenue"
3,3,0,"7601ce37-33f4-ea11-b882-24ee9a37d45c","Academic Leadership Charter School - X491 - X155 - 84X491 - 470 JACKSON AVENUE","7701ce37-33f4-ea11-b882-24ee9a37d45c",-73909363,40811051,"P.S. 754 (OLD IS155) - BRONX","470 JACKSON AVENUE"
1,1,0,"c9689025-33f4-ea11-b882-24ee9a37d45c","J.H.S. 131 Albert Einstein - X131 - X131 - 08X131 - 885 Bolton Avenue","c8689025-33f4-ea11-b882-24ee9a37d45c",-73859998,40822925,"I.S. 131 - BRONX","885 Bolton Avenue"
1,1,0,"df8fd20d-ebf6-ea11-b883-24ee9a37d459","P.S. K140 - K140 - K026 - 75K140 - 1014 LAFAYETTE AVENUE","f2968d36-30f4-ea11-b882-24ee9a37d45c",-73931700,40692100,"P.S. 26 - BROOKLYN","1014 LAFAYETTE AVENUE"
