"TotalCases","StudentCases","EmployeeCases","nycsr_locationsiteid","nycsr_sitename","nycsr_building.nycsr_buildingid","nycsr_building.nycsr_longitude","nycsr_building.nycsr_latitude","nycsr_building.nycsr_buildingname","nycsr_building.nycsr_address"
6,6,0,"555b4cd6-32f4-ea11-b882-24ee9a37d45c","Port Richmond High School - R445 - R445 - 31R445 - 85 ST JOSEPHS AVENUE","515b4cd6-32f4-ea11-b882-24ee9a37d45c",-74141924,40635562,"PORT RICHMOND HS - S. I.","85 ST JOSEPHS AVENUE"
3,2,1,"a153dd74-33f4-ea11-b882-24ee9a37d45c","New Visions Charter High School for Advanced Math and Science - X539 - X475 - 84X539 - 99 TERRACE VIEW AVENUE","9853dd74-33f4-ea11-b882-24ee9a37d45c",-73912686,40877379,"JOHN F. KENNEDY HS - X","99 TERRACE VIEW AVENUE"
3,3,0,"7b283fb1-30f4-ea11-b882-24ee9a37d45c","P.S. 289 George V. Brower - K289 - K289 - 17K289 - 900 ST MARKS AVENUE","77283fb1-30f4-ea11-b882-24ee9a37d45c",-73942401,40674244,"P.S. 289 - BROOKLYN","900 ST MARKS AVENUE"
2,1,1,"29e61462-31f4-ea11-b882-24ee9a37d45c","P.S. 89 - M089 - M089 - 02M089 - 201 WARREN STREET","9741e65b-31f4-ea11-b882-24ee9a37d45c",-74013967,40717010,"P.S./I.S. 89 - MANHATTAN","201 WARREN STREET"
1,0,1,"d1d10307-33f4-ea11-b882-24ee9a37d45c","P.S. 063 Author's Academy - X063 - X063 - 09X063 - 1260 FRANKLIN AVENUE","8736d900-33f4-ea11-b882-24ee9a37d45c",-73901859,40830930,"P.S. 63 - BRONX","1260 FRANKLIN AVENUE"
2,2,0,"f721d292-30f4-ea11-b882-24ee9a37d45c","P.S. 230 Doris L. Cohen - K230 - K230 - 15K230 - 1 ALBEMARLE ROAD","f321d292-30f4-ea11-b882-24ee9a37d45c",-73980515,40645609,"P.S. 230 - BROOKLYN","1 ALBEMARLE ROAD"
2,1,1,"6c41e65b-31f4-ea11-b882-24ee9a37d45c","The Lexington Academy - M072 - M072 - 04M072 - 131 EAST 104 STREET","6d41e65b-31f4-ea11-b882-24ee9a37d45c",-73947450,40791444,"P.S. 72 - MANHATTAN","131 EAST 104 STREET"
7,6,1,"46b4977a-32f4-ea11-b882-24ee9a37d45c","Aviation Career & Technical Education High School - Q610 - Q610 - 24Q610 - 45-30 36 STREET","44b4977a-32f4-ea11-b882-24ee9a37d45c",-73929577,40743309,"AVIATION HS - Q","45-30 36 STREET"
3,0,3,"cab36d80-30f4-ea11-b882-24ee9a37d45c","P.S. 184 Newport - K184 - K184 - 23K184 - 273 NEWPORT STREET","c8b36d80-30f4-ea11-b882-24ee9a37d45c",-73905004,40660385,"P.S. 184 - BROOKLYN","273 NEWPORT STREET"
3,2,1,"bf315367-30f4-ea11-b882-24ee9a37d45c","P.S. 123 Suydam - K123 - K123 - 32K123 - 100 IRVING AVENUE","bb315367-30f4-ea11-b882-24ee9a37d45c",-73922388,40704076,"P.S. 123 - BROOKLYN","100 IRVING AVENUE"
6,2,4,"8603194f-30f4-ea11-b882-24ee9a37d45c","Brooklyn Landmark Elementary School - K599 - K073 - 23K599 - 251 MAC DOUGAL STREET","8503194f-30f4-ea11-b882-24ee9a37d45c",-73910719,40680679,"P.S. 73 - BROOKLYN","251 MAC DOUGAL STREET"
1,0,1,"0fcf496e-31f4-ea11-b882-24ee9a37d45c","P.S. 132 Juan Pablo Duarte - M132 - M132 - 06M132 - 185 WADSWORTH AVENUE","10cf496e-31f4-ea11-b882-24ee9a37d45c",-73933964,40850561,"P.S. 132 - MANHATTAN","185 WADSWORTH AVENUE"
1,1,0,"3c9f4974-31f4-ea11-b882-24ee9a37d45c","P.S. 142 Amalia Castro - M142 - M142 - 01M142 - 100 ATTORNEY STREET","379f4974-31f4-ea11-b882-24ee9a37d45c",-73984116,40718121,"P.S. 142 - MANHATTAN","100 ATTORNEY STREET"
3,1,2,"1fa198c3-30f4-ea11-b882-24ee9a37d45c","Sunset Park Avenues Elementary School - K516 - K333 - 15K516 - 4222 4th Avenue","20a198c3-30f4-ea11-b882-24ee9a37d45c",-74008106,40650793,"P.S. 516 SUNSET PARK AVENUES ELEMENTARY SCHOOL - B","4222 4th Avenue"
3,3,0,"ad9c11e8-30f4-ea11-b882-24ee9a37d45c","High School for Public Service: Heroes of Tomorrow - K546 - K470 - 17K546 - 600 KINGSTON AVENUE","aa9c11e8-30f4-ea11-b882-24ee9a37d45c",-73943839,40658671,"GEORGE W. WINGATE HS - K","600 KINGSTON AVENUE"
6,3,3,"be689025-33f4-ea11-b882-24ee9a37d45c","Kappa III - X316 - X129 - 12X316 - 2055 MAPES AVENUE","bf689025-33f4-ea11-b882-24ee9a37d45c",-73886721,40846128,"I.S. 129 (PAIRED W P234) - BRONX","2055 MAPES AVENUE"
4,3,1,"13ba8b86-30f4-ea11-b882-24ee9a37d45c","P.S. 206 Joseph F Lamb - K206 - K206 - 22K206 - 2200 GRAVESEND NECK ROAD","14ba8b86-30f4-ea11-b882-24ee9a37d45c",-73948453,40596876,"P.S. 206 - BROOKLYN","2200 GRAVESEND NECK ROAD"
1,0,1,"369ebaee-32f4-ea11-b882-24ee9a37d45c","P.S. 018 John Peter Zenger - X018 - X018 - 07X018 - 502 MORRIS AVENUE","379ebaee-32f4-ea11-b882-24ee9a37d45c",-73922697,40816369,"P.S. 18 - BRONX","502 MORRIS AVENUE"
1,0,1,"fc1aad3c-30f4-ea11-b882-24ee9a37d45c","P.S. K141 - K141 - K035 - 75K141 - 272 Macdonough Street","fd1aad3c-30f4-ea11-b882-24ee9a37d45c",-73935891,40681528,"I.S. 35 - BROOKLYN","272 Macdonough Street"
1,0,1,"1703cefa-32f4-ea11-b882-24ee9a37d45c","P.S. 043 Jonas Bronck - X043 - X043 - 07X043 - 165 BROWN PLACE","1803cefa-32f4-ea11-b882-24ee9a37d45c",-73921593,40806452,"P.S. 43 - BRONX","165 BROWN PLACE"
2,0,2,"e6c1392a-30f4-ea11-b882-24ee9a37d45c","P.S. K141 - K141 - K002 - 75K141 - 655 Parkside Avenue","dfc1392a-30f4-ea11-b882-24ee9a37d45c",-73951575,40656423,"I.S. 2 - BROOKLYN","655 Parkside Avenue"
1,1,0,"d1d27c6d-30f4-ea11-b882-24ee9a37d45c","The Brooklyn New School, P.S. 146 - K146 - K142 - 15K146 - 610 HENRY STREET","cfd27c6d-30f4-ea11-b882-24ee9a37d45c",-74002022,40679462,"J.H.S. 142 - BROOKLYN","610 HENRY STREET"
3,2,1,"fd8052e9-ebf6-ea11-b883-24ee9a37d459","Mott Hall Charter School - X177 - X063 - 84X177 - 1260 FRANKLIN AVENUE","8736d900-33f4-ea11-b882-24ee9a37d45c",-73901859,40830930,"P.S. 63 - BRONX","1260 FRANKLIN AVENUE"
5,5,0,"75d92255-30f4-ea11-b882-24ee9a37d45c","J.H.S. 088 Peter Rouget - K088 - K088 - 15K088 - 544 7TH AVENUE","76d92255-30f4-ea11-b882-24ee9a37d45c",-73988743,40660805,"I.S. 88 - BROOKLYN","544 7TH AVENUE"
1,1,0,"aa72c880-32f4-ea11-b882-24ee9a37d45c","High School for Law Enforcement and Public Safety - Q690 - Q690 - 28Q690 - 116-25 GUY R BREWER BOULEVARD","a972c880-32f4-ea11-b882-24ee9a37d45c",-73783438,40685838,"HS FOR LAW ENFORCEMENT - QUEENS","116-25 GUY R BREWER BOULEVARD"
4,3,1,"60b50aa5-30f4-ea11-b882-24ee9a37d45c","J.H.S. 259 William McKinley - K259 - K259 - 20K259 - 7305 Ft Hamilton Parkway","61b50aa5-30f4-ea11-b882-24ee9a37d45c",-74014633,40626089,"I.S. 259 - BROOKLYN","7305 Ft Hamilton Parkway"
1,0,1,"cc0d3c5b-30f4-ea11-b882-24ee9a37d45c","P.S. 97 The Highlawn - K097 - K097 - 21K097 - 1846 West 13 Street","cd0d3c5b-30f4-ea11-b882-24ee9a37d45c",-73985570,40601191,"P.S. 97 - BROOKLYN","1846 West 13 Street"
1,1,0,"0e03cefa-32f4-ea11-b882-24ee9a37d45c","Young Leaders Elementary School - X369 - X040 - 07X369 - 468 EAST 140 STREET","0b03cefa-32f4-ea11-b882-24ee9a37d45c",-73919773,40809080,"P.S. 220 - BRONX","468 EAST 140 STREET"
1,0,1,"5236d900-33f4-ea11-b882-24ee9a37d45c","P.S. 048 Joseph R. Drake - X048 - X048 - 08X048 - 1290 SPOFFORD AVENUE","5336d900-33f4-ea11-b882-24ee9a37d45c",-73886834,40814034,"P.S. 48 - BRONX","1290 SPOFFORD AVENUE"
1,1,0,"c7315367-30f4-ea11-b882-24ee9a37d45c","John Ericsson Middle School 126 - K126 - K126 - 14K126 - 424 LEONARD STREET","c3315367-30f4-ea11-b882-24ee9a37d45c",-73947932,40719818,"J.H.S. 126 - BROOKLYN","424 LEONARD STREET"
1,0,1,"b82ff20c-32f4-ea11-b882-24ee9a37d45c","P.S. 108 Captain Vincent G. Fowler - Q108 - Q108 - 27Q108 - 108-10 109 AVENUE","b92ff20c-32f4-ea11-b882-24ee9a37d45c",-73831025,40679083,"P.S. 108 - QUEENS","108-10 109 AVENUE"
1,1,0,"141bad3c-30f4-ea11-b882-24ee9a37d45c","I.S. 98 Bay Academy - K098 - K043 - 21K098 - 1401 EMMONS AVENUE","151bad3c-30f4-ea11-b882-24ee9a37d45c",-73954047,40583893,"I.S. 98 - BROOKLYN","1401 EMMONS AVENUE"
2,0,2,"cb689025-33f4-ea11-b882-24ee9a37d45c","Soundview Academy for Culture and Scholarship - X448 - X131 - 08X448 - 885 Bolton Avenue","c8689025-33f4-ea11-b882-24ee9a37d45c",-73859998,40822925,"I.S. 131 - BRONX","885 Bolton Avenue"
1,0,1,"6f283fb1-30f4-ea11-b882-24ee9a37d45c","I.S. 285 Meyer Levin - K285 - K285 - 18K285 - 5909 BEVERLY ROAD","70283fb1-30f4-ea11-b882-24ee9a37d45c",-73920784,40647818,"I.S. 285 - BROOKLYN","5909 BEVERLY ROAD"
7,2,5,"e292e6d5-30f4-ea11-b882-24ee9a37d45c","James Madison High School - K425 - K425 - 22K425 - 3787 BEDFORD AVENUE","e092e6d5-30f4-ea11-b882-24ee9a37d45c",-73947661,40610499,"JAMES MADISON HS - K","3787 BEDFORD AVENUE"
1,1,0,"310410ca-32f4-ea11-b882-24ee9a37d45c","P.S. 052 John C. Thompson - R052 - R052 - 31R052 - 450 BUEL AVENUE","320410ca-32f4-ea11-b882-24ee9a37d45c",-74089012,40582550,"P.S. 52 - STATEN ISLAND","450 BUEL AVENUE"
2,1,1,"410b210d-33f4-ea11-b882-24ee9a37d45c","P.S. 081 Robert J. Christen - X081 - X081 - 10X081 - 5550 RIVERDALE AVENUE","420b210d-33f4-ea11-b882-24ee9a37d45c",-73904657,40903275,"P.S. 81 - BRONX","5550 RIVERDALE AVENUE"
1,0,1,"8d593c87-33f4-ea11-b882-24ee9a37d45c","P.S. 048 Joseph R. Drake - X048 - X848 - 08X048 - 659 COSTER STREET","8e593c87-33f4-ea11-b882-24ee9a37d45c",-73887579,40813637,"P.S. 48 AX (HNTS PNT ECC1)-BRONX","659 COSTER STREET"
2,2,0,"43fdc1bd-32f4-ea11-b882-24ee9a37d45c","I.S. 007 Elias Bernstein - R007 - R007 - 31R007 - 1270 Huguenot Avenue","447c21b7-32f4-ea11-b882-24ee9a37d45c",-74186096,40522971,"I.S. 7 - STATEN ISLAND","1270 Huguenot Avenue"
1,0,1,"d9d27c6d-30f4-ea11-b882-24ee9a37d45c","P.S. 147 Isaac Remsen - K147 - K147 - 14K147 - 325 BUSHWICK AVENUE","d4d27c6d-30f4-ea11-b882-24ee9a37d45c",-73938790,40705005,"P.S. 147 - BROOKLYN","325 BUSHWICK AVENUE"
6,1,5,"43de5eb7-30f4-ea11-b882-24ee9a37d45c","P.S. 299 Thomas Warren Field - K299 - K299 - 32K299 - 88 WOODBINE STREET","44de5eb7-30f4-ea11-b882-24ee9a37d45c",-73917899,40690755,"P.S. 299 - BROOKLYN","88 WOODBINE STREET"
1,1,0,"429f4974-31f4-ea11-b882-24ee9a37d45c","Washington Heights Expeditionary Learning School - M348 - M143 - 06M348 - 511 WEST 182ND STREET","3f9f4974-31f4-ea11-b882-24ee9a37d45c",-73930991,40849311,"I.S. 143 - MANHATTAN","511 WEST 182ND STREET"
1,1,0,"55a5db98-30f4-ea11-b882-24ee9a37d45c","J.H.S. 234 Arthur W. Cunningham - K234 - K234 - 22K234 - 1875 EAST 17 STREET","56a5db98-30f4-ea11-b882-24ee9a37d45c",-73955217,40604447,"I.S. 234 - BROOKLYN","1875 EAST 17 STREET"
14,12,2,"5d07e99e-31f4-ea11-b882-24ee9a37d45c","Stuyvesant High School - M475 - M477 - 02M475 - 345 CHAMBERS STREET","5c07e99e-31f4-ea11-b882-24ee9a37d45c",-74013921,40718025,"STUYVESANT HS (NEW) - MANHATTAN","345 CHAMBERS STREET"
3,1,2,"d90d3c5b-30f4-ea11-b882-24ee9a37d45c","P.S. 102 The Bayview - K102 - K102 - 20K102 - 211 72 STREET","da0d3c5b-30f4-ea11-b882-24ee9a37d45c",-74028758,40634318,"P.S. 102 - BROOKLYN","211 72 STREET"
1,0,1,"f6d0de79-30f4-ea11-b882-24ee9a37d45c","I.S. 171 Abraham Lincoln - K171 - K171 - 19K171 - 528 RIDGEWOOD AVENUE","53ebaa73-30f4-ea11-b882-24ee9a37d45c",-73869434,40685852,"I.S. 171 - BROOKLYN","528 RIDGEWOOD AVENUE"
3,2,1,"9083ff9e-30f4-ea11-b882-24ee9a37d45c","P.S. 249 The Caton - K249 - K249 - 17K249 - 18 MARLBOROUGH ROAD","9183ff9e-30f4-ea11-b882-24ee9a37d45c",-73966456,40649509,"P.S. 249 - BROOKLYN","18 MARLBOROUGH ROAD"
5,5,0,"b03fce93-7c88-ec11-b8d0-24ee9a37d45c","Academy of American Studies - Q575 - Q575 - 30Q575 - 40-11 28th Street","b13fce93-7c88-ec11-b8d0-24ee9a37d45c",-73936596,40751839,"ACADEMY OF AMERICAN STUDIES - QUEENS","40-11 28th Street"
7,4,3,"9b476368-32f4-ea11-b882-24ee9a37d45c","Veritas Academy - Q240 - Q460 - 25Q240 - 35-01 UNION STREET","97476368-32f4-ea11-b882-24ee9a37d45c",-73826811,40764892,"FLUSHING HS - Q","35-01 UNION STREET"
1,1,0,"9672c880-32f4-ea11-b882-24ee9a37d45c","High School for Construction Trades, Engineering and Architecture - Q650 - Q650 - 27Q650 - 94-06 104TH STREET","8f72c880-32f4-ea11-b882-24ee9a37d45c",-73841475,40689177,"HS FOR CONST.TRADES,ENGG.,& ARCH-Q","94-06 104TH STREET"
1,0,1,"5b5b4cd6-32f4-ea11-b882-24ee9a37d45c","Curtis High School - R450 - R450 - 31R450 - 105 HAMILTON AVENUE","5a5b4cd6-32f4-ea11-b882-24ee9a37d45c",-74082149,40645436,"CURTIS HS - S. I.","105 HAMILTON AVENUE"
1,0,1,"8c977d2b-32f4-ea11-b882-24ee9a37d45c","P.S. 195 William Haberle - Q195 - Q195 - 29Q195 - 253-50 149 Avenue","8d977d2b-32f4-ea11-b882-24ee9a37d45c",-73735618,40652641,"P.S. 195 - QUEENS","253-50 149 Avenue"
1,1,0,"237eed06-32f4-ea11-b882-24ee9a37d45c","I.S. 093 Ridgewood - Q093 - Q093 - 24Q093 - 66-56 FOREST AVENUE","0f7eed06-32f4-ea11-b882-24ee9a37d45c",-73903057,40705609,"I.S. 93 - QUEENS","66-56 FOREST AVENUE"
6,6,0,"fcae0313-32f4-ea11-b882-24ee9a37d45c","I.S. 125 Thom J. McCann Woodside - Q125 - Q125 - 24Q125 - 46-02 47 AVENUE","fdae0313-32f4-ea11-b882-24ee9a37d45c",-73918762,40740452,"I.S. 125 - QUEENS","46-02 47 AVENUE"
3,0,3,"07f32ce2-31f4-ea11-b882-24ee9a37d45c","P.S. 014 Fairview - Q014 - Q014 - 24Q014 - 107-01 OTIS AVENUE","faf22ce2-31f4-ea11-b882-24ee9a37d45c",-73854570,40741020,"P.S. 14 - QUEENS","107-01 OTIS AVENUE"
2,1,1,"cee0838c-31f4-ea11-b882-24ee9a37d45c","The River School - M281 - M281 - 02M281 - 425 East 35 Street","cde0838c-31f4-ea11-b882-24ee9a37d45c",-73972592,40744288,"P.S. 281 - MANHATTAN","425 East 35 Street"
1,0,1,"0c78931f-33f4-ea11-b882-24ee9a37d45c","J.H.S. 118 William W. Niles - X118 - X118 - 10X118 - 577 EAST 179 STREET","0b78931f-33f4-ea11-b882-24ee9a37d45c",-73892482,40848702,"I.S. 118 - BRONX","577 EAST 179 STREET"
2,2,0,"63fdc1bd-32f4-ea11-b882-24ee9a37d45c","P.S. 020 Port Richmond - R020 - R020 - 31R020 - 161 PARK AVENUE","64fdc1bd-32f4-ea11-b882-24ee9a37d45c",-74132382,40636729,"P.S. 20 - STATEN ISLAND","161 PARK AVENUE"
1,0,1,"d3689025-33f4-ea11-b882-24ee9a37d45c","Pelham Academy of Academics and Community Engagement - X468 - X135 - 11X468 - 2441 WALLACE AVENUE","d4689025-33f4-ea11-b882-24ee9a37d45c",-73865028,40862098,"I.S. 135 - BRONX","2441 WALLACE AVENUE"
2,0,2,"880e6e25-32f4-ea11-b882-24ee9a37d45c","P.S. 171 Peter G. Van Alst - Q171 - Q171 - 30Q171 - 14-14 29 AVENUE","870e6e25-32f4-ea11-b882-24ee9a37d45c",-73929093,40770926,"P.S. 171 - QUEENS","14-14 29 AVENUE"
2,2,0,"9d886843-31f4-ea11-b882-24ee9a37d45c","P.S. 011: The Sarah J. Garnet Elementary School - M011 - M011 - 02M011 - 320 WEST 21 STREET","9e886843-31f4-ea11-b882-24ee9a37d45c",-74000743,40744186,"P.S. 11 - MANHATTAN","320 WEST 21 STREET"
1,1,0,"dac88e4f-31f4-ea11-b882-24ee9a37d45c","P.S. 048 P.O. Michael J. Buczek - M048 - M048 - 06M048 - 4360-78 BROADWAY","d9c88e4f-31f4-ea11-b882-24ee9a37d45c",-73933629,40853193,"P.S. 48 - MANHATTAN","4360-78 BROADWAY"
3,2,1,"1baf0313-32f4-ea11-b882-24ee9a37d45c","The Bellaire School - Q135 - Q135 - 29Q135 - 207-11 89 AVENUE","1caf0313-32f4-ea11-b882-24ee9a37d45c",-73757591,40720864,"P.S. 135 - QUEENS","207-11 89 AVENUE"
6,2,4,"6ce2635c-32f4-ea11-b882-24ee9a37d45c","Bayside High School - Q495 - Q405 - 26Q495 - 32-24 CORPORAL KENNEDY STREET","6be2635c-32f4-ea11-b882-24ee9a37d45c",-73781041,40771398,"BAYSIDE HS - Q","32-24 CORPORAL KENNEDY STREET"
4,4,0,"26c73b4a-32f4-ea11-b882-24ee9a37d45c","A.C.E. Academy for Scholars at the Geraldine Ferraro Campus - Q290 - Q290 - 24Q290 - 55-20 METROPOLITAN AVENUE","24c73b4a-32f4-ea11-b882-24ee9a37d45c",-73908307,40713030,"THE GERALDINE FERRARO CAMPUS - QUEENS","55-20 METROPOLITAN AVENUE"
4,1,3,"e880b5c9-df1e-eb11-b885-24ee9a37d45c","MS 936 Arts Off 3rd - K936 - K746 - 20K936 - 270 59th Street","e980b5c9-df1e-eb11-b885-24ee9a37d45c",-74020748,40642914,"P.S. @ 270 59TH STREET- BROOKLYN","270 59th Street"
1,0,1,"58fdc1bd-32f4-ea11-b882-24ee9a37d45c","Fort Hill Collaborative Elementary School - R010 - R016 - 31R010 - 195 DANIEL LOW TERRACE","56fdc1bd-32f4-ea11-b882-24ee9a37d45c",-74079594,40639638,"P.S. 16 - STATEN ISLAND","195 DANIEL LOW TERRACE"
2,1,1,"27005d7a-31f4-ea11-b882-24ee9a37d45c","P.S. 163 Alfred E. Smith - M163 - M163 - 03M163 - 163 West 97 Street","26005d7a-31f4-ea11-b882-24ee9a37d45c",-73968470,40795163,"P.S. 163 - MANHATTAN","163 West 97 Street"
1,1,0,"ee8a0044-33f4-ea11-b882-24ee9a37d45c","P.S. 168 - X168 - X183 - 75X168 - 339 MORRIS AVENUE","ef8a0044-33f4-ea11-b882-24ee9a37d45c",-73925995,40813681,"J.H.S. 203 - BRONX","339 MORRIS AVENUE"
3,2,1,"03b7c337-32f4-ea11-b882-24ee9a37d45c","J.H.S. 216 George J. Ryan - Q216 - Q216 - 26Q216 - 64-20 175 Street","04b7c337-32f4-ea11-b882-24ee9a37d45c",-73794501,40737188,"J.H.S. 216 - QUEENS","64-20 175 Street"
1,0,1,"0baf0313-32f4-ea11-b882-24ee9a37d45c","P.S. 130 - Q130 - Q130 - 25Q130 - 200-01 42 AVENUE","04af0313-32f4-ea11-b882-24ee9a37d45c",-73784009,40760219,"P.S. 130 - QUEENS","200-01 42 AVENUE"
5,5,0,"d2b66262-32f4-ea11-b882-24ee9a37d45c","Forest Hills High School - Q440 - Q440 - 28Q440 - 67-01 110 STREET","d3b66262-32f4-ea11-b882-24ee9a37d45c",-73843972,40730017,"FOREST HILLS HS - Q","67-01 110 STREET"
2,1,1,"445bc58c-30f4-ea11-b882-24ee9a37d45c","P.S. 212 Lady Deborah Moody - K212 - K212 - 21K212 - 87 BAY 49 STREET","455bc58c-30f4-ea11-b882-24ee9a37d45c",-73985368,40587612,"P.S. 212 - BROOKLYN","87 BAY 49 STREET"
2,0,2,"a183ff9e-30f4-ea11-b882-24ee9a37d45c","P.S. 253 - K253 - K253 - 21K253 - 601 OCEANVIEW AVENUE","a283ff9e-30f4-ea11-b882-24ee9a37d45c",-73961962,40580237,"P.S. 253 - BROOKLYN","601 OCEANVIEW AVENUE"
1,1,0,"78283fb1-30f4-ea11-b882-24ee9a37d45c","P.S. 288 The Shirley Tanyhill - K288 - K288 - 21K288 - 2950 WEST 25 STREET","79283fb1-30f4-ea11-b882-24ee9a37d45c",-73992393,40574029,"P.S. 288 - BROOKLYN","2950 WEST 25 STREET"
1,0,1,"4dfdc1bd-32f4-ea11-b882-24ee9a37d45c","P.S. 11 Thomas Dongan School - R011 - R011 - 31R011 - 51 Jefferson Street","4efdc1bd-32f4-ea11-b882-24ee9a37d45c",-74098252,40590887,"P.S. 11 - STATEN ISLAND","51 Jefferson Street"
3,3,0,"bae0838c-31f4-ea11-b882-24ee9a37d45c","P.S. 234 Independence School - M234 - M234 - 02M234 - 292 GREENWICH STREET","bbe0838c-31f4-ea11-b882-24ee9a37d45c",-74010880,40719530,"P.S. 234 - MANHATTAN","292 GREENWICH STREET"
1,0,1,"3788e6db-30f4-ea11-b882-24ee9a37d45c","FDNY - Captain Vernon A. Richard High School for Fire and Life Safety - K502 - K435 - 19K502 - 400 PENNSYLVANIA AVENUE","3688e6db-30f4-ea11-b882-24ee9a37d45c",-73895122,40666868,"THOMAS JEFFERSON HS - K","400 PENNSYLVANIA AVENUE"
1,0,1,"2e9ebaee-32f4-ea11-b882-24ee9a37d45c","P.S. 291 - X291 - X015 - 10X291 - 2195 ANDREWS AVENUE","219ebaee-32f4-ea11-b882-24ee9a37d45c",-73909763,40859243,"P.S. 15 - BRONX","2195 ANDREWS AVENUE"
6,5,1,"cdba3c50-33f4-ea11-b882-24ee9a37d45c","The Highbridge Green School - X361 - X285 - 09X361 - 200 West 167th Street","ceba3c50-33f4-ea11-b882-24ee9a37d45c",-73927892,40838232,"HIGHBRIDGE ENVIRONMENTAL EDUCATION CAMPUS - BRONX","200 West 167th Street"
2,0,2,"f902cefa-32f4-ea11-b882-24ee9a37d45c","P.S. X188 - X188 - X034 - 75X188 - 770 GROTE STREET","fa02cefa-32f4-ea11-b882-24ee9a37d45c",-73883877,40850168,"P.S. 34 - BRONX","770 GROTE STREET"
2,2,0,"520b210d-33f4-ea11-b882-24ee9a37d45c","P.S. 085 Great Expectations - X085 - X085 - 10X085 - 2400 MARION AVENUE","530b210d-33f4-ea11-b882-24ee9a37d45c",-73894682,40858689,"P.S. 85 - BRONX","2400 MARION AVENUE"
2,0,2,"5ede5eb7-30f4-ea11-b882-24ee9a37d45c","P.S. 307 Daniel Hale Williams - K307 - K307 - 13K307 - 209 YORK STREET","5fde5eb7-30f4-ea11-b882-24ee9a37d45c",-73981599,40701789,"P.S. 307 - BROOKLYN","209 YORK STREET"
1,0,1,"3288e6db-30f4-ea11-b882-24ee9a37d45c","Achievement First Crown Heights Charter School - K356 - K434 - 84K356 - 1485 PACIFIC STREET","3388e6db-30f4-ea11-b882-24ee9a37d45c",-73942390,40677266,"CROWN HEIGHTS CHARTER SCHOOLS - BROOKLYN","1485 PACIFIC STREET"
1,1,0,"a5edf392-32f4-ea11-b882-24ee9a37d45c","Joseph F. Quinn Intermediate School 77 - Q077 - Q849 - 24Q077 - 976 Seneca Avenue","a4edf392-32f4-ea11-b882-24ee9a37d45c",-73902147,40699101,"I.S. 77 - QUEENS","976 Seneca Avenue"
3,3,0,"0bcf496e-31f4-ea11-b882-24ee9a37d45c","M.S. 131 - M131 - M131 - 02M131 - 100 HESTER STREET","03cf496e-31f4-ea11-b882-24ee9a37d45c",-73993607,40716231,"I.S. 131 - MANHATTAN","100 HESTER STREET"
2,1,1,"418dbfcf-30f4-ea11-b882-24ee9a37d45c","Kingsborough Early College School - K468 - K400 - 21K468 - 2630 BENSON AVENUE","3a8dbfcf-30f4-ea11-b882-24ee9a37d45c",-73986313,40593028,"Lafayette Educational Campus","2630 BENSON AVENUE"
2,2,0,"20a6ba98-31f4-ea11-b882-24ee9a37d45c","Academy for Software Engineering - M546 - M460 - 02M546 - 40 IRVING PLACE","16a6ba98-31f4-ea11-b882-24ee9a37d45c",-73987064,40735361,"WASHINGTON IRVING HS - MANHATTAN","40 IRVING PLACE"
1,1,0,"79593c87-33f4-ea11-b882-24ee9a37d45c","P.S. 226 - X226 - X826 - 10X226 - 1950 SEDGWICK AVENUE","7a593c87-33f4-ea11-b882-24ee9a37d45c",-73916076,40855822,"P.S. 226 MINISCHOOL - BRONX","1950 SEDGWICK AVENUE"
5,4,1,"c9883319-32f4-ea11-b882-24ee9a37d45c","I.S. 141 The Steinway - Q141 - Q141 - 30Q141 - 37-11 21 AVENUE","ca883319-32f4-ea11-b882-24ee9a37d45c",-73904508,40775766,"I.S. 141 - QUEENS","37-11 21 AVENUE"
2,1,1,"6541e65b-31f4-ea11-b882-24ee9a37d45c","New York City Lab Middle School for Collaborative Studies - M312 - M070 - 02M312 - 333 WEST 17 STREET","defab455-31f4-ea11-b882-24ee9a37d45c",-74002222,40742512,"I.S. 70 - MANHATTAN","333 WEST 17 STREET"
4,3,1,"417c21b7-32f4-ea11-b882-24ee9a37d45c","P.S. 6 Corporal Allan F. Kivlehan School - R006 - R006 - 31R006 - 555 PAGE AVENUE","3c7c21b7-32f4-ea11-b882-24ee9a37d45c",-74230118,40510207,"P.S. 6 - STATEN ISLAND","555 PAGE AVENUE"
1,0,1,"5ca5db98-30f4-ea11-b882-24ee9a37d45c","P.S. 236 Mill Basin - K236 - K236 - 22K236 - 6302 AVENUE U","5ba5db98-30f4-ea11-b882-24ee9a37d45c",-73912005,40615494,"P.S. 236 - BROOKLYN","6302 AVENUE U"
2,1,1,"52474313-33f4-ea11-b882-24ee9a37d45c","M.S. X101 Edward R. Byrne - X101 - X101 - 08X101 - 2750 LAFAYETTE AVENUE","4e474313-33f4-ea11-b882-24ee9a37d45c",-73829211,40827080,"I.S. 101 - BRONX","2750 LAFAYETTE AVENUE"
2,1,1,"3bb4977a-32f4-ea11-b882-24ee9a37d45c","Queens Satellite High School for Opportunity - Q338 - Q595 - 28Q338 - 162-02 HILLSIDE AVENUE","39b4977a-32f4-ea11-b882-24ee9a37d45c",-73799532,40708204,"AUX. SERV. - JAMAICA LEARN CT - Q","162-02 HILLSIDE AVENUE"
2,2,0,"a672c880-32f4-ea11-b882-24ee9a37d45c","Queens Metropolitan High School - Q686 - Q686 - 28Q686 - 91-30 METROPOLITAN AVENUE","a372c880-32f4-ea11-b882-24ee9a37d45c",-73855543,40708431,"METROPOLITAN AVENUE CAMPUS - QUEENS","91-30 METROPOLITAN AVENUE"
3,3,0,"63ffcc6e-33f4-ea11-b882-24ee9a37d45c","The Bronx High School of Science - X445 - X445 - 10X445 - 75 WEST 205 STREET","64ffcc6e-33f4-ea11-b882-24ee9a37d45c",-73889011,40879958,"BRONX HS OF SCIENCE - X","75 WEST 205 STREET"
1,0,1,"daf57030-30f4-ea11-b882-24ee9a37d45c","Magnet School of Math, Science and Design Technology - K010 - K010 - 15K010 - 511 7 AVENUE","dbf57030-30f4-ea11-b882-24ee9a37d45c",-73985946,40660912,"P.S. 10 - BROOKLYN","511 7 AVENUE"
3,3,0,"626e70b7-31f4-ea11-b882-24ee9a37d45c","High School for Environmental Studies - M400 - M834 - 02M400 - 444 WEST 56 STREET","5d6e70b7-31f4-ea11-b882-24ee9a37d45c",-73988610,40767848,"HS FOR ENVIRONMENTAL STUDIES - M","444 WEST 56 STREET"
1,0,1,"2c06003e-32f4-ea11-b882-24ee9a37d45c","P.S. 242 Leonard P. Stavisky Early Childhood School - Q242 - Q242 - 25Q242 - 29-66 137 STREET","2d06003e-32f4-ea11-b882-24ee9a37d45c",-73832005,40769752,"P.S. 242 - (ECC) - QUEENS","29-66 137 STREET"
5,4,1,"07fc3df4-30f4-ea11-b882-24ee9a37d45c","John Dewey High School - K540 - K540 - 21K540 - 50 AVENUE X","05fc3df4-30f4-ea11-b882-24ee9a37d45c",-73981925,40588070,"JOHN DEWEY HS - K","50 AVENUE X"
3,2,1,"512b3eee-30f4-ea11-b882-24ee9a37d45c","Fort Hamilton High School - K490 - K490 - 20K490 - 8301 SHORE ROAD","522b3eee-30f4-ea11-b882-24ee9a37d45c",-74038103,40626827,"FORT HAMILTON HS - K","8301 SHORE ROAD"
1,1,0,"f29b4c1f-32f4-ea11-b882-24ee9a37d45c","M.S. 158 Marie Curie - Q158 - Q158 - 26Q158 - 46-35 Oceania Street","f39b4c1f-32f4-ea11-b882-24ee9a37d45c",-73771878,40756562,"J.H.S. 158 - QUEENS","46-35 Oceania Street"
3,0,3,"e4c1392a-30f4-ea11-b882-24ee9a37d45c","Parkside Preparatory Academy - K002 - K002 - 17K002 - 655 Parkside Avenue","dfc1392a-30f4-ea11-b882-24ee9a37d45c",-73951575,40656423,"I.S. 2 - BROOKLYN","655 Parkside Avenue"
1,0,1,"9f53dd74-33f4-ea11-b882-24ee9a37d45c","Marble Hill High School for International Studies - X477 - X475 - 10X477 - 99 TERRACE VIEW AVENUE","9853dd74-33f4-ea11-b882-24ee9a37d45c",-73912686,40877379,"JOHN F. KENNEDY HS - X","99 TERRACE VIEW AVENUE"
2,2,0,"95886843-31f4-ea11-b882-24ee9a37d45c","P.S. 009 Sarah Anderson - M009 - M009 - 03M009 - 100 WEST 84 STREET","87886843-31f4-ea11-b882-24ee9a37d45c",-73974256,40785234,"P.S. 9 - MANHATTAN","100 WEST 84 STREET"
1,1,0,"7e34aa92-31f4-ea11-b882-24ee9a37d45c","Quest to Learn - M422 - M440 - 02M422 - 351 WEST 18 STREET","7834aa92-31f4-ea11-b882-24ee9a37d45c",-74002540,40743407,"BAYARD RUSTIN EDUCATIONAL COMP-M","351 WEST 18 STREET"
3,1,2,"a932c3fb-eaf6-ea11-b883-24ee9a37d459","P.S. Q004 - Q004 - Q179 - 75Q004 - 196-25 Peck Avenue","9c0e6e25-32f4-ea11-b882-24ee9a37d45c",-73778118,40741700,"P.S. 179 - QUEENS","196-25 Peck Avenue"
1,1,0,"db37fba4-31f4-ea11-b882-24ee9a37d45c","Cascades High School - M650 - M510 - 01M650 - 198 Forsyth Street","d737fba4-31f4-ea11-b882-24ee9a37d45c",-73990468,40722415,"FORSYTH HS (AUXSVC-OLD 91) - M","198 Forsyth Street"
1,1,0,"ab9c11e8-30f4-ea11-b882-24ee9a37d45c","School for Human Rights, The - K531 - K470 - 17K531 - 600 KINGSTON AVENUE","aa9c11e8-30f4-ea11-b882-24ee9a37d45c",-73943839,40658671,"GEORGE W. WINGATE HS - K","600 KINGSTON AVENUE"
1,1,0,"85d810ab-31f4-ea11-b882-24ee9a37d45c","Food and Finance High School - M288 - M535 - 02M288 - 525 WEST 50TH STREET","f137fba4-31f4-ea11-b882-24ee9a37d45c",-73992700,40765474,"PARK WEST HS (ECF) - MANHATTAN","525 WEST 50TH STREET"
1,0,1,"d685f462-ebf6-ea11-b883-24ee9a37d459","P.S. M811 - Mickey Mantle School - M811 - M200 - 75M811 - 2589 7 AVENUE","848d8486-31f4-ea11-b882-24ee9a37d45c",-73935746,40823988,"P.S. 200 (TANDEM M010) - MANHATTAN","2589 7 AVENUE"
2,2,0,"60a5db98-30f4-ea11-b882-24ee9a37d45c","The Academy of Talented Scholars - K682 - K237 - 20K682 - 50 AVENUE P","5fa5db98-30f4-ea11-b882-24ee9a37d45c",-73986678,40606994,"LUCRETIA MARCIGLIANO CAMPUS - K","50 AVENUE P"
1,0,1,"1830f69f-ebf6-ea11-b883-24ee9a37d459","P.S. Q004 - Q004 - Q213 - 75Q004 - 231-02 67 AVENUE","f8b6c337-32f4-ea11-b882-24ee9a37d45c",-73745390,40747457,"P.S. 213 - QUEENS","231-02 67 AVENUE"
1,1,0,"c98442ee-31f4-ea11-b882-24ee9a37d45c","P.S. 032 State Street - Q032 - Q032 - 25Q032 - 171-11 35 AVENUE","ca8442ee-31f4-ea11-b882-24ee9a37d45c",-73794323,40765459,"P.S. 32 - QUEENS","171-11 35 AVENUE"
2,2,0,"e7883319-32f4-ea11-b882-24ee9a37d45c","P.S. 146 Howard Beach - Q146 - Q146 - 27Q146 - 98-01 159 AVENUE","e8883319-32f4-ea11-b882-24ee9a37d45c",-73834896,40660531,"P.S. 146 - QUEENS","98-01 159 AVENUE"
1,1,0,"db92e6d5-30f4-ea11-b882-24ee9a37d45c","Academy for Young Writers - K404 - K422 - 19K404 - 1065 Elton Street","da92e6d5-30f4-ea11-b882-24ee9a37d45c",-73874064,40657266,"SPRING CREEK EDUCATIONAL CAMPUS - BROOKLYN","1065 Elton Street"
7,4,3,"137eed06-32f4-ea11-b882-24ee9a37d45c","P.S./I.S. 087 Middle Village - Q087 - Q087 - 24Q087 - 67-54 80 STREET","147eed06-32f4-ea11-b882-24ee9a37d45c",-73871674,40711559,"P.S. 87 - QUEENS","67-54 80 STREET"
1,0,1,"e2e0a4fb-ebf6-ea11-b883-24ee9a37d459","P.S. X010 - X010 - X240 - 75X010 - 1501 JEROME AVENUE","baba3c50-33f4-ea11-b882-24ee9a37d45c",-73916084,40842503,"DOE NEW SETTLEMENT COMMUNITY CAMPUS - X","1501 JEROME AVENUE"
4,0,4,"5ae61462-31f4-ea11-b882-24ee9a37d45c","P.S. 108 Assemblyman Angelo Del Toro Educational Complex - M108 - M108 - 04M108 - 1615 MADISON AVENUE","5be61462-31f4-ea11-b882-24ee9a37d45c",-73947855,40795032,"P.S. 108 - MANHATTAN","1615 MADISON AVENUE"
4,2,2,"1b474313-33f4-ea11-b882-24ee9a37d45c","Sheridan Academy for Young Leaders - X457 - X090 - 09X457 - 1116 SHERIDAN AVENUE","1c474313-33f4-ea11-b882-24ee9a37d45c",-73917526,40831873,"P.S. 90 - BRONX","1116 SHERIDAN AVENUE"
3,1,2,"b52ff20c-32f4-ea11-b882-24ee9a37d45c","P.S. 107 Thomas A Dooley - Q107 - Q107 - 25Q107 - 167-02 45 AVENUE","b62ff20c-32f4-ea11-b882-24ee9a37d45c",-73799476,40755364,"P.S. 107 - QUEENS","167-02 45 AVENUE"
2,1,1,"e4ba3c50-33f4-ea11-b882-24ee9a37d45c","P.S. 583 - X583 - X317 - 08X583 - 1028 WHITE PLAINS ROAD","e5ba3c50-33f4-ea11-b882-24ee9a37d45c",-73859622,40826949,"P.S. 317 - BRONX","1028 WHITE PLAINS ROAD"
1,1,0,"ca8521d0-32f4-ea11-b882-24ee9a37d45c","P.S. 060 Alice Austen - R060 - R060 - 31R060 - 55 Merrill Avenue","cb8521d0-32f4-ea11-b882-24ee9a37d45c",-74162634,40610604,"P.S. 60 - STATEN ISLAND","55 Merrill Avenue"
1,0,1,"58e61462-31f4-ea11-b882-24ee9a37d45c","P.S. 102 Jacques Cartier - M102 - M102 - 04M102 - 315 EAST 113 STREET","56e61462-31f4-ea11-b882-24ee9a37d45c",-73938418,40795000,"P.S. 102 - MANHATTAN","315 EAST 113 STREET"
6,6,0,"aaab074a-33f4-ea11-b882-24ee9a37d45c","Urban Institute of Mathematics - X371 - X192 - 08X371 - 650 HOLLYWOOD AVENUE","078b0044-33f4-ea11-b882-24ee9a37d45c",-73818083,40826794,"I.S. 192 - BRONX","650 HOLLYWOOD AVENUE"
1,0,1,"d4e8ce00-32f4-ea11-b882-24ee9a37d45c","P.S. 076 William Hallet - Q076 - Q076 - 30Q076 - 36-36 10 Street","d2e8ce00-32f4-ea11-b882-24ee9a37d45c",-73941630,40760862,"P.S. 76 - QUEENS","36-36 10 Street"
3,2,1,"91e657bd-30f4-ea11-b882-24ee9a37d45c","P.S. 506: The School of Journalism & Technology - K506 - K314 - 20K506 - 330 59 Street","8ee657bd-30f4-ea11-b882-24ee9a37d45c",-74019299,40641950,"P.S. 314 - BROOKLYN","330 59 Street"
2,1,1,"7f283fb1-30f4-ea11-b882-24ee9a37d45c","P.S. 290 Juan Morel Campos - K290 - K290 - 19K290 - 135 Schenck Avenue","7e283fb1-30f4-ea11-b882-24ee9a37d45c",-73889375,40678182,"P.S. 290 - BROOKLYN","135 Schenck Avenue"
1,1,0,"b22ff20c-32f4-ea11-b882-24ee9a37d45c","Lighthouse Elementary School - Q106 - Q106 - 27Q106 - 180 BEACH 35 STREET","b32ff20c-32f4-ea11-b882-24ee9a37d45c",-73766846,40594738,"P.S. 106 - QUEENS","180 BEACH 35 STREET"
2,1,1,"5907e99e-31f4-ea11-b882-24ee9a37d45c","High School for Health Professions and Human Services - M420 - M475 - 02M420 - 345 East 15th Street","5607e99e-31f4-ea11-b882-24ee9a37d45c",-73982590,40732665,"HEALTH PROFESSIONS HS (OL STY) - M","345 East 15th Street"
1,1,0,"9ee657bd-30f4-ea11-b882-24ee9a37d45c","I.S. 318 Eugenio Maria De Hostos - K318 - K318 - 14K318 - 101 WALTON STREET","9de657bd-30f4-ea11-b882-24ee9a37d45c",-73948771,40703034,"I.S. 318 - BROOKLYN","101 WALTON STREET"
2,2,0,"d9968d36-30f4-ea11-b882-24ee9a37d45c","P.S. 020 Clinton Hill - K020 - K020 - 13K020 - 225 ADELPHI STREET","d1968d36-30f4-ea11-b882-24ee9a37d45c",-73970896,40690742,"P.S. 20 - BROOKLYN","225 ADELPHI STREET"
2,0,2,"4a0d6d19-33f4-ea11-b882-24ee9a37d45c","P.S. 110 Theodore Schoenfeld - X110 - X110 - 09X110 - 580 CROTONA PARK SOUTH","420d6d19-33f4-ea11-b882-24ee9a37d45c",-73900654,40834470,"P.S. 110 - BRONX","580 CROTONA PARK SOUTH"
4,4,0,"cee8ce00-32f4-ea11-b882-24ee9a37d45c","J.H.S. 074 Nathaniel Hawthorne - Q074 - Q074 - 26Q074 - 61-15 Oceania Street","cfe8ce00-32f4-ea11-b882-24ee9a37d45c",-73766653,40744743,"I.S. 74 - QUEENS","61-15 Oceania Street"
2,0,2,"d53159fa-30f4-ea11-b882-24ee9a37d45c","George Westinghouse Career and Technical Education High School - K605 - K580 - 13K605 - 105 TECH PLACE","d33159fa-30f4-ea11-b882-24ee9a37d45c",-73986105,40695444,"GEORGE WESTINGHOUSE VOC HS - K","105 TECH PLACE"
1,0,1,"9f778cb8-ebf6-ea11-b883-24ee9a37d459","P.S. Q811 - Q811 - Q566 - 75Q811 - 74-20 COMMONWEALTH BLVD","27b4977a-32f4-ea11-b882-24ee9a37d45c",-73728834,40744197,"QNS HS OF TEACH., LIB. ARTS&SCI-Q","74-20 COMMONWEALTH BLVD"
2,2,0,"df883319-32f4-ea11-b882-24ee9a37d45c","P.S. 144 Col Jeromus Remsen - Q144 - Q144 - 28Q144 - 69-20 JUNO STREET","e0883319-32f4-ea11-b882-24ee9a37d45c",-73852398,40714890,"P.S. 144 - QUEENS","69-20 JUNO STREET"
1,1,0,"aa8fd48d-ebf6-ea11-b883-24ee9a37d459","P.S. Q811 - Q811 - Q037 - 75Q811 - 179-37 137 Avenue","d58442ee-31f4-ea11-b882-24ee9a37d45c",-73758778,40676201,"P.S. 37 - QUEENS","179-37 137 Avenue"
1,1,0,"45e61462-31f4-ea11-b882-24ee9a37d45c","Bard High School Early College - M696 - M097 - 01M696 - 525 EAST HOUSTON STREET","46e61462-31f4-ea11-b882-24ee9a37d45c",-73976093,40718276,"BARD COLLEGE HS (OLD M097) - M","525 EAST HOUSTON STREET"
1,0,1,"d82ff20c-32f4-ea11-b882-24ee9a37d45c","P.S./I.S. 119 The Glendale - Q119 - Q119 - 24Q119 - 74-01 78 AVENUE","d92ff20c-32f4-ea11-b882-24ee9a37d45c",-73875073,40705187,"I.S. 119 - QUEENS","74-01 78 AVENUE"
1,0,1,"bcc4bd60-4afb-ea11-b883-24ee9a37d459","Ivy League Early Learning Academy - XANI - XANI -  - 4022 EAST TREMONT AVENUE","bdc4bd60-4afb-ea11-b883-24ee9a37d459",-73817980,40819638,"TUTOR TIME","4022 EAST TREMONT AVENUE"
2,1,1,"602b3eee-30f4-ea11-b882-24ee9a37d45c","High School for Innovation in Advertising and Media - K617 - K500 - 18K617 - 1600 ROCKAWAY PARKWAY","5e2b3eee-30f4-ea11-b882-24ee9a37d45c",-73898601,40640543,"CANARSIE HS - K","1600 ROCKAWAY PARKWAY"
2,0,2,"b3fc24e8-31f4-ea11-b882-24ee9a37d45c","P.S. 022 Thomas Jefferson - Q022 - Q022 - 25Q022 - 153-33 SANFORD AVENUE","b1fc24e8-31f4-ea11-b882-24ee9a37d45c",-73811373,40761744,"P.S. 22 - QUEENS","153-33 SANFORD AVENUE"
3,3,0,"4b6e70b7-31f4-ea11-b882-24ee9a37d45c","High School for Mathematics, Science and Engineering at City College - M692 - M812 - 05M692 - 240 CONVENT AVE","4c6e70b7-31f4-ea11-b882-24ee9a37d45c",-73950354,40820208,"HS FOR MATH, SCI & ENGINEERING-M","240 CONVENT AVE"
1,0,1,"cc92e6d5-30f4-ea11-b882-24ee9a37d45c","Brooklyn Lab School - K639 - K420 - 19K639 - 999 JAMAICA AVENUE","c692e6d5-30f4-ea11-b882-24ee9a37d45c",-73869305,40693002,"FRANKLIN K. LANE HS - K","999 JAMAICA AVENUE"
2,2,0,"e4201dab-30f4-ea11-b882-24ee9a37d45c","P.S. 277 Gerritsen Beach - K277 - K277 - 22K277 - 2529 GERRITSEN AVENUE","e5201dab-30f4-ea11-b882-24ee9a37d45c",-73927850,40595798,"P.S. 277 - BROOKLYN","2529 GERRITSEN AVENUE"
2,2,0,"d611f898-32f4-ea11-b882-24ee9a37d45c","Renaissance Charter School - Q705 - Q885 - 84Q705 - 35-59 81ST STREET","d511f898-32f4-ea11-b882-24ee9a37d45c",-73884817,40749934,"RENAISSANCE CHARTER SCHOOL - Q","35-59 81ST STREET"
1,0,1,"68f4a0ef-eaf6-ea11-b883-24ee9a37d459","P.S. K811 Connie Lekas School - K811 - K286 - 75K811 - 2525 HARING STREET","6e283fb1-30f4-ea11-b882-24ee9a37d45c",-73938610,40591132,"P.S. 811 (OLD P286) - BROOKLYN","2525 HARING STREET"
2,0,2,"6b507380-31f4-ea11-b882-24ee9a37d45c","P.S. 192 Jacob H. Schiff - M192 - M192 - 06M192 - 500 WEST 138 STREET","64507380-31f4-ea11-b882-24ee9a37d45c",-73952023,40820510,"P.S. 192 - MANHATTAN","500 WEST 138 STREET"
1,1,0,"1402926e-32f4-ea11-b882-24ee9a37d45c","Academy of Medical Technology: A College Board School - Q309 - Q465 - 27Q309 - 8-21 BAY 25 STREET","0b02926e-32f4-ea11-b882-24ee9a37d45c",-73763995,40601537,"FAR ROCKAWAY HS - Q","8-21 BAY 25 STREET"
2,1,1,"48767649-31f4-ea11-b882-24ee9a37d45c","P.S. 034 Franklin D. Roosevelt - M034 - M034 - 01M034 - 730 East 12 Street","49767649-31f4-ea11-b882-24ee9a37d45c",-73975058,40726008,"P.S. 34 - MANHATTAN","730 East 12 Street"
2,1,1,"e08a0044-33f4-ea11-b882-24ee9a37d45c","Bedford Park Elementary School - X077 - X177 - 10X077 - 3177 WEBSTER AVENUE","dc8a0044-33f4-ea11-b882-24ee9a37d45c",-73875375,40872559,"THE NORWOOD EAST CAMPUS - BRONX","3177 WEBSTER AVENUE"
2,1,1,"aaeb6056-32f4-ea11-b882-24ee9a37d45c","The Hector Figueroa School - Q398 - Q398 - 30Q398 - 69-01 34TH AVENUE","abeb6056-32f4-ea11-b882-24ee9a37d45c",-73896705,40752773,"P.S. 398 - QUEENS","69-01 34TH AVENUE"
1,1,0,"ee37fba4-31f4-ea11-b882-24ee9a37d45c","I.S. 528 Bea Fuller Rodgers School - M528 - M528 - 06M528 - 180 WADSWORTH AVENUE","ed37fba4-31f4-ea11-b882-24ee9a37d45c",-73934676,40850683,"I.S. 528 - MANHATTAN","180 WADSWORTH AVENUE"
2,1,1,"de2ff20c-32f4-ea11-b882-24ee9a37d45c","P.S. 121 Queens - Q121 - Q121 - 28Q121 - 126-10 109 AVENUE","df2ff20c-32f4-ea11-b882-24ee9a37d45c",-73815330,40683585,"P.S. 121 - QUEENS","126-10 109 AVENUE"
3,2,1,"5f6e70b7-31f4-ea11-b882-24ee9a37d45c","High School of Economics and Finance - M489 - M833 - 02M489 - 100 TRINITY PLACE","606e70b7-31f4-ea11-b882-24ee9a37d45c",-74012328,40709270,"HS FOR ECONOMICS & FINANCE - M","100 TRINITY PLACE"
2,2,0,"fd8a0044-33f4-ea11-b882-24ee9a37d45c","Jill Chaifetz Transfer High School - X379 - X184 - 07X379 - 778 FOREST AVENUE","f88a0044-33f4-ea11-b882-24ee9a37d45c",-73905389,40818703,"I.S. 184 - BRONX","778 FOREST AVENUE"
2,1,1,"1cba8b86-30f4-ea11-b882-24ee9a37d45c","P.S. 209 Margaret Mead - K209 - K209 - 21K209 - 2609 EAST 7 STREET","1dba8b86-30f4-ea11-b882-24ee9a37d45c",-73961191,40586800,"P.S. 209 - BROOKLYN","2609 EAST 7 STREET"
2,1,1,"12ae38fc-7001-ed11-b8db-24ee9a37d45c","The Richard H. Hungerford School - R721 - R086 - 75R721 - 715 L Ocean Terrace","713f38e4-e9e5-ec11-b8d9-24ee9a37d45c",-74108045,40608374,"I.S./H.S. @ 715L OCEAN TERRACE - STATEN ISLAND","715 L Ocean Terrace"
1,1,0,"e0e0838c-31f4-ea11-b882-24ee9a37d45c","P.S. 051 Elias Howe - M051 - M338 - 02M051 - 525 WEST 44TH STREET","dfe0838c-31f4-ea11-b882-24ee9a37d45c",-73995825,40761487,"P.S. 51 ELIAS HOWE - MANHATTAN","525 WEST 44TH STREET"
3,2,1,"bec88e4f-31f4-ea11-b882-24ee9a37d45c","M.S. M247 Dual Language Middle School - M247 - M044 - 03M247 - 100 WEST 77 STREET","bfc88e4f-31f4-ea11-b882-24ee9a37d45c",-73977602,40780536,"I.S. 44 - MANHATTAN","100 WEST 77 STREET"
2,0,2,"fc454b50-32f4-ea11-b882-24ee9a37d45c","College Point Collaborative - Q379 - Q336 - 25Q379 - 12406 14TH AVENUE","fd454b50-32f4-ea11-b882-24ee9a37d45c",-73843504,40785129,"The College Point Collaborative Educational Buildi","12406 14TH AVENUE"
1,0,1,"25e0d393-ebf6-ea11-b883-24ee9a37d459","P.S. Q993 - Q993 - Q130 - 75Q993 - 200-01 42 AVENUE","04af0313-32f4-ea11-b882-24ee9a37d45c",-73784009,40760219,"P.S. 130 - QUEENS","200-01 42 AVENUE"
3,1,2,"0678931f-33f4-ea11-b882-24ee9a37d45c","I.S. 117 Joseph H. Wade - X117 - X117 - 09X117 - 1865 MORRIS AVENUE","0578931f-33f4-ea11-b882-24ee9a37d45c",-73909022,40848552,"I.S. 117 - BRONX","1865 MORRIS AVENUE"
1,0,1,"94283fb1-30f4-ea11-b882-24ee9a37d45c","Digital Arts and Cinema Technology High School - K429 - K293 - 15K429 - 284 Baltic Street","91283fb1-30f4-ea11-b882-24ee9a37d45c",-73993293,40685006,"J.H.S. 293 - BROOKLYN","284 Baltic Street"
2,2,0,"362f7d06-31f4-ea11-b882-24ee9a37d45c","Brooklyn Studio Secondary School - K690 - K721 - 21K690 - 8310 21ST AVENUE","56416e00-31f4-ea11-b882-24ee9a37d45c",-73995084,40604980,"BROOKLYN STUDIO (TANDEM K128) - K","8310 21ST AVENUE"
2,2,0,"9748b1f5-eaf6-ea11-b883-24ee9a37d459","P.S. 372 -The Children's School - K372 - K834 - 75K372 - 512 CARROLL STREET","fcd7cf12-31f4-ea11-b882-24ee9a37d45c",-73985500,40676198,"P.S. 372 (OUR LADY OF PEACE)-K","512 CARROLL STREET"
1,0,1,"76886843-31f4-ea11-b882-24ee9a37d45c","P.S. 002 Meyer London - M002 - M002 - 02M002 - 122 Henry Street","77886843-31f4-ea11-b882-24ee9a37d45c",-73991523,40712907,"P.S. 2 - MANHATTAN","122 Henry Street"
1,1,0,"5536d900-33f4-ea11-b882-24ee9a37d45c","P.S. 049 Willis Avenue - X049 - X049 - 07X049 - 383 EAST 139 STREET","4d36d900-33f4-ea11-b882-24ee9a37d45c",-73922730,40810413,"P.S. 49 - BRONX","383 EAST 139 STREET"
1,1,0,"a483ff9e-30f4-ea11-b882-24ee9a37d45c","P.S. 254 Dag Hammarskjold - K254 - K254 - 22K254 - 2469 East 18 Street","a583ff9e-30f4-ea11-b882-24ee9a37d45c",-73951550,40591103,"P.S. 254 - BROOKLYN","2469 East 18 Street"
2,2,0,"77a5db98-30f4-ea11-b882-24ee9a37d45c","Olympus Academy - K635 - K242 - 18K635 - 755 EAST 100 STREET","71a5db98-30f4-ea11-b882-24ee9a37d45c",-73898607,40645965,"P.S. 235 ANNEX - BROOKLYN","755 EAST 100 STREET"
3,2,1,"f0f22ce2-31f4-ea11-b882-24ee9a37d45c","York Early College Academy - Q284 - Q008 - 28Q284 - 108-35 167 STREET","f1f22ce2-31f4-ea11-b882-24ee9a37d45c",-73786403,40696910,"J.H.S. 8 - QUEENS","108-35 167 STREET"
1,0,1,"a70e6e25-32f4-ea11-b882-24ee9a37d45c","P.S. 181 Brookfield - Q181 - Q181 - 29Q181 - 148-15 230 Street","a80e6e25-32f4-ea11-b882-24ee9a37d45c",-73752948,40655674,"P.S. 181 - QUEENS","148-15 230 Street"
5,5,0,"f2ae0313-32f4-ea11-b882-24ee9a37d45c","P.S. 122 Mamie Fay - Q122 - Q122 - 30Q122 - 21-21 DITMARS BOULEVARD","cb2ff20c-32f4-ea11-b882-24ee9a37d45c",-73915785,40780507,"P.S. 122 - QUEENS","21-21 DITMARS BOULEVARD"
4,4,0,"538dbfcf-30f4-ea11-b882-24ee9a37d45c","Abraham Lincoln High School - K410 - K410 - 21K410 - 2800 OCEAN PARKWAY","518dbfcf-30f4-ea11-b882-24ee9a37d45c",-73968733,40582627,"ABRAHAM LINCOLN HS - K","2800 OCEAN PARKWAY"
2,1,1,"236e3d68-31f4-ea11-b882-24ee9a37d45c","Community Action School - MS 258 - M258 - M118 - 03M258 - 154 WEST 93 STREET","246e3d68-31f4-ea11-b882-24ee9a37d45c",-73971011,40791395,"I.S. 118 - MANHATTAN","154 WEST 93 STREET"
1,0,1,"a732c3fb-eaf6-ea11-b883-24ee9a37d459","P.S. Q177 - Q177 - Q177 - 75Q177 - 56-37 188 STREET","8b0e6e25-32f4-ea11-b882-24ee9a37d45c",-73787419,40743400,"P.S. 177 - QUEENS","56-37 188 STREET"
1,1,0,"4febaa73-30f4-ea11-b882-24ee9a37d45c","New Bridges Elementary - K532 - K167 - 17K532 - 1025 EASTERN PARKWAY","4cebaa73-30f4-ea11-b882-24ee9a37d45c",-73934316,40669557,"P.S. 167 - BROOKLYN","1025 EASTERN PARKWAY"
2,2,0,"a369c231-32f4-ea11-b882-24ee9a37d45c","Energy Tech High School - Q258 - Q204 - 30Q258 - 36-41 28 STREET","9c69c231-32f4-ea11-b882-24ee9a37d45c",-73932628,40756471,"I.S. 204 - QUEENS","36-41 28 STREET"
10,10,0,"5588e6db-30f4-ea11-b882-24ee9a37d45c","New Utrecht High School - K445 - K445 - 20K445 - 1601 80 STREET","5488e6db-30f4-ea11-b882-24ee9a37d45c",-74002308,40613041,"NEW UTRECHT HS - K","1601 80 STREET"
1,0,1,"dc8521d0-32f4-ea11-b882-24ee9a37d45c","P.S. 069 Daniel D. Tompkins - R069 - R069 - 31R069 - 144 KEATING PLACE","dd8521d0-32f4-ea11-b882-24ee9a37d45c",-74157327,40591480,"P.S. 69 - STATEN ISLAND","144 KEATING PLACE"
2,2,0,"df8442ee-31f4-ea11-b882-24ee9a37d45c","P.S. 038 Rosedale - Q038 - Q038 - 29Q038 - 135-21 241 STREET","e08442ee-31f4-ea11-b882-24ee9a37d45c",-73733774,40671150,"P.S. 38 - QUEENS","135-21 241 STREET"
1,0,1,"f68052e9-ebf6-ea11-b883-24ee9a37d459","P.S. X017 - X017 - X043 - 75X017 - 165 BROWN PLACE","1803cefa-32f4-ea11-b882-24ee9a37d45c",-73921593,40806452,"P.S. 43 - BRONX","165 BROWN PLACE"
3,3,0,"a52aa42b-33f4-ea11-b882-24ee9a37d45c","Riverdale / Kingsbridge Academy (Middle School / High School 141) - X141 - X141 - 10X141 - 660 West 237 Street","a62aa42b-33f4-ea11-b882-24ee9a37d45c",-73914141,40887407,"M.S./H.S. 141 - BRONX","660 West 237 Street"
1,0,1,"76b50aa5-30f4-ea11-b882-24ee9a37d45c","P.S. 264 Bay Ridge Elementary School For The Arts - K264 - K264 - 20K264 - 371 89th Street","74b50aa5-30f4-ea11-b882-24ee9a37d45c",-74029444,40621025,"PS 264 BAY RIDGE ELEM SCL FOR THE ARTS - BROOKLYN","371 89th Street"
1,1,0,"5d9f4974-31f4-ea11-b882-24ee9a37d45c","P.S. 153 Adam Clayton Powell - M153 - M153 - 06M153 - 1750 AMSTERDAM AVENUE","589f4974-31f4-ea11-b882-24ee9a37d45c",-73947599,40826514,"P.S. 153 - MANHATTAN","1750 AMSTERDAM AVENUE"
1,1,0,"bbbfa431-33f4-ea11-b882-24ee9a37d45c","The Laboratory School of Finance and Technology: X223 - X223 - X149 - 07X223 - 360 EAST 145 STREET","bcbfa431-33f4-ea11-b882-24ee9a37d45c",-73920851,40813612,"J.H.S. 149 - BRONX","360 EAST 145 STREET"
2,2,0,"f59b4c1f-32f4-ea11-b882-24ee9a37d45c","P.S. 159 - Q159 - Q159 - 26Q159 - 205-01 33 AVENUE","f69b4c1f-32f4-ea11-b882-24ee9a37d45c",-73783973,40770108,"P.S. 159 - QUEENS","205-01 33 AVENUE"
1,1,0,"f9ae0313-32f4-ea11-b882-24ee9a37d45c","P.S. 124 Osmond A Church - Q124 - Q124 - 27Q124 - 129-15 150 AVENUE","faae0313-32f4-ea11-b882-24ee9a37d45c",-73811266,40665669,"P.S. 124 - QUEENS","129-15 150 AVENUE"
2,2,0,"fef22ce2-31f4-ea11-b882-24ee9a37d45c","P.S. 011 Kathryn Phelan - Q011 - Q011 - 30Q011 - 54-25 SKILLMAN AVENUE","fff22ce2-31f4-ea11-b882-24ee9a37d45c",-73909032,40746127,"P.S. 11 - QUEENS","54-25 SKILLMAN AVENUE"
1,1,0,"9a778cb8-ebf6-ea11-b883-24ee9a37d459","P.S. Q993 - Q993 - Q499 - 75Q993 - 148-20 REEVES AVENUE","8bbc9674-32f4-ea11-b882-24ee9a37d45c",-73820821,40738599,"P.S./I.S. 499 - QUEENS","148-20 REEVES AVENUE"
1,0,1,"0dcf496e-31f4-ea11-b882-24ee9a37d45c","Emma Lazarus High School - M394 - M131 - 02M394 - 100 HESTER STREET","03cf496e-31f4-ea11-b882-24ee9a37d45c",-73993607,40716231,"I.S. 131 - MANHATTAN","100 HESTER STREET"
3,2,1,"38c73b4a-32f4-ea11-b882-24ee9a37d45c","Corona Arts & Sciences Academy - Q311 - Q311 - 24Q311 - 98-11 44TH AVENUE","36c73b4a-32f4-ea11-b882-24ee9a37d45c",-73865239,40745920,"P.S./ I.S. 311 - QUEENS","98-11 44TH AVENUE"
4,3,1,"fbfb3df4-30f4-ea11-b882-24ee9a37d45c","Edward R. Murrow High School - K525 - K525 - 21K525 - 1600 AVENUE L","fafb3df4-30f4-ea11-b882-24ee9a37d45c",-73959141,40619671,"EDWARD R. MURROW HS - K","1600 AVENUE L"
3,0,3,"0ba198c3-30f4-ea11-b882-24ee9a37d45c","Hyde Leadership Charter School - Brooklyn - K769 - K328 - 84K769 - 330 ALABAMA AVENUE","0ca198c3-30f4-ea11-b882-24ee9a37d45c",-73898249,40667985,"P.S. 328 - BROOKLYN","330 ALABAMA AVENUE"
1,1,0,"11f32ce2-31f4-ea11-b882-24ee9a37d45c","The 30th Avenue School (G&T Citywide) - Q300 - Q017 - 30Q300 - 28-37 29 STREET","0af32ce2-31f4-ea11-b882-24ee9a37d45c",-73922544,40768034,"P.S. 17 - QUEENS","28-37 29 STREET"
2,1,1,"790e6e25-32f4-ea11-b882-24ee9a37d45c","P.S. 166 Henry Gradstein - Q166 - Q166 - 30Q166 - 33-09 35 AVENUE","7a0e6e25-32f4-ea11-b882-24ee9a37d45c",-73926249,40757497,"P.S. 166 - QUEENS","33-09 35 AVENUE"
1,0,1,"674accc4-ebf6-ea11-b883-24ee9a37d459","P.S. Q255 - Q255 - Q885 - 75Q255 - 35-59 81ST STREET","d511f898-32f4-ea11-b882-24ee9a37d45c",-73884817,40749934,"RENAISSANCE CHARTER SCHOOL - Q","35-59 81ST STREET"
1,0,1,"40b4977a-32f4-ea11-b882-24ee9a37d45c","Queens Technical High School - Q600 - Q600 - 24Q600 - 37-02 47 AVENUE","41b4977a-32f4-ea11-b882-24ee9a37d45c",-73927995,40741658,"QUEENS VOC HS - Q","37-02 47 AVENUE"
1,0,1,"0fc0c20d-ecf6-ea11-b883-24ee9a37d459","P.S. 723 - X723 - X909 - 75X723 - 516 EAST TREMONT AVENUE","48ff3d8d-33f4-ea11-b882-24ee9a37d45c",-73896596,40846495,"Arthur Avenue Educational Building","516 EAST TREMONT AVENUE"
1,1,0,"d03159fa-30f4-ea11-b882-24ee9a37d45c","Sunset Park High School - K667 - K564 - 15K667 - 153 35 Street","18fc3df4-30f4-ea11-b882-24ee9a37d45c",-74004342,40655583,"SUNSET PARK HS - BROOKLYN","153 35 Street"
2,0,2,"a872c880-32f4-ea11-b882-24ee9a37d45c","Queens Transition Center - Q752 - Q690 - 75Q752 - 116-25 GUY R BREWER BOULEVARD","a972c880-32f4-ea11-b882-24ee9a37d45c",-73783438,40685838,"HS FOR LAW ENFORCEMENT - QUEENS","116-25 GUY R BREWER BOULEVARD"
3,0,3,"a132c3fb-eaf6-ea11-b883-24ee9a37d459","P.S. 085 Judge Charles Vallone - Q085 - Q085 - 30Q085 - 23-70 31 STREET","0a7eed06-32f4-ea11-b882-24ee9a37d45c",-73915039,40773126,"P.S. 85 - QUEENS","23-70 31 STREET"
4,2,2,"e68521d0-32f4-ea11-b882-24ee9a37d45c","I.S. 075 Frank D. Paulo - R075 - R075 - 31R075 - 455 HUGUENOT AVENUE","e28521d0-32f4-ea11-b882-24ee9a37d45c",-74197033,40544535,"I.S. 75 - STATEN ISLAND","455 HUGUENOT AVENUE"
2,1,1,"02cf496e-31f4-ea11-b882-24ee9a37d45c","Pace High School - M298 - M131 - 02M298 - 100 HESTER STREET","03cf496e-31f4-ea11-b882-24ee9a37d45c",-73993607,40716231,"I.S. 131 - MANHATTAN","100 HESTER STREET"
2,2,0,"cf2ff20c-32f4-ea11-b882-24ee9a37d45c","P.S./I.S. 116 William C. Hughley - Q116 - Q116 - 29Q116 - 107-25 WREN PLACE","d02ff20c-32f4-ea11-b882-24ee9a37d45c",-73781839,40700840,"P.S. 116 - QUEENS","107-25 WREN PLACE"
1,1,0,"53fdc1bd-32f4-ea11-b882-24ee9a37d45c","P.S. 78 - R078 - R014 - 31R078 - 35 Hill Street","46fdc1bd-32f4-ea11-b882-24ee9a37d45c",-74079228,40622415,"P.S. 14 - STATEN ISLAND","35 Hill Street"
2,0,2,"d3968d36-30f4-ea11-b882-24ee9a37d45c","P.S. 018 Edward Bush - K018 - K018 - 14K018 - 101 MAUJER STREET","d4968d36-30f4-ea11-b882-24ee9a37d45c",-73946695,40710880,"P.S. 18 - BROOKLYN","101 MAUJER STREET"
4,0,4,"e221d292-30f4-ea11-b882-24ee9a37d45c","P.S. 224 Hale A. Woodruff - K224 - K224 - 19K224 - 757 WORTMAN AVENUE","e121d292-30f4-ea11-b882-24ee9a37d45c",-73866542,40664143,"P.S. 224 - BROOKLYN","757 WORTMAN AVENUE"
1,0,1,"ac8fd48d-ebf6-ea11-b883-24ee9a37d459","P.S. Q233 - Q233 - Q042 - 75Q233 - 488 Beach 66 Street","ea8442ee-31f4-ea11-b882-24ee9a37d45c",-73794804,40594358,"P.S. 42 - QUEENS","488 Beach 66 Street"
2,0,2,"9072c880-32f4-ea11-b882-24ee9a37d45c","Eagle Academy for Young Men III - Q327 - Q633 - 29Q327 - 171-10 Linden Boulevard","9172c880-32f4-ea11-b882-24ee9a37d45c",-73778924,40691720,"EAGLE ACADEMY - QUEENS","171-10 Linden Boulevard"
3,3,0,"1f7eed06-32f4-ea11-b882-24ee9a37d45c","P.S. 091 Richard Arkwright - Q091 - Q091 - 24Q091 - 68-10 CENTRAL AVE","207eed06-32f4-ea11-b882-24ee9a37d45c",-73883995,40703503,"P.S. 91 - QUEENS","68-10 CENTRAL AVE"
2,1,1,"1878931f-33f4-ea11-b882-24ee9a37d45c","P.S. 310 Marble Hill - X310 - X122 - 10X310 - 260 W KINGSBRIDGE RD","1978931f-33f4-ea11-b882-24ee9a37d45c",-73905547,40872477,"P.S. 310 - BRONX","260 W KINGSBRIDGE RD"
1,1,0,"ba72c880-32f4-ea11-b882-24ee9a37d45c","Information Technology High School - Q502 - Q725 - 30Q502 - 21-16 44th Road","b972c880-32f4-ea11-b882-24ee9a37d45c",-73946488,40748502,"HS FOR INFORMATION TECH - QUEENS","21-16 44th Road"
1,1,0,"673cbf01-ebf6-ea11-b883-24ee9a37d459","P.S. X596 - X596 - X178 - 75X596 - 850 BAYCHESTER AVENUE","e38a0044-33f4-ea11-b882-24ee9a37d45c",-73831669,40874035,"P.S. 178 - BRONX","850 BAYCHESTER AVENUE"
2,1,1,"d479df48-30f4-ea11-b882-24ee9a37d45c","Community Roots Charter School - K536 - K067 - 84K536 - 51 SAINT EDWARDS STREET","d179df48-30f4-ea11-b882-24ee9a37d45c",-73977674,40695339,"P.S. 67 - BROOKLYN","51 SAINT EDWARDS STREET"
1,1,0,"4f474313-33f4-ea11-b882-24ee9a37d45c","P.S. 100 Isaac Clason - X100 - X100 - 08X100 - 800 TAYLOR AVENUE","50474313-33f4-ea11-b882-24ee9a37d45c",-73862760,40822552,"P.S. 100 - BRONX","800 TAYLOR AVENUE"
2,1,1,"307eed06-32f4-ea11-b882-24ee9a37d45c","P.S. 097 Forest Park - Q097 - Q097 - 27Q097 - 85-52 85 STREET","317eed06-32f4-ea11-b882-24ee9a37d45c",-73860031,40694232,"P.S. 97 - QUEENS","85-52 85 STREET"
2,1,1,"2cff3d8d-33f4-ea11-b882-24ee9a37d45c","Health Opportunities High School - X670 - X884 - 07X670 - 350 Gerard Avenue","2dff3d8d-33f4-ea11-b882-24ee9a37d45c",-73929960,40815712,"HEALTH OPPORTUNITIES HS - X","350 Gerard Avenue"
2,1,1,"bbfab455-31f4-ea11-b882-24ee9a37d45c","James Weldon Johnson - M057 - M057 - 04M057 - 176 EAST 115 STREET","bcfab455-31f4-ea11-b882-24ee9a37d45c",-73941598,40797205,"P.S. 57 - MANHATTAN","176 EAST 115 STREET"
2,0,2,"64977d2b-32f4-ea11-b882-24ee9a37d45c","J.H.S. 185 Edward Bleeker - Q185 - Q185 - 25Q185 - 147-26 25 DRIVE","ae0e6e25-32f4-ea11-b882-24ee9a37d45c",-73818607,40774906,"J.H.S. 185 - QUEENS","147-26 25 DRIVE"
2,1,1,"6e36d900-33f4-ea11-b882-24ee9a37d45c","P.S. 056 Norwood Heights - X056 - X056 - 10X056 - 341 EAST 207 STREET","6f36d900-33f4-ea11-b882-24ee9a37d45c",-73874912,40875481,"P.S. 56 - BRONX","341 EAST 207 STREET"
3,0,3,"3a0410ca-32f4-ea11-b882-24ee9a37d45c","P.S. 055 Henry M. Boehm - R055 - R055 - 31R055 - 54 OSBORNE STREET","3b0410ca-32f4-ea11-b882-24ee9a37d45c",-74163037,40536625,"P.S. 55 - STATEN ISLAND","54 OSBORNE STREET"
1,0,1,"eeb98b86-30f4-ea11-b882-24ee9a37d45c","P.S. 195 Manhattan Beach - K195 - K195 - 22K195 - 131 IRWIN STREET","efb98b86-30f4-ea11-b882-24ee9a37d45c",-73943498,40580161,"P.S. 195 - BROOKLYN","131 IRWIN STREET"
1,0,1,"f89b4c1f-32f4-ea11-b882-24ee9a37d45c","P.S. 160 Walter Francis Bishop - Q160 - Q160 - 28Q160 - 109-59 INWOOD STREET","ee9b4c1f-32f4-ea11-b882-24ee9a37d45c",-73799685,40688373,"P.S. 160 - QUEENS","109-59 INWOOD STREET"
3,2,1,"fbf22ce2-31f4-ea11-b882-24ee9a37d45c","I.S. 010 Horace Greeley - Q010 - Q010 - 30Q010 - 45-11 31st Ave","fcf22ce2-31f4-ea11-b882-24ee9a37d45c",-73911962,40760122,"I.S. 10 - QUEENS","45-11 31st Ave"
2,2,0,"9f476368-32f4-ea11-b882-24ee9a37d45c","Flushing High School - Q460 - Q460 - 25Q460 - 35-01 UNION STREET","97476368-32f4-ea11-b882-24ee9a37d45c",-73826811,40764892,"FLUSHING HS - Q","35-01 UNION STREET"
2,0,2,"bab36d80-30f4-ea11-b882-24ee9a37d45c","The SEEALL Academy - K180 - K180 - 20K180 - 5601 16 AVENUE","b8b36d80-30f4-ea11-b882-24ee9a37d45c",-73989250,40626454,"P.S. 180 - BROOKLYN","5601 16 AVENUE"
3,2,1,"6373198d-e31e-eb11-b885-24ee9a37d45c","American Dream Charter School - X471 - XAXQ - 84X471 - 403 Concord Avenue","a7845cb8-33f4-ea11-b882-24ee9a37d45c",-73909595,40809100,"Heketi Community Charter School","403 Concord Avenue"
2,2,0,"8407e99e-31f4-ea11-b882-24ee9a37d45c","Manhattan / Hunter Science High School - M541 - M490 - 03M541 - 122 AMSTERDAM AVENUE","7c07e99e-31f4-ea11-b882-24ee9a37d45c",-73985608,40774891,"MARTIN LUTHER KING, JR. HS - M","122 AMSTERDAM AVENUE"
2,2,0,"d8b36d80-30f4-ea11-b882-24ee9a37d45c","P.S. 189 The Bilingual Center - K189 - K189 - 17K189 - 1100 EAST NEW YORK AVENUE","d7b36d80-30f4-ea11-b882-24ee9a37d45c",-73925435,40665228,"P.S. 189 - BROOKLYN","1100 EAST NEW YORK AVENUE"
1,1,0,"c52ff20c-32f4-ea11-b882-24ee9a37d45c","P.S./I.S. 113 Anthony J. Pranzo - Q113 - Q113 - 24Q113 - 78-23 87TH STREET","c62ff20c-32f4-ea11-b882-24ee9a37d45c",-73861493,40705476,"P.S./I.S. 113 - QUEENS","78-23 87TH STREET"
1,0,1,"f61aad3c-30f4-ea11-b882-24ee9a37d45c","Success Academy Charter School - Bed Stuy 1 - K367 - K033 - 84K367 - 70 Tompkins Avenue","eb1aad3c-30f4-ea11-b882-24ee9a37d45c",-73947557,40696698,"I.S. 33 - BROOKLYN","70 Tompkins Avenue"
2,0,2,"93611579-4afb-ea11-b883-24ee9a37d459","Independent Kidz Daycare, Inc. - QBNV - QBNV -  - 63-49 Alderton Street","94611579-4afb-ea11-b883-24ee9a37d459",-73865401,0,"Independent Kidz Daycare, Inc.","63-49 Alderton Street"
2,0,2,"882aa42b-33f4-ea11-b882-24ee9a37d45c","P186X Walter J. Damrosch School - X186 - X136 - 75X186 - 750 Jennings Street","892aa42b-33f4-ea11-b882-24ee9a37d45c",-73897797,40831388,"P.S. 186 (OLD J136) - BRONX","750 Jennings Street"
3,0,3,"f92ece86-32f4-ea11-b882-24ee9a37d45c","Success Academy Charter School - South Jamaica - Q374 - Q781 - 84Q374 - 120-27 141st Street","fa2ece86-32f4-ea11-b882-24ee9a37d45c",-73799756,40675626,"John Adams HS Annex - Queens","120-27 141st Street"
3,3,0,"ace657bd-30f4-ea11-b882-24ee9a37d45c","P.S. 321 William Penn - K321 - K321 - 15K321 - 180 7 AVENUE","ade657bd-30f4-ea11-b882-24ee9a37d45c",-73978633,40671816,"P.S. 321 - BROOKLYN","180 7 AVENUE"
6,4,2,"87e2635c-32f4-ea11-b882-24ee9a37d45c","Benjamin N. Cardozo High School - Q415 - Q415 - 26Q415 - 57-00 223RD STREET","86e2635c-32f4-ea11-b882-24ee9a37d45c",-73757271,40752343,"BENJAMIN N. CARDOZO HS - Q","57-00 223RD STREET"
1,0,1,"18a6ba98-31f4-ea11-b882-24ee9a37d45c","Success Academy Charter School - Union Square - M174 - M460 - 84M174 - 40 IRVING PLACE","16a6ba98-31f4-ea11-b882-24ee9a37d45c",-73987064,40735361,"WASHINGTON IRVING HS - MANHATTAN","40 IRVING PLACE"
3,3,0,"70977d2b-32f4-ea11-b882-24ee9a37d45c","J.H.S. 189 Daniel Carter Beard - Q189 - Q189 - 25Q189 - 144-80 BARCLAY AVENUE","6b977d2b-32f4-ea11-b882-24ee9a37d45c",-73818399,40759963,"J.H.S. 189 - QUEENS","144-80 BARCLAY AVENUE"
2,0,2,"290b210d-33f4-ea11-b882-24ee9a37d45c","P.S. 196 - X196 - X077 - 12X196 - 1250 WARD AVENUE","230b210d-33f4-ea11-b882-24ee9a37d45c",-73877305,40830811,"P.S. 195 - BRONX","1250 WARD AVENUE"
2,2,0,"ceb36d80-30f4-ea11-b882-24ee9a37d45c","P.S. 185 Walter Kassenbrock - K185 - K185 - 20K185 - 8601 RIDGE BOULEVARD","cfb36d80-30f4-ea11-b882-24ee9a37d45c",-74033429,40623598,"P.S. 185 - BROOKLYN","8601 RIDGE BOULEVARD"
3,1,2,"c579df48-30f4-ea11-b882-24ee9a37d45c","J.H.S. 062 Ditmas - K062 - K062 - 20K062 - 700 Cortelyou Road","c479df48-30f4-ea11-b882-24ee9a37d45c",-73971153,40638087,"I.S. 62 - BROOKLYN","700 Cortelyou Road"
1,1,0,"21c73b4a-32f4-ea11-b882-24ee9a37d45c","Helen M. Marshall School - Q330 - Q287 - 24Q330 - 110-08 NORTHERN BOULEVARD","20c73b4a-32f4-ea11-b882-24ee9a37d45c",-73859202,40757888,"P.S. 330 - QUEENS","110-08 NORTHERN BOULEVARD"
1,1,0,"6f2f77fa-31f4-ea11-b882-24ee9a37d45c","P.S. 066 Jacqueline Kennedy Onassis - Q066 - Q066 - 27Q066 - 85-11 102 Street","702f77fa-31f4-ea11-b882-24ee9a37d45c",-73846135,40697941,"P.S. 66 - QUEENS","85-11 102 Street"
1,1,0,"3dc15a75-ebf6-ea11-b883-24ee9a37d459","Urban Assembly New York Harbor School - M551 - M871 - 02M551 - 134 CARDER ROAD","7bc280bd-31f4-ea11-b882-24ee9a37d45c",-74013582,40692063,"NYHS - BOATHOUSE","134 CARDER ROAD"
1,1,0,"3b88e6db-30f4-ea11-b882-24ee9a37d45c","Performing Arts and Technology High School - K507 - K435 - 19K507 - 400 PENNSYLVANIA AVENUE","3688e6db-30f4-ea11-b882-24ee9a37d45c",-73895122,40666868,"THOMAS JEFFERSON HS - K","400 PENNSYLVANIA AVENUE"
2,2,0,"89977d2b-32f4-ea11-b882-24ee9a37d45c","J.H.S. 194 William Carr - Q194 - Q194 - 25Q194 - 154-60 17 AVENUE","8a977d2b-32f4-ea11-b882-24ee9a37d45c",-73806990,40783231,"J.H.S. 194 - QUEENS","154-60 17 AVENUE"
2,2,0,"c5fab455-31f4-ea11-b882-24ee9a37d45c","East Side Community School - M450 - M060 - 01M450 - 420 East 12 Street","c1fab455-31f4-ea11-b882-24ee9a37d45c",-73982472,40729152,"J.H.S. 60 - MANHATTAN","420 East 12 Street"
1,0,1,"a948b1f5-eaf6-ea11-b883-24ee9a37d459","Success Academy Charter School - Harlem 1 - M351 - M149 - 84M351 - 34 West 118 Street","539f4974-31f4-ea11-b882-24ee9a37d45c",-73948088,40802649,"P.S. 149 (TANDEM M207) - MANHATTAN","34 West 118 Street"
2,2,0,"c20d3c5b-30f4-ea11-b882-24ee9a37d45c","P.S. 095 The Gravesend - K095 - K095 - 21K095 - 345 VAN SICKLEN STREET","c30d3c5b-30f4-ea11-b882-24ee9a37d45c",-73974664,40595996,"P.S. 95 - BROOKLYN","345 VAN SICKLEN STREET"
2,1,1,"6934aa92-31f4-ea11-b882-24ee9a37d45c","Success Academy Charter School - Washington Heights - M265 - M387 - 84M265 - 701 Fort Washington Avenue","6a34aa92-31f4-ea11-b882-24ee9a37d45c",-73935231,40857650,"Success Academy - Washington Heights","701 Fort Washington Avenue"
2,2,0,"a8d810ab-31f4-ea11-b882-24ee9a37d45c","Success Academy Charter School - Hell's Kitchen - M170 - M625 - 84M170 - 439 WEST 49TH STREET","a9d810ab-31f4-ea11-b882-24ee9a37d45c",-73990318,40763655,"HS OF GRAPHIC COMMUNICATION ARTS-M","439 WEST 49TH STREET"
1,1,0,"ffae0313-32f4-ea11-b882-24ee9a37d45c","Albert Shanker School for Visual and Performing Arts - Q126 - Q126 - 30Q126 - 31-51 21 STREET","f5ae0313-32f4-ea11-b882-24ee9a37d45c",-73929990,40766008,"I.S. 126 - QUEENS","31-51 21 STREET"
1,1,0,"58507380-31f4-ea11-b882-24ee9a37d45c","P.S./I.S. 187 Hudson Cliffs - M187 - M187 - 06M187 - 349 CABRINI BOULEVARD","59507380-31f4-ea11-b882-24ee9a37d45c",-73936840,40856239,"P.S./I.S. 187 - MANHATTAN","349 CABRINI BOULEVARD"
2,0,2,"e8ed94c3-31f4-ea11-b882-24ee9a37d45c","Beacon High School - M479 - M912 - 03M479 - 522 WEST 44TH STREET","e7ed94c3-31f4-ea11-b882-24ee9a37d45c",-73996262,40760858,"BEACON HIGH SCHOOL - MANHATTAN","522 WEST 44TH STREET"
3,3,0,"39a6ba98-31f4-ea11-b882-24ee9a37d45c","Frank McCourt High School - M417 - M470 - 03M417 - 145 WEST 84 STREET","33a6ba98-31f4-ea11-b882-24ee9a37d45c",-73974483,40786134,"LOUIS D. BRANDEIS HS - MANHATTAN","145 WEST 84 STREET"
1,0,1,"b0edf392-32f4-ea11-b882-24ee9a37d45c","P.S. 060 Woodhaven - Q060 - Q860 - 27Q060 - 91-02 88 AVENUE","b1edf392-32f4-ea11-b882-24ee9a37d45c",-73852792,40691467,"P.S. 60 MINISCHOOL - QUEENS","91-02 88 AVENUE"
2,2,0,"42a10a44-32f4-ea11-b882-24ee9a37d45c","New York City Academy for Discovery - Q306 - Q262 - 27Q306 - 95-16 89TH AVENUE","43a10a44-32f4-ea11-b882-24ee9a37d45c",-73848577,40691482,"P.S. 262 - QUEENS","95-16 89TH AVENUE"
1,1,0,"48507380-31f4-ea11-b882-24ee9a37d45c","Amistad Dual Language School - M311 - M176 - 06M311 - 4862 BROADWAY","46507380-31f4-ea11-b882-24ee9a37d45c",-73923818,40866381,"P.S./I.S. 176 - MANHATTAN","4862 BROADWAY"
1,0,1,"fe9dbaee-32f4-ea11-b882-24ee9a37d45c","P.S. 001 Courtlandt School - X001 - X001 - 07X001 - 335 EAST 152 STREET","ff9dbaee-32f4-ea11-b882-24ee9a37d45c",-73919634,40819331,"P.S. 1 - BRONX","335 EAST 152 STREET"
4,4,0,"d8e8ce00-32f4-ea11-b882-24ee9a37d45c","P.S. 079 Francis Lewis - Q079 - Q079 - 25Q079 - 147-27 15 DRIVE","d7e8ce00-32f4-ea11-b882-24ee9a37d45c",-73817338,40786201,"P.S. 79 - QUEENS","147-27 15 DRIVE"
1,1,0,"515bc58c-30f4-ea11-b882-24ee9a37d45c","P.S. 215 Morris H. Weiss - K215 - K215 - 21K215 - 415 AVENUE S","505bc58c-30f4-ea11-b882-24ee9a37d45c",-73970171,40602722,"P.S. 215 - BROOKLYN","415 AVENUE S"
1,1,0,"4f5bc58c-30f4-ea11-b882-24ee9a37d45c","P.S. K231 - K231 - K215 - 75K231 - 415 AVENUE S","505bc58c-30f4-ea11-b882-24ee9a37d45c",-73970171,40602722,"P.S. 215 - BROOKLYN","415 AVENUE S"
2,0,2,"2d6e3d68-31f4-ea11-b882-24ee9a37d45c","P.S. 38 Roberto Clemente - M038 - M121 - 04M038 - 232 EAST 103 STREET","2b6e3d68-31f4-ea11-b882-24ee9a37d45c",-73944762,40788668,"P.S. 38 (OLD M121) - MANHATTAN","232 EAST 103 STREET"
2,0,2,"f3f22ce2-31f4-ea11-b882-24ee9a37d45c","J.H.S. 008 Richard S. Grossley - Q008 - Q008 - 28Q008 - 108-35 167 STREET","f1f22ce2-31f4-ea11-b882-24ee9a37d45c",-73786403,40696910,"J.H.S. 8 - QUEENS","108-35 167 STREET"
4,3,1,"f06b62bb-25e6-eb11-b8b1-24ee9a37d45c","M.S. 935 - K935 - K667 - 19K935 - 76 Dinsmore Place","89afadd7-370e-eb11-a813-001dd8309fa8",-73875152,40680655,"District 19 S.T.E.M. Academies","76 Dinsmore Place"
1,1,0,"57042f6f-ebf6-ea11-b883-24ee9a37d459","Success Academy Charter School - Harlem 1 - M351 - M620 - 84M351 - 111 EAST 33RD STREET","a0d810ab-31f4-ea11-b882-24ee9a37d45c",-73981070,40746510,"NORMAN THOMAS HS (ECF) - MANHATTAN","111 EAST 33RD STREET"
13,0,13,"84476368-32f4-ea11-b882-24ee9a37d45c","Long Island City High School - Q450 - Q452 - 30Q450 - 14-30 BROADWAY","81476368-32f4-ea11-b882-24ee9a37d45c",-73933907,40765881,"LONG ISLAND CITY HS(NEW)-Q","14-30 BROADWAY"
1,0,1,"6241e65b-31f4-ea11-b882-24ee9a37d45c","Yorkville Community School - M151 - M066 - 02M151 - 421 East 88 Street","6341e65b-31f4-ea11-b882-24ee9a37d45c",-73947287,40777948,"RICHARD R GREEN HS OF TEACHING - M","421 East 88 Street"
4,4,0,"568946f4-31f4-ea11-b882-24ee9a37d45c","P.S. 043 - Q043 - Q043 - 27Q043 - 160 BEACH 29 STREET","ee8442ee-31f4-ea11-b882-24ee9a37d45c",-73761086,40593480,"P.S. 43 - QUEENS","160 BEACH 29 STREET"
6,2,4,"18474313-33f4-ea11-b882-24ee9a37d45c","P.S. 086 Kingsbridge Heights - X086 - X086 - 10X086 - 2756 RESERVOIR AVENUE","19474313-33f4-ea11-b882-24ee9a37d45c",-73897066,40869061,"P.S. 86 - BRONX","2756 RESERVOIR AVENUE"
1,1,0,"a072c880-32f4-ea11-b882-24ee9a37d45c","Young Women's Leadership School, Queens - Q896 - Q680 - 28Q896 - 150-91 87 ROAD","9d72c880-32f4-ea11-b882-24ee9a37d45c",-73804166,40708409,"YOUNG WOMENS' LEADERSHIP SCHOOL - QUEENS","150-91 87 ROAD"
1,0,1,"0206003e-32f4-ea11-b882-24ee9a37d45c","The Ivan Lafayette Early Childhood School of the Arts - Q228 - Q228 - 30Q228 - 32-63 93 STREET","0306003e-32f4-ea11-b882-24ee9a37d45c",-73874947,40756931,"P.S. 228 (ECC) - QUEENS","32-63 93 STREET"
1,1,0,"bb48b1f5-eaf6-ea11-b883-24ee9a37d459","School for Cooperative Technical Education - M645 - M646 - 79M645 - 321 East 96 Street","5e0c1bb1-31f4-ea11-b882-24ee9a37d45c",-73945647,40784112,"SCL COOP TECH ED (MNH VOC HS) - M","321 East 96 Street"
1,0,1,"f609e2e1-30f4-ea11-b882-24ee9a37d45c","Boys and Girls High School - K455 - K455 - 16K455 - 1700 FULTON STREET","f209e2e1-30f4-ea11-b882-24ee9a37d45c",-73931604,40678478,"BOYS & GIRLS HS - K","1700 FULTON STREET"
2,2,0,"692b3eee-30f4-ea11-b882-24ee9a37d45c","Franklin Delano Roosevelt High School - K505 - K505 - 20K505 - 5800 20 AVENUE","682b3eee-30f4-ea11-b882-24ee9a37d45c",-73982583,40621299,"FRANKLIN D. ROOSEVELT HS - K","5800 20 AVENUE"
1,1,0,"d3ba3c50-33f4-ea11-b882-24ee9a37d45c","P.S. 306 - X306 - X306 - 10X306 - 40 WEST TREMONT AVENUE","c0ba3c50-33f4-ea11-b882-24ee9a37d45c",-73910827,40850722,"P.S. 306 - BRONX","40 WEST TREMONT AVENUE"
1,0,1,"a532c3fb-eaf6-ea11-b883-24ee9a37d459","P.S. Q255 - Q255 - Q168 - 75Q255 - 158-40 76 ROAD","099c4c1f-32f4-ea11-b882-24ee9a37d45c",-73809380,40724195,"J.H.S. 168 - QUEENS","158-40 76 ROAD"
7,4,3,"b9b66262-32f4-ea11-b882-24ee9a37d45c","John Bowne High School - Q425 - Q425 - 25Q425 - 63-25 MAIN STREET","bab66262-32f4-ea11-b882-24ee9a37d45c",-73823841,40737448,"JOHN BOWNE HS - QUEENS","63-25 MAIN STREET"
2,0,2,"28e4d766-4afb-ea11-b883-24ee9a37d459","JCC Early Childhood - Richmond Ave. - RAER - RAFL -  - 2221 RICHMOND AVENUE","29e4d766-4afb-ea11-b883-24ee9a37d459",-74162386,40592771,"THE FORESIGHT SCHOOL","2221 RICHMOND AVENUE"
7,3,4,"df454b50-32f4-ea11-b882-24ee9a37d45c","P.S. 110 - Q110 - Q315 - 24Q110 - 43-18 97TH PLACE","de454b50-32f4-ea11-b882-24ee9a37d45c",-73866372,40745995,"P.S. 315 - Queens","43-18 97TH PLACE"
2,1,1,"8c0e6e25-32f4-ea11-b882-24ee9a37d45c","Irwin Altman Middle School 172 - Q172 - Q172 - 26Q172 - 81-14 257 Street","8d0e6e25-32f4-ea11-b882-24ee9a37d45c",-73713245,40741409,"J.H.S. 172 - QUEENS","81-14 257 Street"
2,1,1,"3d88e6db-30f4-ea11-b882-24ee9a37d45c","World Academy for Total Community Health High School - K510 - K435 - 19K510 - 400 PENNSYLVANIA AVENUE","3688e6db-30f4-ea11-b882-24ee9a37d45c",-73895122,40666868,"THOMAS JEFFERSON HS - K","400 PENNSYLVANIA AVENUE"
2,1,1,"2e0410ca-32f4-ea11-b882-24ee9a37d45c","I.S. 051 Edwin Markham - R051 - R051 - 31R051 - 80 WILLOWBROOK ROAD","2f0410ca-32f4-ea11-b882-24ee9a37d45c",-74145522,40623077,"I.S. 51 - STATEN ISLAND","80 WILLOWBROOK ROAD"
1,1,0,"c3c88e4f-31f4-ea11-b882-24ee9a37d45c","The Anderson School - M334 - M044 - 03M334 - 100 WEST 77 STREET","bfc88e4f-31f4-ea11-b882-24ee9a37d45c",-73977602,40780536,"I.S. 44 - MANHATTAN","100 WEST 77 STREET"
1,1,0,"e4aeb707-ecf6-ea11-b883-24ee9a37d459","Restart Academy - M973 - X655 -  - 455 SOUTHERN BLVD","99eb0e7b-33f4-ea11-b882-24ee9a37d45c",-73907528,40810671,"SAMUEL GOMPERS VOC HS - X","455 SOUTHERN BLVD"
1,0,1,"818d8486-31f4-ea11-b882-24ee9a37d45c","P.S. 77 Lower Lab School - M077 - M198 - 02M077 - 1700 3 AVENUE","7f8d8486-31f4-ea11-b882-24ee9a37d45c",-73950420,40785018,"P.S. 198 - MANHATTAN","1700 3 AVENUE"
1,0,1,"0dd1de79-30f4-ea11-b882-24ee9a37d45c","P.S. 177 The Marlboro - K177 - K177 - 21K177 - 346 AVENUE P","0ed1de79-30f4-ea11-b882-24ee9a37d45c",-73974425,40608169,"P.S. 177 - BROOKLYN","346 AVENUE P"
1,0,1,"e2b36d80-30f4-ea11-b882-24ee9a37d45c","P.S. 191 Paul Robeson - K191 - K191 - 17K191 - 1600 PARK PLACE","e0b36d80-30f4-ea11-b882-24ee9a37d45c",-73924127,40671730,"P.S. 191 - BROOKLYN","1600 PARK PLACE"
2,2,0,"35ebaa73-30f4-ea11-b882-24ee9a37d45c","P.S. 164 Caesar Rodney - K164 - K164 - 20K164 - 4211 14 AVENUE","36ebaa73-30f4-ea11-b882-24ee9a37d45c",-73985739,40637101,"P.S. 164 - BROOKLYN","4211 14 AVENUE"
3,2,1,"0aba8b86-30f4-ea11-b882-24ee9a37d45c","P.S. 203 Floyd Bennett School - K203 - K203 - 22K203 - 5101 AVENUE M","0bba8b86-30f4-ea11-b882-24ee9a37d45c",-73925732,40622108,"P.S. 203 - BROOKLYN","5101 AVENUE M"
2,1,1,"8f0e6e25-32f4-ea11-b882-24ee9a37d45c","P.S. 173 Fresh Meadows - Q173 - Q173 - 26Q173 - 174-10 67 AVENUE","900e6e25-32f4-ea11-b882-24ee9a37d45c",-73795651,40734097,"P.S. 173 - QUEENS","174-10 67 AVENUE"
1,1,0,"73593c87-33f4-ea11-b882-24ee9a37d45c","P.S. 196 - X196 - X823 - 12X196 - 1025 Morrison Avenue","34a31781-33f4-ea11-b882-24ee9a37d45c",-73874162,40824989,"I.S. 123 MINISCHOOL - BRONX","1025 Morrison Avenue"
1,1,0,"e8b98b86-30f4-ea11-b882-24ee9a37d45c","M.S. 582 - K582 - K196 - 14K582 - 207 BUSHWICK AVENUE","e9b98b86-30f4-ea11-b882-24ee9a37d45c",-73939385,40708804,"P.S. 196 - BROOKLYN","207 BUSHWICK AVENUE"
1,0,1,"e8c1392a-30f4-ea11-b882-24ee9a37d45c","Explore Charter School - K704 - K002 - 84K704 - 655 Parkside Avenue","dfc1392a-30f4-ea11-b882-24ee9a37d45c",-73951575,40656423,"I.S. 2 - BROOKLYN","655 Parkside Avenue"
2,0,2,"1ea6ba98-31f4-ea11-b882-24ee9a37d45c","Union Square Academy for Health Sciences - M533 - M460 - 02M533 - 40 IRVING PLACE","16a6ba98-31f4-ea11-b882-24ee9a37d45c",-73987064,40735361,"WASHINGTON IRVING HS - MANHATTAN","40 IRVING PLACE"
1,0,1,"d6d27c6d-30f4-ea11-b882-24ee9a37d45c","P.S. 145 Andrew Jackson - K145 - K145 - 32K145 - 100 NOLL STREET","d7d27c6d-30f4-ea11-b882-24ee9a37d45c",-73932388,40701107,"P.S. 145 - BROOKLYN","100 NOLL STREET"
1,1,0,"f037fba4-31f4-ea11-b882-24ee9a37d45c","P.S. 138 - M138 - M535 - 75M138 - 525 WEST 50TH STREET","f137fba4-31f4-ea11-b882-24ee9a37d45c",-73992700,40765474,"PARK WEST HS (ECF) - MANHATTAN","525 WEST 50TH STREET"
1,1,0,"8932c3fb-eaf6-ea11-b883-24ee9a37d459","P.S. 018 Park Terrace - M018 - M898 - 06M018 - 4124 9 Avenue","93c280bd-31f4-ea11-b882-24ee9a37d45c",-73911732,40871456,"P.S. 18 - MANHATTAN","4124 9 Avenue"
3,3,0,"89e657bd-30f4-ea11-b882-24ee9a37d45c","The Urban Assembly School for Law and Justice - K483 - K313 - 13K483 - 283 ADAMS STREET","82e657bd-30f4-ea11-b882-24ee9a37d45c",-73988323,40694629,"ADAMS STREET EDUCATIONAL CAMPUS - K","283 ADAMS STREET"
1,1,0,"6a5bc58c-30f4-ea11-b882-24ee9a37d45c","J.H.S. 220 John J. Pershing - K220 - K220 - 20K220 - 4812 9TH AVENUE","695bc58c-30f4-ea11-b882-24ee9a37d45c",-74001250,40640997,"I.S. 220 - BROOKLYN","4812 9TH AVENUE"
2,0,2,"be56635c-33f4-ea11-b882-24ee9a37d45c","Bronx River High School - X349 - X405 - 08X349 - 3000 EAST TREMONT AVENUE","b556635c-33f4-ea11-b882-24ee9a37d45c",-73839583,40839775,"HERBERT H. LEHMAN HS - X","3000 EAST TREMONT AVENUE"
1,0,1,"807eda5c-ebf6-ea11-b883-24ee9a37d459","P.S. M094 - M094 - M061 - 75M094 - 610 EAST 12 STREET","c8fab455-31f4-ea11-b882-24ee9a37d45c",-73978254,40727537,"P.S. 61 - MANHATTAN","610 EAST 12 STREET"
1,1,0,"c38442ee-31f4-ea11-b882-24ee9a37d45c","The Jermaine L. Green STEM Institute of Queens - Q354 - Q030 - 28Q354 - 126-10 BEDELL STREET","c48442ee-31f4-ea11-b882-24ee9a37d45c",-73774668,40679843,"P.S. 30 - QUEENS","126-10 BEDELL STREET"
3,3,0,"9fa9d9c3-32f4-ea11-b882-24ee9a37d45c","Marsh Avenue School for Expeditionary Learning - R063 - R043 - 31R063 - 100 ESSEX DRIVE","a0a9d9c3-32f4-ea11-b882-24ee9a37d45c",-74159343,40581958,"JEROME PARKER CAMPUS - S.I.","100 ESSEX DRIVE"
2,2,0,"ac2aa42b-33f4-ea11-b882-24ee9a37d45c","The New School for Leadership and Journalism - X244 - X143 - 10X244 - 120 WEST 231 STREET","ad2aa42b-33f4-ea11-b882-24ee9a37d45c",-73901565,40875636,"I.S. 143 - BRONX","120 WEST 231 STREET"
1,1,0,"270410ca-32f4-ea11-b882-24ee9a37d45c","The Eagle Academy for Young Men of Staten Island - R028 - R049 - 31R028 - 101 WARREN STREET","190410ca-32f4-ea11-b882-24ee9a37d45c",-74080695,40620443,"I.S. 49 - STATEN ISLAND","101 WARREN STREET"
2,1,1,"a332c3fb-eaf6-ea11-b883-24ee9a37d459","P.S. 131 Abigail Adams - Q131 - Q131 - 29Q131 - 170-21 84 Avenue","0eaf0313-32f4-ea11-b882-24ee9a37d45c",-73794061,40717150,"P.S. 131 - QUEENS","170-21 84 Avenue"
1,0,1,"db21d292-30f4-ea11-b882-24ee9a37d45c","P.S. 222 Katherine R. Snyder - K222 - K222 - 22K222 - 3301 QUENTIN ROAD","dc21d292-30f4-ea11-b882-24ee9a37d45c",-73939205,40614005,"P.S. 222 - BROOKLYN","3301 QUENTIN ROAD"
5,2,3,"6ca9d9c3-32f4-ea11-b882-24ee9a37d45c","I.S. 024 Myra S. Barnes - R024 - R024 - 31R024 - 750 DURANT AVENUE","5bfdc1bd-32f4-ea11-b882-24ee9a37d45c",-74145558,40545490,"I.S. 24 - STATEN ISLAND","750 DURANT AVENUE"
2,2,0,"f1b98b86-30f4-ea11-b882-24ee9a37d45c","P.S. 196 Ten Eyck - K196 - K196 - 14K196 - 207 BUSHWICK AVENUE","e9b98b86-30f4-ea11-b882-24ee9a37d45c",-73939385,40708804,"P.S. 196 - BROOKLYN","207 BUSHWICK AVENUE"
1,0,1,"e8d10307-33f4-ea11-b882-24ee9a37d45c","P.S. 068 Bronx - X068 - X068 - 11X068 - 4011 MONTICELLO AVENUE","e9d10307-33f4-ea11-b882-24ee9a37d45c",-73838880,40891603,"P.S. 68 - BRONX","4011 MONTICELLO AVENUE"
1,1,0,"b669c231-32f4-ea11-b882-24ee9a37d45c","P.S. 209 Clearview Gardens - Q209 - Q209 - 25Q209 - 16-10 Utopia Parkway","b569c231-32f4-ea11-b882-24ee9a37d45c",-73795845,40783777,"P.S. 209 - QUEENS","16-10 Utopia Parkway"
2,0,2,"13ff3d8d-33f4-ea11-b882-24ee9a37d45c","P.S. 205 Fiorello LaGuardia - X205 - X864 - 10X205 - 2375 SOUTHERN BOULEVARD","14ff3d8d-33f4-ea11-b882-24ee9a37d45c",-73882372,40853238,"P.S. 205B (ECF) - BRONX","2375 SOUTHERN BOULEVARD"
2,2,0,"4c8dbfcf-30f4-ea11-b882-24ee9a37d45c","Midwood High School - K405 - K405 - 22K405 - 2839 BEDFORD AVENUE","4d8dbfcf-30f4-ea11-b882-24ee9a37d45c",-73952356,40632829,"MIDWOOD HS - K","2839 BEDFORD AVENUE"
1,1,0,"778d8486-31f4-ea11-b882-24ee9a37d45c","KIPP Infinity Charter School - M336 - M195 - 84M336 - 625 WEST 133 STREET","758d8486-31f4-ea11-b882-24ee9a37d45c",-73956814,40819793,"TERENCE D. TOLBERT EDUCATION COMPLEX - MANHATTAN","625 WEST 133 STREET"
1,0,1,"8e69c231-32f4-ea11-b882-24ee9a37d45c","P.S. 199 Maurice A. Fitzgerald - Q199 - Q199 - 24Q199 - 39-20 48 Avenue","98977d2b-32f4-ea11-b882-24ee9a37d45c",-73926081,40739831,"P.S. 199 - QUEENS","39-20 48 Avenue"
2,1,1,"eef22ce2-31f4-ea11-b882-24ee9a37d45c","P.S. 007 Louis F. Simeone - Q007 - Q007 - 24Q007 - 80-55 CORNISH AVENUE","ecf22ce2-31f4-ea11-b882-24ee9a37d45c",-73882446,40739644,"P.S. 7 - QUEENS","80-55 CORNISH AVENUE"
2,1,1,"c1ab074a-33f4-ea11-b882-24ee9a37d45c","P.S. 205 Fiorello LaGuardia - X205 - X205 - 10X205 - 2475 Southern Boulevard","c2ab074a-33f4-ea11-b882-24ee9a37d45c",-73881753,40855759,"P.S. 205A (ECF) - BRONX","2475 Southern Boulevard"
2,0,2,"0a9c4c1f-32f4-ea11-b882-24ee9a37d45c","P.S. 165 Edith K. Bergtraum - Q165 - Q165 - 25Q165 - 70-35 150 Street","0b9c4c1f-32f4-ea11-b882-24ee9a37d45c",-73816966,40729746,"P.S. 165 - QUEENS","70-35 150 Street"
1,1,0,"c0e0838c-31f4-ea11-b882-24ee9a37d45c","East Side Elementary School, PS 267 - M267 - M267 - 02M267 - 213 EAST 63RD STREET","c1e0838c-31f4-ea11-b882-24ee9a37d45c",-73963861,40763883,"P.S. 59 - (MEETH) -MANHATTAN","213 EAST 63RD STREET"
2,2,0,"9969c231-32f4-ea11-b882-24ee9a37d45c","J.H.S. 202 Robert H. Goddard - Q202 - Q202 - 27Q202 - 138-30 LAFAYETTE STREET","9169c231-32f4-ea11-b882-24ee9a37d45c",-73845992,40670905,"I.S. 202 - QUEENS","138-30 LAFAYETTE STREET"
1,0,1,"17302ab1-49fb-ea11-b883-24ee9a37d459","SERFA M. GOMEZ DE HEREDIA - APT2C - XBIL - XBIL -  - 820 EAST 168 STREET","18302ab1-49fb-ea11-b883-24ee9a37d459",-73898340,40828488,"820 EAST 168 STREET","820 EAST 168 STREET"
1,0,1,"480b210d-33f4-ea11-b882-24ee9a37d45c","P.S. X811 - X811 - X084 - 75X811 - 1434 Longfellow Avenue","490b210d-33f4-ea11-b882-24ee9a37d45c",-73886798,40830552,"P.S. 811 (OLD I84) - BRONX","1434 Longfellow Avenue"
1,1,0,"58767649-31f4-ea11-b882-24ee9a37d45c","Urban Assembly School for the Performing Arts - M369 - M043 - 05M369 - 509 WEST 129 STREET","59767649-31f4-ea11-b882-24ee9a37d45c",-73955520,40815747,"I.S. 172 (OLD 43) - MANHATTAN","509 WEST 129 STREET"
3,3,0,"10b7c337-32f4-ea11-b882-24ee9a37d45c","P.S. 221 The North Hills School - Q221 - Q221 - 26Q221 - 57-40 MARATHON PARKWAY","11b7c337-32f4-ea11-b882-24ee9a37d45c",-73731518,40758808,"P.S. 221 - QUEENS","57-40 MARATHON PARKWAY"
1,1,0,"ddfab455-31f4-ea11-b882-24ee9a37d45c","N.Y.C. Lab School for Collaborative Studies - M412 - M070 - 02M412 - 333 WEST 17 STREET","defab455-31f4-ea11-b882-24ee9a37d45c",-74002222,40742512,"I.S. 70 - MANHATTAN","333 WEST 17 STREET"
2,2,0,"24ebaa73-30f4-ea11-b882-24ee9a37d45c","P.S./I.S. 157 The Benjamin Franklin Health & Science Academy - K157 - K157 - 14K157 - 850 KENT AVENUE","23ebaa73-30f4-ea11-b882-24ee9a37d45c",-73959999,40695397,"P.S. 157 - BROOKLYN","850 KENT AVENUE"
1,0,1,"fc09e2e1-30f4-ea11-b882-24ee9a37d45c","Nelson Mandela High School - K765 - K455 - 16K765 - 1700 FULTON STREET","f209e2e1-30f4-ea11-b882-24ee9a37d45c",-73931604,40678478,"BOYS & GIRLS HS - K","1700 FULTON STREET"
1,1,0,"d1f57030-30f4-ea11-b882-24ee9a37d45c","P.S. 007 Abraham Lincoln - K007 - K007 - 19K007 - 858 JAMAICA AVENUE","fcc1392a-30f4-ea11-b882-24ee9a37d45c",-73872983,40689213,"P.S. 7 - BROOKLYN","858 JAMAICA AVENUE"
1,1,0,"2bc73b4a-32f4-ea11-b882-24ee9a37d45c","P.S. 092 Harry T. Stewart Sr. - Q092 - Q292 - 30Q092 - 99-01 34 AVENUE","29c73b4a-32f4-ea11-b882-24ee9a37d45c",-73868773,40755983,"P.S. 92 - QUEENS","99-01 34 AVENUE"
1,0,1,"72c17bb2-e11e-eb11-b885-24ee9a37d45c","P.S. Q256 - Q256 - Q438 - 75Q256 - 445 Beach 135 Street","73c17bb2-e11e-eb11-b885-24ee9a37d45c",-73855146,40577474,"P.S. 256 ANNEX - QUEENS","445 Beach 135 Street"
1,0,1,"30e61462-31f4-ea11-b882-24ee9a37d45c","P.S. 138 - M138 - M090 - 75M138 - 21 JUMEL PLACE","2ce61462-31f4-ea11-b882-24ee9a37d45c",-73935815,40839139,"I.S. 90 - MANHATTAN","21 JUMEL PLACE"
1,1,0,"3ea10a44-32f4-ea11-b882-24ee9a37d45c","Pioneer Academy - Q307 - Q260 - 24Q307 - 40-20 100TH STREET","3da10a44-32f4-ea11-b882-24ee9a37d45c",-73865787,40749175,"P.S. 307- QUEENS","40-20 100TH STREET"
1,1,0,"2fff3d8d-33f4-ea11-b882-24ee9a37d45c","Community School for Social Justice - X427 - X884 - 07X427 - 350 Gerard Avenue","2dff3d8d-33f4-ea11-b882-24ee9a37d45c",-73929960,40815712,"HEALTH OPPORTUNITIES HS - X","350 Gerard Avenue"
2,1,1,"16a198c3-30f4-ea11-b882-24ee9a37d45c","P.S./I.S. 30 Mary White Ovington - K030 - K331 - 20K030 - 7002 4TH AVENUE","15a198c3-30f4-ea11-b882-24ee9a37d45c",-74023950,40633598,"P.S./I.S.30 MARY WHITE OVINGTON - BROOKLYN","7002 4TH AVENUE"
1,1,0,"0db7c337-32f4-ea11-b882-24ee9a37d45c","P.S. 220 Edward Mandel - Q220 - Q220 - 28Q220 - 62-10 108 STREET","0eb7c337-32f4-ea11-b882-24ee9a37d45c",-73852621,40736314,"P.S. 220 - QUEENS","62-10 108 STREET"
4,0,4,"1503cefa-32f4-ea11-b882-24ee9a37d45c","P.S. 042 Claremont - X042 - X042 - 09X042 - 1537 WASHINGTON AVENUE","1103cefa-32f4-ea11-b882-24ee9a37d45c",-73903243,40838636,"P.S. 42 - BRONX","1537 WASHINGTON AVENUE"
2,2,0,"8c886843-31f4-ea11-b882-24ee9a37d45c","P.S. 006 Lillie D. Blake - M006 - M006 - 02M006 - 45 EAST 81 STREET","8d886843-31f4-ea11-b882-24ee9a37d45c",-73960427,40777737,"P.S. 6 - MANHATTAN","45 EAST 81 STREET"
3,3,0,"7953dd74-33f4-ea11-b882-24ee9a37d45c","Bronx Bridges High School - X432 - X450 - 08X432 - 1980 LAFAYETTE AVENUE","62ffcc6e-33f4-ea11-b882-24ee9a37d45c",-73855930,40821218,"Adlai E. Stevenson Educational Campus","1980 LAFAYETTE AVENUE"
1,1,0,"277eed06-32f4-ea11-b882-24ee9a37d45c","P.S. 094 David D. Porter - Q094 - Q094 - 26Q094 - 41-77 Little Neck Parkway","287eed06-32f4-ea11-b882-24ee9a37d45c",-73738703,40771258,"P.S. 94 - QUEENS","41-77 Little Neck Parkway"
1,1,0,"7c03194f-30f4-ea11-b882-24ee9a37d45c","P.S. K141 - K141 - K071 - 75K141 - 215 HEYWARD STREET","7703194f-30f4-ea11-b882-24ee9a37d45c",-73953304,40703996,"I.S. 71 - BROOKLYN","215 HEYWARD STREET"
1,0,1,"9a886843-31f4-ea11-b882-24ee9a37d45c","Frederick Douglass Academy - M499 - M010 - 05M499 - 2581 7TH AVENUE","9b886843-31f4-ea11-b882-24ee9a37d45c",-73935746,40823988,"I.S. 10 (TANDEM M200) - MANHATTAN","2581 7TH AVENUE"
3,1,2,"02ee94c3-31f4-ea11-b882-24ee9a37d45c","Thurgood Marshall Academy for Learning and Social Change - M670 - M970 - 05M670 - 200-214 WEST 135TH STREET","03ee94c3-31f4-ea11-b882-24ee9a37d45c",-73944299,40815237,"THURGOOD MARSHALL ACAD. - M","200-214 WEST 135TH STREET"
2,2,0,"1ca6ba98-31f4-ea11-b882-24ee9a37d45c","International High School at Union Square - M438 - M460 - 02M438 - 40 IRVING PLACE","16a6ba98-31f4-ea11-b882-24ee9a37d45c",-73987064,40735361,"WASHINGTON IRVING HS - MANHATTAN","40 IRVING PLACE"
2,2,0,"f6ae0313-32f4-ea11-b882-24ee9a37d45c","P.S. 123 - Q123 - Q123 - 27Q123 - 145-01 119 AVENUE","f7ae0313-32f4-ea11-b882-24ee9a37d45c",-73795571,40678913,"P.S. 123 - QUEENS","145-01 119 AVENUE"
1,1,0,"e2ce496e-31f4-ea11-b882-24ee9a37d45c","Success Academy Charter School - Harlem 5 - M482 - M123 - 84M482 - 301 WEST 140 STREET","e3ce496e-31f4-ea11-b882-24ee9a37d45c",-73944551,40820216,"P.S. 123 - MANHATTAN","301 WEST 140 STREET"
2,2,0,"f9138e39-6a0c-ed11-b091-088e901ef405","Success Academy Charter School - Fort Greene - K752 - K297 - 84K752 - 700 PARK AVENUE","38de5eb7-30f4-ea11-b882-24ee9a37d45c",-73948166,40697377,"P.S. 297 - BROOKLYN","700 PARK AVENUE"
2,2,0,"5e8946f4-31f4-ea11-b882-24ee9a37d45c","P.S. 046 Alley Pond - Q046 - Q046 - 26Q046 - 64-45 218 STREET","5f8946f4-31f4-ea11-b882-24ee9a37d45c",-73758042,40745744,"P.S. 46 - QUEENS","64-45 218 STREET"
1,1,0,"d8315367-30f4-ea11-b882-24ee9a37d45c","P.S. 131 Brooklyn - K131 - K131 - 15K131 - 4305 FT HAMILTON PARKWAY","d9315367-30f4-ea11-b882-24ee9a37d45c",-73993247,40640728,"P.S. 131 - BROOKLYN","4305 FT HAMILTON PARKWAY"
1,0,1,"69fdc1bd-32f4-ea11-b882-24ee9a37d45c","P.S. 022 Graniteville - R022 - R022 - 31R022 - 1860 Forest Avenue","6afdc1bd-32f4-ea11-b882-24ee9a37d45c",-74150544,40624847,"P.S. 22 - STATEN ISLAND","1860 Forest Avenue"
3,2,1,"84a9d9c3-32f4-ea11-b882-24ee9a37d45c","P.S. 032 The Gifford School - R032 - R032 - 31R032 - 232 Barlow Avenue","80a9d9c3-32f4-ea11-b882-24ee9a37d45c",-74155400,40557900,"P.S. 32 - STATEN ISLAND","232 Barlow Avenue"
1,1,0,"e5ce496e-31f4-ea11-b882-24ee9a37d45c","P.S. 123 Mahalia Jackson - M123 - M123 - 05M123 - 301 WEST 140 STREET","e3ce496e-31f4-ea11-b882-24ee9a37d45c",-73944551,40820216,"P.S. 123 - MANHATTAN","301 WEST 140 STREET"
4,4,0,"8b476368-32f4-ea11-b882-24ee9a37d45c","Newtown High School - Q455 - Q455 - 24Q455 - 48-01 90 STREET","8c476368-32f4-ea11-b882-24ee9a37d45c",-73874129,40740824,"NEWTOWN HS - Q","48-01 90 STREET"
1,1,0,"ef9b4c1f-32f4-ea11-b882-24ee9a37d45c","J.H.S. 157 Stephen A. Halsey - Q157 - Q157 - 28Q157 - 63-55 102ND STREET","f09b4c1f-32f4-ea11-b882-24ee9a37d45c",-73852879,40732348,"J.H.S. 157 - QUEENS","63-55 102ND STREET"
1,1,0,"2e005d7a-31f4-ea11-b882-24ee9a37d45c","Mott Hall II - M862 - M165 - 03M862 - 234 West 109 Street","2f005d7a-31f4-ea11-b882-24ee9a37d45c",-73965949,40802653,"P.S. 165 - MANHATTAN","234 West 109 Street"
1,1,0,"26a198c3-30f4-ea11-b882-24ee9a37d45c","M.S. 890 - K890 - K338 - 22K890 - 21 HINCKLEY PLACE","27a198c3-30f4-ea11-b882-24ee9a37d45c",-73971010,40644861,"P.S. 338 - Brooklyn","21 HINCKLEY PLACE"
1,0,1,"2deabc42-30f4-ea11-b882-24ee9a37d45c","P.S. K141 - K141 - K054 - 75K141 - 195 SANDFORD STREET","2eeabc42-30f4-ea11-b882-24ee9a37d45c",-73952504,40692616,"P.S. 54 - BROOKLYN","195 SANDFORD STREET"
2,1,1,"f5c4bd60-4afb-ea11-b883-24ee9a37d459","Happy MaryAnn Day School - QBHP - QBHP -  - 132-18 41st Avenue","f6c4bd60-4afb-ea11-b883-24ee9a37d459",-73832993,40756623,"Happy MaryAnn Day School","132-18 41st Avenue"
1,1,0,"209ebaee-32f4-ea11-b882-24ee9a37d45c","P.S. X015 Institute for Environmental Learning - X015 - X015 - 10X015 - 2195 ANDREWS AVENUE","219ebaee-32f4-ea11-b882-24ee9a37d45c",-73909763,40859243,"P.S. 15 - BRONX","2195 ANDREWS AVENUE"
1,1,0,"ed17b7f4-32f4-ea11-b882-24ee9a37d45c","P.S. 024 Spuyten Duyvil - X024 - X024 - 10X024 - 660 WEST 236 STREET","ee17b7f4-32f4-ea11-b882-24ee9a37d45c",-73915114,40886922,"P.S. 24 - BRONX","660 WEST 236 STREET"
4,0,4,"d9883319-32f4-ea11-b882-24ee9a37d45c","P.S. 143 Louis Armstrong - Q143 - Q143 - 24Q143 - 34-74 113 Street","d7883319-32f4-ea11-b882-24ee9a37d45c",-73855715,40755393,"P.S. 143 - QUEENS","34-74 113 Street"
1,1,0,"8a41e65b-31f4-ea11-b882-24ee9a37d45c","P.S. 084 Lillian Weber - M084 - M084 - 03M084 - 32 West 92 Street","8b41e65b-31f4-ea11-b882-24ee9a37d45c",-73968419,40789479,"P.S. 84 - MANHATTAN","32 West 92 Street"
2,2,0,"f302cefa-32f4-ea11-b882-24ee9a37d45c","P.S. 032 Belmont - X032 - X032 - 10X032 - 690 EAST 183 STREET","f402cefa-32f4-ea11-b882-24ee9a37d45c",-73886220,40851724,"P.S. 32 - BRONX","690 EAST 183 STREET"
1,0,1,"0fa31781-33f4-ea11-b882-24ee9a37d45c","P.S. 315 Lab School - X315 - X779 - 10X315 - 2865 CLAFLIN AVENUE","10a31781-33f4-ea11-b882-24ee9a37d45c",-73900068,40873659,"Jerome Park Educational Building","2865 CLAFLIN AVENUE"
3,2,1,"df2ece86-32f4-ea11-b882-24ee9a37d45c","Bard High School Early College Queens - Q299 - Q735 - 24Q299 - 30-20 THOMSON AVENUE","db2ece86-32f4-ea11-b882-24ee9a37d45c",-73937004,40744175,"QUEENS HIGH SCHOOL COMPLEX - Q","30-20 THOMSON AVENUE"
5,2,3,"3088e6db-30f4-ea11-b882-24ee9a37d45c","Brooklyn Technical High School - K430 - K430 - 13K430 - 29 FT GREENE PLACE","3188e6db-30f4-ea11-b882-24ee9a37d45c",-73976435,40688896,"BROOKLYN TECH HS - K","29 FT GREENE PLACE"
1,0,1,"cdc88e4f-31f4-ea11-b882-24ee9a37d45c","P.S. 046 Arthur Tappan - M046 - M046 - 05M046 - 2987 FREDERICK DOUGLASS BOULEVARD","ccc88e4f-31f4-ea11-b882-24ee9a37d45c",-73936300,40830400,"P.S. 46 - MANHATTAN","2987 FREDERICK DOUGLASS BOULEVARD"
5,5,0,"90bc9674-32f4-ea11-b882-24ee9a37d45c","Hillcrest High School - Q505 - Q505 - 28Q505 - 160-05 HIGHLAND AVENUE","8fbc9674-32f4-ea11-b882-24ee9a37d45c",-73803001,40709461,"HILLCREST HS - Q","160-05 HIGHLAND AVENUE"
1,1,0,"1c005d7a-31f4-ea11-b882-24ee9a37d45c","Yorkville East Middle School - M177 - M158 - 02M177 - 1458 YORK AVENUE","1d005d7a-31f4-ea11-b882-24ee9a37d45c",-73950745,40770215,"P.S. 158 - MANHATTAN","1458 YORK AVENUE"
1,1,0,"f1ce496e-31f4-ea11-b882-24ee9a37d45c","KIPP S.T.A.R. College Preparatory Charter School - M726 - M125 - 84M726 - 433 WEST 123 STREET","edce496e-31f4-ea11-b882-24ee9a37d45c",-73955722,40810793,"P.S. 125 - MANHATTAN","425 WEST 123 STREET"
1,1,0,"05ee94c3-31f4-ea11-b882-24ee9a37d45c","Spruce Street School - M397 - M971 - 02M397 - 12 SPRUCE STREET","01ee94c3-31f4-ea11-b882-24ee9a37d45c",-74005473,40711321,"THE SPRUCE STREET EDUCATIONAL CAMPUS","12 SPRUCE STREET"
9,7,2,"59be7adc-32f4-ea11-b882-24ee9a37d45c","Susan E. Wagner High School - R460 - R460 - 31R460 - 1200 MANOR ROAD","5abe7adc-32f4-ea11-b882-24ee9a37d45c",-74130819,40588985,"SUSAN E. WAGNER HS - S. I.","1200 MANOR ROAD"
1,0,1,"5dfdc1bd-32f4-ea11-b882-24ee9a37d45c","P.S. 018 John G. Whittier - R018 - R018 - 31R018 - 221 Broadway","5efdc1bd-32f4-ea11-b882-24ee9a37d45c",-74116817,40636521,"P.S. 18 - STATEN ISLAND","221 Broadway"
3,1,2,"b948b1f5-eaf6-ea11-b883-24ee9a37d459","P.S. M721 - Manhattan Occupational Training Center - M721 - M641 - 75M721 - 250 West Houston Street","4d0c1bb1-31f4-ea11-b882-24ee9a37d45c",-74006155,40729052,"CITY-AS-SCHOOL(OLD 95) - MANHATTAN","250 West Houston Street"
1,1,0,"43767649-31f4-ea11-b882-24ee9a37d45c","P.S. 033 Chelsea Prep - M033 - M033 - 02M033 - 281 9 AVENUE","42767649-31f4-ea11-b882-24ee9a37d45c",-74000238,40749014,"P.S. 33 - MANHATTAN","281 9 AVENUE"
1,0,1,"ba17ab87-ebf6-ea11-b883-24ee9a37d459","P.S. Q255 - Q255 - Q007 - 75Q255 - 80-55 CORNISH AVENUE","ecf22ce2-31f4-ea11-b882-24ee9a37d45c",-73882446,40739644,"P.S. 7 - QUEENS","80-55 CORNISH AVENUE"
2,2,0,"2b0410ca-32f4-ea11-b882-24ee9a37d45c","P.S. 050 Frank Hankinson - R050 - R050 - 31R050 - 200 ADELAIDE AVENUE","2c0410ca-32f4-ea11-b882-24ee9a37d45c",-74124332,40560954,"P.S. 50 - STATEN ISLAND","200 ADELAIDE AVENUE"
1,1,0,"8653dd74-33f4-ea11-b882-24ee9a37d45c","Harry S Truman High School - X455 - X455 - 11X455 - 750 BAYCHESTER AVENUE","8253dd74-33f4-ea11-b882-24ee9a37d45c",-73831669,40874035,"HARRY S. TRUMAN HS - X","750 BAYCHESTER AVENUE"
1,0,1,"17cf496e-31f4-ea11-b882-24ee9a37d45c","P.S. 133 Fred R Moore - M133 - M133 - 05M133 - 2121 5 AVENUE","18cf496e-31f4-ea11-b882-24ee9a37d45c",-73939178,40809665,"P.S. 133 - MANHATTAN","2121 5 AVENUE"
3,2,1,"20eabc42-30f4-ea11-b882-24ee9a37d45c","J.H.S. 050 John D. Wells - K050 - K050 - 14K050 - 183 SOUTH 3 STREET","1feabc42-30f4-ea11-b882-24ee9a37d45c",-73960137,40711915,"J.H.S. 50 - BROOKLYN","183 SOUTH 3 STREET"
1,0,1,"8b32c3fb-eaf6-ea11-b883-24ee9a37d459","Teachers College Community School - M517 - M916 - 05M517 - 168 MORNINGSIDE AVENUE","f0ed94c3-31f4-ea11-b882-24ee9a37d45c",-73953317,40812428,"TEACHERS COLLEGE COMMUNITY SCHOOL - MANHATTAN","168 MORNINGSIDE AVENUE"
1,0,1,"d60d3c5b-30f4-ea11-b882-24ee9a37d45c","P.S. 101 The Verrazano - K101 - K101 - 21K101 - 8696 24 Avenue","d70d3c5b-30f4-ea11-b882-24ee9a37d45c",-73991962,40597379,"P.S. 101 - BROOKLYN","8696 24 Avenue"
1,0,1,"4a416e00-31f4-ea11-b882-24ee9a37d45c","Brooklyn's Daily Discovery Pre-K Center - K840 - K687 - 21K840 - 10 BOUCK COURT","4b416e00-31f4-ea11-b882-24ee9a37d45c",-73973728,40588759,"PRE-K CENTER @BOUCK COURT - BROOKLYN","10 BOUCK COURT"
1,1,0,"24e2abc9-30f4-ea11-b882-24ee9a37d45c","KIPP Always Mentally Prepared Charter School - K357 - K390 - 84K357 - 1224 PARK PLACE","25e2abc9-30f4-ea11-b882-24ee9a37d45c",-73937601,40672290,"I.S. 390 - BROOKLYN","1224 PARK PLACE"
1,1,0,"3d0410ca-32f4-ea11-b882-24ee9a37d45c","P.S. 56 The Louis Desario School - R056 - R056 - 31R056 - 250 KRAMER AVENUE","3e0410ca-32f4-ea11-b882-24ee9a37d45c",-74213943,40541856,"P.S. 56 - STATEN ISLAND","250 KRAMER AVENUE"
1,0,1,"ffb98b86-30f4-ea11-b882-24ee9a37d45c","P.S. 200 Benson School - K200 - K200 - 20K200 - 1940 BENSON AVENUE","00ba8b86-30f4-ea11-b882-24ee9a37d45c",-74001915,40602809,"P.S. 200 - BROOKLYN","1940 BENSON AVENUE"
1,0,1,"cd8521d0-32f4-ea11-b882-24ee9a37d45c","I.S. 061 William A Morris - R061 - R061 - 31R061 - 445 CASTLETON AVENUE","460410ca-32f4-ea11-b882-24ee9a37d45c",-74097941,40634497,"I.S. 61 - STATEN ISLAND","445 CASTLETON AVENUE"
2,2,0,"c548b1f5-eaf6-ea11-b883-24ee9a37d459","Urban Assembly New York Harbor School - M551 - M877 - 02M551 - 10 South Street, Slip 7","86c280bd-31f4-ea11-b882-24ee9a37d45c",-74018941,40689493,"NEW YORK HARBOR SCHOOL - MANHATTAN","10 South Street, Slip 7"
1,0,1,"ca85f462-ebf6-ea11-b883-24ee9a37d459","P.S. M811 - Mickey Mantle School - M811 - M149 - 75M811 - 34 West 118 Street","539f4974-31f4-ea11-b882-24ee9a37d45c",-73948088,40802649,"P.S. 149 (TANDEM M207) - MANHATTAN","34 West 118 Street"
2,1,1,"cc8442ee-31f4-ea11-b882-24ee9a37d45c","P.S. 033 Edward M. Funk - Q033 - Q033 - 29Q033 - 91-37 222 STREET","cd8442ee-31f4-ea11-b882-24ee9a37d45c",-73734102,40727172,"P.S. 33 - QUEENS","91-37 222 STREET"
1,1,0,"c837fba4-31f4-ea11-b882-24ee9a37d45c","Park East High School - M495 - M495 - 04M495 - 230 EAST 105 STREET","c737fba4-31f4-ea11-b882-24ee9a37d45c",-73944092,40790191,"PARK EAST HS - MANHATTAN","230 EAST 105 STREET"
1,1,0,"980e6e25-32f4-ea11-b882-24ee9a37d45c","P.S. 176 Cambria Heights - Q176 - Q176 - 29Q176 - 120-45 235 Street","990e6e25-32f4-ea11-b882-24ee9a37d45c",-73729226,40684987,"P.S. 176 - QUEENS","120-45 235 Street"
1,0,1,"86977d2b-32f4-ea11-b882-24ee9a37d45c","P.S. 193 Alfred J. Kennedy - Q193 - Q193 - 25Q193 - 152-20 11 AVENUE","87977d2b-32f4-ea11-b882-24ee9a37d45c",-73808987,40792053,"P.S. 193 - QUEENS","152-20 11 AVENUE"
2,1,1,"2baf0313-32f4-ea11-b882-24ee9a37d45c","P.S. 139 Rego Park - Q139 - Q139 - 28Q139 - 93-06 63 DRIVE","29af0313-32f4-ea11-b882-24ee9a37d45c",-73862561,40728012,"P.S. 139 - QUEENS","93-06 63 DRIVE"
2,2,0,"dcba3c50-33f4-ea11-b882-24ee9a37d45c","The STEAM Bridge School - X481 - X311 - 11X481 - 1684 WHITE PLAINS ROAD","daba3c50-33f4-ea11-b882-24ee9a37d45c",-73865498,40843531,"P.S. 311 - BRONX","1684 WHITE PLAINS ROAD"
1,0,1,"e411f898-32f4-ea11-b882-24ee9a37d45c","East River Academy - Q344 - Q902 - 79Q344 - 19-19 HAZEN ST","e311f898-32f4-ea11-b882-24ee9a37d45c",-73893300,40773500,"RMSC - QUEENS","19-19 HAZEN ST"
1,0,1,"f511a0be-ebf6-ea11-b883-24ee9a37d459","Mosaic Pre-K Center - Q331 - Q777 - 24Q331 - 50-15 44th Street","f22ece86-32f4-ea11-b882-24ee9a37d45c",-73921346,40736680,"PS 199 ANNEX(@ST. TERESA'S) - QUEENS","50-15 44th Street"
2,2,0,"668946f4-31f4-ea11-b882-24ee9a37d45c","P.S. 049 Dorothy Bonawit Kole - Q049 - Q049 - 24Q049 - 63-60 80th Street","678946f4-31f4-ea11-b882-24ee9a37d45c",-73875493,40719567,"P.S./I.S. 49 - QUEENS","63-60 80th Street"
1,1,0,"30ebaa73-30f4-ea11-b882-24ee9a37d45c","Success Academy Charter School - Crown Heights - K741 - K161 - 84K741 - 330 CROWN STREET","31ebaa73-30f4-ea11-b882-24ee9a37d45c",-73949243,40665757,"P.S. 161 - BROOKLYN","330 CROWN STREET"
1,0,1,"d7fab455-31f4-ea11-b882-24ee9a37d45c","P.S. 064 Robert Simon - M064 - M064 - 01M064 - 600 EAST 6 STREET","d3fab455-31f4-ea11-b882-24ee9a37d45c",-73981597,40723130,"P.S. 64 (OLD 71) - MANHATTAN","600 EAST 6 STREET"
1,1,0,"4c9d7c62-33f4-ea11-b882-24ee9a37d45c","High School of Language and Innovation - X509 - X415 - 11X509 - 925 ASTOR AVENUE","439d7c62-33f4-ea11-b882-24ee9a37d45c",-73860729,40860443,"CHRISTOPHER COLUMBUS HS - X","925 ASTOR AVENUE"
2,2,0,"16ba8b86-30f4-ea11-b882-24ee9a37d45c","P.S. 207 Elizabeth G. Leary - K207 - K207 - 22K207 - 4011 FILLMORE AVENUE","17ba8b86-30f4-ea11-b882-24ee9a37d45c",-73930485,40613981,"P.S. 207 - BROOKLYN","4011 FILLMORE AVENUE"
2,2,0,"009c4c1f-32f4-ea11-b882-24ee9a37d45c","P.S. 162 John Golden - Q162 - Q162 - 26Q162 - 201-02 53 AVENUE","019c4c1f-32f4-ea11-b882-24ee9a37d45c",-73776576,40748405,"P.S. 162 - QUEENS","201-02 53 AVENUE"
1,0,1,"48005d7a-31f4-ea11-b882-24ee9a37d45c","P.S. 175 Henry H Garnet - M175 - M175 - 05M175 - 175 WEST 134 STREET","47005d7a-31f4-ea11-b882-24ee9a37d45c",-73942706,40814388,"P.S. 175 - MANHATTAN","175 WEST 134 STREET"
2,2,0,"f5f22ce2-31f4-ea11-b882-24ee9a37d45c","The Emerson School - Q287 - Q008 - 28Q287 - 108-35 167 STREET","f1f22ce2-31f4-ea11-b882-24ee9a37d45c",-73786403,40696910,"J.H.S. 8 - QUEENS","108-35 167 STREET"
2,0,2,"400410ca-32f4-ea11-b882-24ee9a37d45c","P.S. 057 Hubert H. Humphrey - R057 - R057 - 31R057 - 140 PALMA DRIVE","410410ca-32f4-ea11-b882-24ee9a37d45c",-74083799,40611136,"P.S. 57 - STATEN ISLAND","140 PALMA DRIVE"
1,1,0,"8203194f-30f4-ea11-b882-24ee9a37d45c","East New York Middle School of Excellence - K678 - K072 - 19K678 - 605 SHEPHERD AVENUE","7e03194f-30f4-ea11-b882-24ee9a37d45c",-73879131,40669358,"P.S. 72 - BROOKLYN","605 SHEPHERD AVENUE"
4,4,0,"cf201dab-30f4-ea11-b882-24ee9a37d45c","P.S. 273 Wortman - K273 - K273 - 19K273 - 923 JEROME STREET","cb201dab-30f4-ea11-b882-24ee9a37d45c",-73879276,40658500,"P.S. 273 - BROOKLYN","923 JEROME STREET"
3,2,1,"db2ff20c-32f4-ea11-b882-24ee9a37d45c","P.S. 120 Queens - Q120 - Q120 - 25Q120 - 58-01 136 STREET","dc2ff20c-32f4-ea11-b882-24ee9a37d45c",-73828674,40745215,"P.S. 120 - QUEENS","58-01 136 STREET"
2,1,1,"d73159fa-30f4-ea11-b882-24ee9a37d45c","City Polytechnic High School of Engineering, Architecture, and Technology - K674 - K580 - 13K674 - 105 TECH PLACE","d33159fa-30f4-ea11-b882-24ee9a37d45c",-73986105,40695444,"GEORGE WESTINGHOUSE VOC HS - K","105 TECH PLACE"
2,0,2,"172ed53d-33f4-ea11-b882-24ee9a37d45c","P.S. 214 - X214 - X167 - 12X214 - 1970 WEST FARMS ROAD","152ed53d-33f4-ea11-b882-24ee9a37d45c",-73879931,40839297,"P.S. 214 - BRONX","1970 WEST FARMS ROAD"
2,1,1,"8c72c880-32f4-ea11-b882-24ee9a37d45c","Thomas A. Edison Career and Technical Education High School - Q620 - Q620 - 28Q620 - 165-65 84 AVENUE","49b4977a-32f4-ea11-b882-24ee9a37d45c",-73799692,40716071,"THOMAS A. EDISON VOC HS - Q","165-65 84 AVENUE"
2,2,0,"7707e99e-31f4-ea11-b882-24ee9a37d45c","P.S. 059 Beekman Hill International - M059 - M488 - 02M059 - 231-249 EAST 56 STREET","6d07e99e-31f4-ea11-b882-24ee9a37d45c",-73967204,40759248,"MIDTOWN EAST CAMPUS - MANHATTAN","231-249 EAST 56 STREET"
1,0,1,"45ef7338-ebf6-ea11-b883-24ee9a37d459","P.S. K053 - K053 - K437 - 75K053 - 713 CATON AVENUE","4488e6db-30f4-ea11-b882-24ee9a37d45c",-73973363,40647598,"P.S./I.S. 437 - BROOKLYN","713 CATON AVENUE"
2,2,0,"b9edf392-32f4-ea11-b882-24ee9a37d45c","P.S. 099 Kew Gardens - Q099 - Q866 - 28Q099 - 83-34 Kew Gardens Road","baedf392-32f4-ea11-b882-24ee9a37d45c",-73827276,40709492,"P.S. 99 ANNEX - QUEENS","83-34 Kew Gardens Road"
2,2,0,"4fa10a44-32f4-ea11-b882-24ee9a37d45c","P.S./I.S. 268 - Q268 - Q268 - 29Q268 - 92-07 175 STREET","4ea10a44-32f4-ea11-b882-24ee9a37d45c",-73785210,40707648,"P.S. 268 - QUEENS","92-07 175 STREET"
1,1,0,"367eed06-32f4-ea11-b882-24ee9a37d45c","P.S. 099 Kew Gardens - Q099 - Q099 - 28Q099 - 82-37 KEW GARDENS ROAD","377eed06-32f4-ea11-b882-24ee9a37d45c",-73827722,40711502,"P.S. 99 - QUEENS","82-37 KEW GARDENS ROAD"
10,9,1,"fdb6c337-32f4-ea11-b882-24ee9a37d45c","P.S. 214 Cadwallader Colden - Q214 - Q214 - 25Q214 - 31-15 140 STREET","feb6c337-32f4-ea11-b882-24ee9a37d45c",-73827606,40770215,"P.S. 214 - QUEENS","31-15 140 STREET"
1,1,0,"c25d45f1-85ef-eb11-b8b1-24ee9a37d45c","P.S. 168 - X168 - X151 - 75X168 - 250 EAST 156 STREET","c1bfa431-33f4-ea11-b882-24ee9a37d45c",-73921140,40822574,"I.S. 151 - BRONX","250 EAST 156 STREET"
1,1,0,"898946f4-31f4-ea11-b882-24ee9a37d45c","I.S. 059 Springfield Gardens - Q059 - Q059 - 29Q059 - 132-55 RIDGEDALE STREET","878946f4-31f4-ea11-b882-24ee9a37d45c",-73752772,40681881,"I.S. 59 - QUEENS","132-55 RIDGEDALE STREET"
2,2,0,"076e3d68-31f4-ea11-b882-24ee9a37d45c","Opportunity Charter School - M279 - M113 - 84M279 - 240 WEST 113 STREET","086e3d68-31f4-ea11-b882-24ee9a37d45c",-73955583,40801573,"P.S. 241 - MANHATTAN","240 WEST 113 STREET"
1,0,1,"610067b2-ebf6-ea11-b883-24ee9a37d459","P.S. Q811 - Q811 - Q430 - 75Q811 - 58-20 UTOPIA PARKWAY","bcb66262-32f4-ea11-b882-24ee9a37d45c",-73795049,40740875,"FRANCIS LEWIS HS - Q","58-20 UTOPIA PARKWAY"
2,0,2,"ea201dab-30f4-ea11-b882-24ee9a37d45c","P.S. 279 Herman Schreiber - K279 - K279 - 18K279 - 1070 EAST 104 STREET","e3201dab-30f4-ea11-b882-24ee9a37d45c",-73892797,40644134,"P.S. 279 - BROOKLYN","1070 EAST 104 STREET"
3,0,3,"7d2f77fa-31f4-ea11-b882-24ee9a37d45c","P.S. 070 - Q070 - Q070 - 30Q070 - 30-44 43rd Street","7b2f77fa-31f4-ea11-b882-24ee9a37d45c",-73913964,40761762,"P.S. 70 - QUEENS","30-44 43rd Street"
1,1,0,"75bc9674-32f4-ea11-b882-24ee9a37d45c","Grover Cleveland High School - Q485 - Q485 - 24Q485 - 21-27 HIMROD STREET","74bc9674-32f4-ea11-b882-24ee9a37d45c",-73909202,40711881,"GROVER CLEVELAND HS - Q","21-27 HIMROD STREET"
1,1,0,"db454b50-32f4-ea11-b882-24ee9a37d45c","M.S. 358 - Q358 - Q314 - 28Q358 - 88-08 164TH STREET","d5454b50-32f4-ea11-b882-24ee9a37d45c",-73797981,40708698,"P.S./ I.S. 314 - Queens","88-08 164TH STREET"
1,1,0,"c50d3c5b-30f4-ea11-b882-24ee9a37d45c","I.S. 096 Seth Low - K096 - K096 - 21K096 - 99 AVENUE P","c10d3c5b-30f4-ea11-b882-24ee9a37d45c",-73984985,40608135,"I.S. 96 - BROOKLYN","99 AVENUE P"
1,0,1,"7f53dd74-33f4-ea11-b882-24ee9a37d45c","ALC - Stevenson Campus - X996 - X450 - 88X996 - 1980 LAFAYETTE AVENUE","62ffcc6e-33f4-ea11-b882-24ee9a37d45c",-73855930,40821218,"Adlai E. Stevenson Educational Campus","1980 LAFAYETTE AVENUE"
1,0,1,"b20e93d5-49fb-ea11-b883-24ee9a37d459","Resurrection Ascension Catholic Academy - QAEN - QAEN -  - 85-25 61 ROAD","b30e93d5-49fb-ea11-b883-24ee9a37d459",-73872227,40728136,"RESURRECTION ASCENSION SCHOOL","85-25 61 ROAD"
1,0,1,"830e93d5-49fb-ea11-b883-24ee9a37d459","SAINT DOMINICS TORCH - XAPI - XAPI -  - 2340 ANDREWS AVE","840e93d5-49fb-ea11-b883-24ee9a37d459",-73906158,40862300,"SAINT DOMINICS TORCH","2340 ANDREWS AVE"
1,1,0,"197eed06-32f4-ea11-b882-24ee9a37d45c","P.S. 89Q: The Jose Peralta School of Dreamers - Q089 - Q089 - 24Q089 - 85-28 BRITTON AVENUE","1a7eed06-32f4-ea11-b882-24ee9a37d45c",-73879641,40745963,"P.S. 89 - QUEENS","85-28 BRITTON AVENUE"
1,0,1,"2f06003e-32f4-ea11-b882-24ee9a37d45c","The Active Learning Elementary School - Q244 - Q244 - 25Q244 - 137-20 FRANKLIN AVENUE","2b06003e-32f4-ea11-b882-24ee9a37d45c",-73826192,40754483,"P.S. 244 ECC (@ FRANKLIN AVE) - Q","137-20 FRANKLIN AVENUE"
2,1,1,"94a9d9c3-32f4-ea11-b882-24ee9a37d45c","P.S. 038 George Cromwell - R038 - R038 - 31R038 - 421 LINCOLN AVENUE","92a9d9c3-32f4-ea11-b882-24ee9a37d45c",-74099409,40574799,"P.S. 38 - STATEN ISLAND","421 LINCOLN AVENUE"
2,2,0,"e38521d0-32f4-ea11-b882-24ee9a37d45c","I.S. 072 Rocco Laurie - R072 - R072 - 31R072 - 33 FERNDALE AVENUE","e48521d0-32f4-ea11-b882-24ee9a37d45c",-74158618,40592132,"I.S. 72 - STATEN ISLAND","33 FERNDALE AVENUE"
1,1,0,"555bc58c-30f4-ea11-b882-24ee9a37d45c","P.S. 216 Arturo Toscanini - K216 - K216 - 21K216 - 350 AVENUE X","565bc58c-30f4-ea11-b882-24ee9a37d45c",-73969647,40590000,"P.S. 216 - BROOKLYN","350 AVENUE X"
1,1,0,"53ffcc6e-33f4-ea11-b882-24ee9a37d45c","World View High School - X353 - X440 - 10X353 - 100 WEST MOSHOLU PARKWAY SOUTH","4cffcc6e-33f4-ea11-b882-24ee9a37d45c",-73889011,40879958,"DEWITT CLINTON HS - X","100 WEST MOSHOLU PARKWAY SOUTH"
1,1,0,"d4f57030-30f4-ea11-b882-24ee9a37d45c","The Emily Warren Roebling School - K008 - K008 - 13K008 - 37 HICKS STREET","d5f57030-30f4-ea11-b882-24ee9a37d45c",-73992841,40700709,"P.S. 8 - BROOKLYN","37 HICKS STREET"
1,0,1,"1f6e3d68-31f4-ea11-b882-24ee9a37d45c","Tag Young Scholars - M012 - M117 - 04M012 - 240 EAST 109 STREET","1b6e3d68-31f4-ea11-b882-24ee9a37d45c",-73942285,40792556,"J.H.S. 117 - MANHATTAN","240 EAST 109 STREET"
1,0,1,"f38ac007-ebf6-ea11-b883-24ee9a37d459","P.S. X176 - X176 - X455 - 75X176 - 750 BAYCHESTER AVENUE","8253dd74-33f4-ea11-b882-24ee9a37d45c",-73831669,40874035,"HARRY S. TRUMAN HS - X","750 BAYCHESTER AVENUE"
1,0,1,"9948b1f5-eaf6-ea11-b883-24ee9a37d459","P.S. K134 - K134 - K849 - 22K134 - 4001 18 AVENUE","12d8cf12-31f4-ea11-b882-24ee9a37d45c",-73973180,40632145,"P.S. 134 - BROOKLYN","4001 18 AVENUE"
3,2,1,"16a31781-33f4-ea11-b882-24ee9a37d45c","Bronx Leadership Academy II High School - X527 - X790 - 07X527 - 730 CONCOURSE VILLAGE WEST","0ea31781-33f4-ea11-b882-24ee9a37d45c",-73922366,40821828,"MOTT HAVEN EDUCATIONAL CAMPUS - BRONX","730 CONCOURSE VILLAGE WEST"
1,0,1,"12a6ba98-31f4-ea11-b882-24ee9a37d45c","Liberty High School Academy for Newcomers - M550 - M451 - 02M550 - 250 WEST 18 STREET","13a6ba98-31f4-ea11-b882-24ee9a37d45c",-74000238,40741820,"LIBERTY HS - MANHATTAN","250 WEST 18 STREET"
1,1,0,"2aeabc42-30f4-ea11-b882-24ee9a37d45c","P.S. 052 Sheepshead Bay - K052 - K052 - 22K052 - 2675 EAST 29 STREET","26eabc42-30f4-ea11-b882-24ee9a37d45c",-73940135,40588372,"P.S. 52 - BROOKLYN","2675 EAST 29 STREET"
1,0,1,"15c0c20d-ecf6-ea11-b883-24ee9a37d459","Adult and Continuing Education - K755 - X953 - 79K755 - 3450 EAST TREMONT AVENUE","fa27b299-33f4-ea11-b882-24ee9a37d45c",-73827642,40831829,"AUXILIARY SERVICES HS - BRONX","3450 EAST TREMONT AVENUE"
1,1,0,"62a5db98-30f4-ea11-b882-24ee9a37d45c","Brooklyn School of Inquiry - K686 - K237 - 20K686 - 50 AVENUE P","5fa5db98-30f4-ea11-b882-24ee9a37d45c",-73986678,40606994,"LUCRETIA MARCIGLIANO CAMPUS - K","50 AVENUE P"
1,0,1,"e92ece86-32f4-ea11-b882-24ee9a37d45c","VOYAGES Preparatory - Q744 - Q744 - 24Q744 - 45-10 94th Street","e22ece86-32f4-ea11-b882-24ee9a37d45c",-73871505,40743228,"ELMHURST EDUCATIONAL CAMPUS - Q","45-10 94th Street"
2,2,0,"b272c880-32f4-ea11-b882-24ee9a37d45c","Robert F. Kennedy Community High School - Q670 - Q707 - 25Q670 - 75-40 PARSONS BOULEVARD","b372c880-32f4-ea11-b882-24ee9a37d45c",-73811408,40725280,"R. F. KENNEDY COMM. MIDDLE/HS-Q","75-40 PARSONS BOULEVARD"
3,0,3,"aefc24e8-31f4-ea11-b882-24ee9a37d45c","P.S. 021 Edward Hart - Q021 - Q021 - 25Q021 - 147-36 26 AVENUE","adfc24e8-31f4-ea11-b882-24ee9a37d45c",-73818581,40774134,"P.S. 21 - QUEENS","147-36 26 AVENUE"
1,0,1,"73a78d44-ebf6-ea11-b883-24ee9a37d459","P.S. K369 - Coy L. Cox School - K369 - K580 - 75K369 - 105 TECH PLACE","d33159fa-30f4-ea11-b882-24ee9a37d45c",-73986105,40695444,"GEORGE WESTINGHOUSE VOC HS - K","105 TECH PLACE"
1,1,0,"46de5eb7-30f4-ea11-b882-24ee9a37d45c","Vista Academy - K661 - K302 - 19K661 - 350 LINWOOD STREET","42de5eb7-30f4-ea11-b882-24ee9a37d45c",-73884211,40677112,"I.S. 302 - BROOKLYN","350 LINWOOD STREET"
2,2,0,"a2eb0e7b-33f4-ea11-b882-24ee9a37d45c","Crotona International High School - X524 - X660 - 10X524 - 2474 CROTONA AVENUE","a3eb0e7b-33f4-ea11-b882-24ee9a37d45c",-73882487,40855392,"GRACE H. DODGE VOC HS - X","2474 CROTONA AVENUE"
1,0,1,"bbab074a-33f4-ea11-b882-24ee9a37d45c","Urban Scholars Community School - X463 - X198 - 12X463 - 1180 TINTON AVENUE","baab074a-33f4-ea11-b882-24ee9a37d45c",-73900121,40828406,"P.S. 198 - BRONX","1180 TINTON AVENUE"
1,1,0,"380d6d19-33f4-ea11-b882-24ee9a37d45c","P.S. 105 Sen Abraham Bernstein - X105 - X105 - 11X105 - 725 Brady Avenue","390d6d19-33f4-ea11-b882-24ee9a37d45c",-73866264,40853075,"P.S. 105 - BRONX","725 Brady Avenue"
1,1,0,"b12aa42b-33f4-ea11-b882-24ee9a37d45c","Bronx Charter School for Better Learning II - X484 - X144 - 84X484 - 2545 GUNTHER AVENUE","b22aa42b-33f4-ea11-b882-24ee9a37d45c",-73836525,40863842,"I.S. 144 - BRONX","2545 GUNTHER AVENUE"
2,1,1,"9d476368-32f4-ea11-b882-24ee9a37d45c","Queens High School for Language Studies - Q241 - Q460 - 25Q241 - 35-01 UNION STREET","97476368-32f4-ea11-b882-24ee9a37d45c",-73826811,40764892,"FLUSHING HS - Q","35-01 UNION STREET"
1,1,0,"bdba3c50-33f4-ea11-b882-24ee9a37d45c","Mount Eden Children's Academy - X555 - X240 - 09X555 - 1501 JEROME AVENUE","baba3c50-33f4-ea11-b882-24ee9a37d45c",-73916084,40842503,"DOE NEW SETTLEMENT COMMUNITY CAMPUS - X","1501 JEROME AVENUE"
1,1,0,"0fead4e1-d214-ec11-b8b5-24ee9a37d45c","East New York Family Academy - K409 - K599 - 19K409 - 760 Van Siclen Avenue","7b3fd300-d214-ec11-b8b5-24ee9a37d45c",-73886668,40661102,"K599 – East New York","760 Van Siclen Avenue"
2,2,0,"ec968d36-30f4-ea11-b882-24ee9a37d45c","P.S. 024 - K024 - K024 - 15K024 - 427 38 STREET","ed968d36-30f4-ea11-b882-24ee9a37d45c",-74004533,40652832,"P.S. 24 - BROOKLYN","427 38 STREET"
1,0,1,"8f977d2b-32f4-ea11-b882-24ee9a37d45c","P.S. 196 Grand Central Parkway - Q196 - Q196 - 28Q196 - 71-25 113 STREET","90977d2b-32f4-ea11-b882-24ee9a37d45c",-73837379,40722792,"P.S. 196 - QUEENS","71-25 113 STREET"
3,0,3,"f6ce496e-31f4-ea11-b882-24ee9a37d45c","P.S. 126 Jacob August Riis - M126 - M126 - 02M126 - 80 CATHERINE STREET","f4ce496e-31f4-ea11-b882-24ee9a37d45c",-73997420,40710651,"P.S. 126 - MANHATTAN","80 CATHERINE STREET"
1,1,0,"c0fc24e8-31f4-ea11-b882-24ee9a37d45c","I.S. 025 Adrien Block - Q025 - Q025 - 25Q025 - 34-65 192 STREET","befc24e8-31f4-ea11-b882-24ee9a37d45c",-73789365,40764884,"J.H.S. 25 - QUEENS","34-65 192 STREET"
2,1,1,"ed8442ee-31f4-ea11-b882-24ee9a37d45c","P.S. Q256 - Q256 - Q043 - 75Q256 - 160 BEACH 29 STREET","ee8442ee-31f4-ea11-b882-24ee9a37d45c",-73761086,40593480,"P.S. 43 - QUEENS","160 BEACH 29 STREET"
2,1,1,"b68442ee-31f4-ea11-b882-24ee9a37d45c","P.S. 026 Rufus King - Q026 - Q026 - 26Q026 - 195-02 69 AVENUE","c5fc24e8-31f4-ea11-b882-24ee9a37d45c",-73777607,40735935,"P.S. 26 - QUEENS","195-02 69 AVENUE"
1,1,0,"e7f22ce2-31f4-ea11-b882-24ee9a37d45c","I.S. 5 - The Walter Crowley Intermediate School - Q005 - Q005 - 24Q005 - 50-40 JACOBUS STREET","9adc32dc-31f4-ea11-b882-24ee9a37d45c",-73888133,40737405,"I.S. 5 - QUEENS","50-40 JACOBUS STREET"
6,5,1,"da2ece86-32f4-ea11-b882-24ee9a37d45c","High School of Applied Communication - Q267 - Q735 - 24Q267 - 30-20 THOMSON AVENUE","db2ece86-32f4-ea11-b882-24ee9a37d45c",-73937004,40744175,"QUEENS HIGH SCHOOL COMPLEX - Q","30-20 THOMSON AVENUE"
1,1,0,"0618b7f4-32f4-ea11-b882-24ee9a37d45c","P.S./M.S. 029 Melrose School - X029 - X029 - 07X029 - 758 COURTLANDT AVENUE","0718b7f4-32f4-ea11-b882-24ee9a37d45c",-73916419,40821544,"P.S. 29 - BRONX","758 COURTLANDT AVENUE"
2,2,0,"bd0d3c5b-30f4-ea11-b882-24ee9a37d45c","P.S. 094 The Henry Longfellow - K094 - K094 - 15K094 - 5010 6 AVENUE","8fd92255-30f4-ea11-b882-24ee9a37d45c",-74008795,40643730,"P.S. 94 - BROOKLYN","5010 6 AVENUE"
1,1,0,"d39b4c1f-32f4-ea11-b882-24ee9a37d45c","P.S. 149 Christa McAuliffe - Q149 - Q149 - 30Q149 - 93-11 34 AVENUE","f3883319-32f4-ea11-b882-24ee9a37d45c",-73874505,40755759,"P.S. 149 - QUEENS","93-11 34 AVENUE"
8,8,0,"546e70b7-31f4-ea11-b882-24ee9a37d45c","Millennium High School - M418 - M824 - 02M418 - 75 BROAD STREET","760c1bb1-31f4-ea11-b882-24ee9a37d45c",-74011202,40704697,"MILLENNIUM HS - MANHATTAN","75 BROAD STREET"
2,2,0,"539d7c62-33f4-ea11-b882-24ee9a37d45c","Pan American International High School at Monroe - X388 - X420 - 12X388 - 1300 BOYNTON AVENUE","519d7c62-33f4-ea11-b882-24ee9a37d45c",-73878191,40832508,"JAMES MONROE EDUCATIONAL CAMPUS - X","1300 BOYNTON AVENUE"
1,1,0,"2fa198c3-30f4-ea11-b882-24ee9a37d45c","Frederick Douglass Academy VIII Middle School - K452 - K346 - 19K452 - 1400 PENNSYLVANIA AVENUE","30a198c3-30f4-ea11-b882-24ee9a37d45c",-73881997,40646640,"P.S. 346 - BROOKLYN","1400 PENNSYLVANIA AVENUE"
1,0,1,"9eeb0e7b-33f4-ea11-b882-24ee9a37d45c","H.E.R.O. High (Health, Education, and Research Occupations High School) - X259 - X655 - 07X259 - 455 SOUTHERN BLVD","99eb0e7b-33f4-ea11-b882-24ee9a37d45c",-73907528,40810671,"SAMUEL GOMPERS VOC HS - X","455 SOUTHERN BLVD"
2,2,0,"081bad3c-30f4-ea11-b882-24ee9a37d45c","P.S. 039 Henry Bristow - K039 - K039 - 15K039 - 417 6 AVENUE","091bad3c-30f4-ea11-b882-24ee9a37d45c",-73982909,40668644,"P.S. 39 - BROOKLYN","417 6 AVENUE"
1,1,0,"29a198c3-30f4-ea11-b882-24ee9a37d45c","P.S. 889 - K889 - K338 - 22K889 - 21 HINCKLEY PLACE","27a198c3-30f4-ea11-b882-24ee9a37d45c",-73971010,40644861,"P.S. 338 - Brooklyn","21 HINCKLEY PLACE"
1,1,0,"68e2635c-32f4-ea11-b882-24ee9a37d45c","Academy for Careers in Television and Film - Q301 - Q404 - 30Q301 - 1-50 51ST AVENUE","65e2635c-32f4-ea11-b882-24ee9a37d45c",-73959183,40742964,"HUNTERS POINT CAMPUS - QUEENS","1-50 51ST AVENUE"
2,2,0,"0ffc3df4-30f4-ea11-b882-24ee9a37d45c","All City Leadership Secondary School - K554 - K554 - 32K554 - 321 Palmetto Street","10fc3df4-30f4-ea11-b882-24ee9a37d45c",-73913172,40697378,"ALL CITY LEADERSHIP SECONDARY SCHOOL - BROOKLYN","321 Palmetto Street"
3,3,0,"9d69c231-32f4-ea11-b882-24ee9a37d45c","P.S. 203 Oakland Gardens - Q203 - Q203 - 26Q203 - 53-11 SPRINGFIELD BOULEVARD","9e69c231-32f4-ea11-b882-24ee9a37d45c",-73759822,40753606,"P.S. 203 - QUEENS","53-11 SPRINGFIELD BOULEVARD"
1,1,0,"4c416e00-31f4-ea11-b882-24ee9a37d45c","The School of Creativity and Innovation - K896 - K682 - 15K896 - 736 48TH STREET","4d416e00-31f4-ea11-b882-24ee9a37d45c",-74004306,40643018,"P.S. @ 736 48 STREET - BROOKLYN","736 48TH STREET"
1,0,1,"62be7adc-32f4-ea11-b882-24ee9a37d45c","Ralph R. McKee Career and Technical Education High School - R600 - R600 - 31R600 - 101 Belmont Place","5ebe7adc-32f4-ea11-b882-24ee9a37d45c",-74079263,40642820,"RALPH MCKEE VOC HS - S. I.","101 Belmont Place"
1,1,0,"c392e6d5-30f4-ea11-b882-24ee9a37d45c","Cultural Academy for the Arts and Sciences - K629 - K415 - 18K629 - 5800 TILDEN AVENUE","5b8dbfcf-30f4-ea11-b882-24ee9a37d45c",-73922212,40647728,"SAMUEL J. TILDEN EDUCATIONAL CAMPUS - K","5800 TILDEN AVENUE"
1,0,1,"e28442ee-31f4-ea11-b882-24ee9a37d45c","P.S. 040 Samuel Huntington - Q040 - Q040 - 28Q040 - 109-20 Union Hall Street","dd8442ee-31f4-ea11-b882-24ee9a37d45c",-73790975,40693559,"P.S. 40 (D28) - QUEENS","109-20 Union Hall Street"
2,2,0,"8b01ce37-33f4-ea11-b882-24ee9a37d45c","Bronx Latin - X267 - X158 - 12X267 - 800 HOME STREET","8601ce37-33f4-ea11-b882-24ee9a37d45c",-73900593,40826933,"I.S. 158 - BRONX","800 HOME STREET"
3,3,0,"502f7d06-31f4-ea11-b882-24ee9a37d45c","The Maurice Sendak Community School - K118 - K763 - 15K118 - 211 8TH STREET","512f7d06-31f4-ea11-b882-24ee9a37d45c",-73987602,40671145,"P.S. 118 MAURICE SENDAK COMMUNITY SCHOOL- BROOKLYN","211 8TH STREET"
2,2,0,"1ca31781-33f4-ea11-b882-24ee9a37d45c","Bronx Legacy High School - X625 - X790 - 07X625 - 730 CONCOURSE VILLAGE WEST","0ea31781-33f4-ea11-b882-24ee9a37d45c",-73922366,40821828,"MOTT HAVEN EDUCATIONAL CAMPUS - BRONX","730 CONCOURSE VILLAGE WEST"
1,0,1,"56db4f91-5920-ec11-b8bc-24ee9a37d45c","P.S. 033 Timothy Dwight - X033 - X347 - 10X033 - 2400 Jerome Avenue","57db4f91-5920-ec11-b8bc-24ee9a37d45c",-73901674,40961359,"P.S. 33 ANNEX - BRONX","2400 Jerome Avenue"
2,0,2,"090ae2e1-30f4-ea11-b882-24ee9a37d45c","Leadership Preparatory Bedford Stuyvesant Charter School - K517 - K458 - 84K517 - 832 MARCY AVENUE","050ae2e1-30f4-ea11-b882-24ee9a37d45c",-73947873,40684654,"BOYS HS (OLD) - K","832 MARCY AVENUE"
1,0,1,"b256635c-33f4-ea11-b882-24ee9a37d45c","Bronx Regional High School - X480 - X401 - 12X480 - 1010 REV. J. A. POLITE AVENUE","8ce03d56-33f4-ea11-b882-24ee9a37d45c",-73898265,40823124,"BRONX REGIONAL HS (OLD 133) - X","1010 REV. J. A. POLITE AVENUE"
1,0,1,"a6d810ab-31f4-ea11-b882-24ee9a37d45c","Unity Center for Urban Technologies - M500 - M620 - 02M500 - 111 EAST 33RD STREET","a0d810ab-31f4-ea11-b882-24ee9a37d45c",-73981070,40746510,"NORMAN THOMAS HS (ECF) - MANHATTAN","111 EAST 33RD STREET"
1,1,0,"0fc73b4a-32f4-ea11-b882-24ee9a37d45c","P.S. 273 - Q273 - Q273 - 27Q273 - 88-07 102ND STREET","10c73b4a-32f4-ea11-b882-24ee9a37d45c",-73844335,40693613,"P.S. 273 - QUEENS","88-07 102ND STREET"
1,1,0,"6ea5db98-30f4-ea11-b882-24ee9a37d45c","Andries Hudde - K240 - K240 - 22K240 - 2500 NOSTRAND AVENUE","69a5db98-30f4-ea11-b882-24ee9a37d45c",-73946836,40623788,"I.S. 240 - BROOKLYN","2500 NOSTRAND AVENUE"
1,1,0,"430410ca-32f4-ea11-b882-24ee9a37d45c","Space Shuttle Columbia School - R058 - R058 - 31R058 - 77 MARSH AVENUE","2a0410ca-32f4-ea11-b882-24ee9a37d45c",-74160867,40582791,"P.S. 58 - STATEN ISLAND","77 MARSH AVENUE"
2,1,1,"d79b4c1f-32f4-ea11-b882-24ee9a37d45c","P.S. 150 Queens - Q150 - Q150 - 30Q150 - 40-01 43 AVENUE","d89b4c1f-32f4-ea11-b882-24ee9a37d45c",-73923375,40745887,"P.S. 150 - QUEENS","40-01 43 AVENUE"
3,3,0,"c6b66262-32f4-ea11-b882-24ee9a37d45c","Business Technology Early College High School - Q315 - Q435 - 26Q315 - 230-17 HILLSIDE AVENUE","c4b66262-32f4-ea11-b882-24ee9a37d45c",-73739726,40733888,"MARTIN VAN BUREN HS - QUEENS","230-17 HILLSIDE AVENUE"
1,1,0,"6e2b3eee-30f4-ea11-b882-24ee9a37d45c","Brooklyn Community High School for Excellence and Equity - K566 - K515 - 18K566 - 6565 FLATLANDS AVENUE","6d2b3eee-30f4-ea11-b882-24ee9a37d45c",-73916927,40634451,"SOUTH SHORE EDUCATIONAL CAMPUS - K","6565 FLATLANDS AVENUE"
1,0,1,"fde1abc9-30f4-ea11-b882-24ee9a37d45c","P.S. 156 Waverly - K156 - K356 - 23K156 - 104 SUTTER AVENUE","35a198c3-30f4-ea11-b882-24ee9a37d45c",-73917880,40665553,"P.S. 156 - BROOKLYN","104 SUTTER AVENUE"
1,1,0,"e5d27c6d-30f4-ea11-b882-24ee9a37d45c","Brownsville Collegiate Charter School - K710 - K150 - 84K710 - 364 SACKMAN STREET","e6d27c6d-30f4-ea11-b882-24ee9a37d45c",-73905140,40668768,"P.S. 150 - BROOKLYN","364 SACKMAN STREET"
1,1,0,"725bc58c-30f4-ea11-b882-24ee9a37d45c","Urban Assembly School for Leadership and Empowerment - K609 - K223 - 20K609 - 4200 16 AVENUE","735bc58c-30f4-ea11-b882-24ee9a37d45c",-73982424,40635100,"I.S. 223 - BROOKLYN","4200 16 AVENUE"
1,1,0,"eace496e-31f4-ea11-b882-24ee9a37d45c","P.S. 124 Yung Wing - M124 - M124 - 02M124 - 40 DIVISION STREET","e8ce496e-31f4-ea11-b882-24ee9a37d45c",-73996017,40715097,"P.S. 124 (ECF) - MANHATTAN","40 DIVISION STREET"
1,1,0,"1aa6ba98-31f4-ea11-b882-24ee9a37d45c","The High School For Language And Diplomacy - M399 - M460 - 02M399 - 40 IRVING PLACE","16a6ba98-31f4-ea11-b882-24ee9a37d45c",-73987064,40735361,"WASHINGTON IRVING HS - MANHATTAN","40 IRVING PLACE"
2,2,0,"6b36d900-33f4-ea11-b882-24ee9a37d45c","Frederick Douglass Academy V. Middle School - X273 - X057 - 12X273 - 2111 CROTONA AVENUE","6c36d900-33f4-ea11-b882-24ee9a37d45c",-73888987,40848748,"P.S. 57 - BRONX","2111 CROTONA AVENUE"
2,1,1,"bde0838c-31f4-ea11-b882-24ee9a37d45c","Washington Heights Academy - M366 - M263 - 06M366 - 202 SHERMAN AVE","bee0838c-31f4-ea11-b882-24ee9a37d45c",-73921631,40865575,"PS/IS 263 - Manhattan","202 SHERMAN AVE"
1,0,1,"ba79df48-30f4-ea11-b882-24ee9a37d45c","P.S. 059 William Floyd - K059 - K059 - 14K059 - 211 THROOP AVENUE","b579df48-30f4-ea11-b882-24ee9a37d45c",-73943279,40697619,"P.S. 59 - BROOKLYN","211 THROOP AVENUE"
1,1,0,"33474313-33f4-ea11-b882-24ee9a37d45c","Ampark Neighborhood - X344 - X095 - 10X344 - 3961 HILLMAN AVENUE","34474313-33f4-ea11-b882-24ee9a37d45c",-73891664,40883049,"P.S. 95 - BRONX","3961 HILLMAN AVENUE"
1,1,0,"a169c231-32f4-ea11-b882-24ee9a37d45c","I.S. 204 Oliver W. Holmes - Q204 - Q204 - 30Q204 - 36-41 28 STREET","9c69c231-32f4-ea11-b882-24ee9a37d45c",-73932628,40756471,"I.S. 204 - QUEENS","36-41 28 STREET"
1,0,1,"1f70f999-ebf6-ea11-b883-24ee9a37d459","P.S. Q255 - Q255 - Q154 - 75Q255 - 75-02 162 Street","d69b4c1f-32f4-ea11-b882-24ee9a37d45c",-73807750,40726473,"P.S. 154 - QUEENS","75-02 162 Street"
1,0,1,"c82ff20c-32f4-ea11-b882-24ee9a37d45c","P.S./M.S. 114 Belle Harbor - Q114 - Q114 - 27Q114 - 134-01 CRONSTON AVENUE","c12ff20c-32f4-ea11-b882-24ee9a37d45c",-73854364,40577552,"P.S. 114 - QUEENS","134-01 CRONSTON AVENUE"
1,1,0,"81a9d9c3-32f4-ea11-b882-24ee9a37d45c","P.S. 031 William T. Davis - R031 - R031 - 31R031 - 55 LAYTON AVENUE","82a9d9c3-32f4-ea11-b882-24ee9a37d45c",-74085420,40642090,"P.S. 31 - STATEN ISLAND","55 LAYTON AVENUE"
1,1,0,"612f77fa-31f4-ea11-b882-24ee9a37d45c","I.S. 061 Leonardo Da Vinci - Q061 - Q061 - 24Q061 - 98-50 50 AVENUE","5f2f77fa-31f4-ea11-b882-24ee9a37d45c",-73862886,40741898,"I.S. 61 - QUEENS","98-50 50 AVENUE"
1,1,0,"d28a894e-4afb-ea11-b883-24ee9a37d459","Adventureland Child Care Center - QAYJ - QAYJ -  - 41-31 58TH STREET","d38a894e-4afb-ea11-b883-24ee9a37d459",-73906755,40743715,"BRITE ADVENTURE CENTER, INC.","41-31 58TH STREET"
2,2,0,"a6778cb8-ebf6-ea11-b883-24ee9a37d459","Pathways to Graduation - Q950 - Q595 - 79Q950 - 162-02 HILLSIDE AVENUE","39b4977a-32f4-ea11-b882-24ee9a37d45c",-73799532,40708204,"AUX. SERV. - JAMAICA LEARN CT - Q","162-02 HILLSIDE AVENUE"
1,0,1,"89886843-31f4-ea11-b882-24ee9a37d45c","P.S. 005 Ellen Lurie - M005 - M005 - 06M005 - 3703 TENTH AVENUE","8a886843-31f4-ea11-b882-24ee9a37d45c",-73922277,40857633,"P.S. 5 - MANHATTAN","3703 TENTH AVENUE"
4,3,1,"41de261e-4afb-ea11-b883-24ee9a37d459","NEW LIFE DAYCARE CENTER- SITE 2 - KBSC - KBSC -  - 406-408 GROVE STREET","42de261e-4afb-ea11-b883-24ee9a37d459",-73912224,40701464,"New Life Child Development Center 2-3","406-408 GROVE STREET"
4,4,0,"cbe8ce00-32f4-ea11-b882-24ee9a37d45c","I.S. 73 - The Frank Sansivieri Intermediate School - Q073 - Q073 - 24Q073 - 70-02 54 AVENUE","cce8ce00-32f4-ea11-b882-24ee9a37d45c",-73893318,40728558,"I.S. 73 - QUEENS","70-02 54 AVENUE"
2,2,0,"4e767649-31f4-ea11-b882-24ee9a37d45c","P.S. 040 Augustus Saint-Gaudens - M040 - M040 - 02M040 - 320 EAST 20TH STREET","46767649-31f4-ea11-b882-24ee9a37d45c",-73981536,40735328,"P.S. 40 - MANHATTAN","320 EAST 20TH STREET"
1,1,0,"8341e65b-31f4-ea11-b882-24ee9a37d45c","P.S. 083 Luis Munoz Rivera - M083 - M083 - 04M083 - 219 East 109 Street","8141e65b-31f4-ea11-b882-24ee9a37d45c",-73941955,40793363,"P.S. 83 - MANHATTAN","219 East 109 Street"
1,1,0,"a783ff9e-30f4-ea11-b882-24ee9a37d45c","P.S. 255 Barbara Reing School - K255 - K255 - 22K255 - 1866 EAST 17 STREET","a883ff9e-30f4-ea11-b882-24ee9a37d45c",-73955891,40604461,"P.S. 255 - BROOKLYN","1866 EAST 17 STREET"
1,0,1,"dd968d36-30f4-ea11-b882-24ee9a37d45c","P.S. 021 Crispus Attucks - K021 - K021 - 16K021 - 180 CHAUNCEY STREET","dc968d36-30f4-ea11-b882-24ee9a37d45c",-73926673,40680350,"P.S. 21 - BROOKLYN","180 CHAUNCEY STREET"
1,1,0,"6375147a-51e6-eb11-b8b1-24ee9a37d45c","Valence College Preparatory Charter School - Q387 - QCNB - 84Q387 - 97-29 64 Road","6475147a-51e6-eb11-b8b1-24ee9a37d45c",-73858853,40729413,"97-29 64th Rd","97-29 64 Road"
1,1,0,"920e6e25-32f4-ea11-b882-24ee9a37d45c","P.S. 174 William Sidney Mount - Q174 - Q174 - 28Q174 - 65-10 DIETERLE CRESCENT","930e6e25-32f4-ea11-b882-24ee9a37d45c",-73861462,40720583,"P.S. 174 - QUEENS","65-10 DIETERLE CRESCENT"
1,1,0,"ec09e2e1-30f4-ea11-b882-24ee9a37d45c","East Williamsburg Scholars Academy - K477 - K450 - 14K477 - 850 GRAND STREET","e909e2e1-30f4-ea11-b882-24ee9a37d45c",-73938921,40711134,"GRAND STREET CAMPUS (OLD E.D.HS)- K","850 GRAND STREET"
1,0,1,"0b8bc007-ebf6-ea11-b883-24ee9a37d459","Home Instruction - Bronx - X999 - X953 - 75X502 - 3450 EAST TREMONT AVENUE","fa27b299-33f4-ea11-b882-24ee9a37d45c",-73827642,40831829,"AUXILIARY SERVICES HS - BRONX","3450 EAST TREMONT AVENUE"
2,0,2,"cd79df48-30f4-ea11-b882-24ee9a37d45c","P.S. 66 - K066 - K066 - 18K066 - 845 EAST 96 STREET","cc79df48-30f4-ea11-b882-24ee9a37d45c",-73907064,40648749,"P.S. 66 - BROOKLYN","845 EAST 96 STREET"
2,1,1,"449f4974-31f4-ea11-b882-24ee9a37d45c","Future Leaders Institute Charter School - M861 - M144 - 84M861 - 134 WEST 122 STREET","459f4974-31f4-ea11-b882-24ee9a37d45c",-73948385,40806055,"P.S. 242 (OLD P144) - MANHATTAN","134 WEST 122 STREET"
3,2,1,"35767649-31f4-ea11-b882-24ee9a37d45c","Lower East Side Preparatory High School - M515 - M025 - 01M515 - 145 Stanton Street","29767649-31f4-ea11-b882-24ee9a37d45c",-73986038,40720040,"J.H.S. 25 - MANHATTAN","145 Stanton Street"
1,0,1,"df11f898-32f4-ea11-b882-24ee9a37d45c","P.S. 360 - Q360 - Q892 - 29Q360 - 199-10 112 AVENUE","e011f898-32f4-ea11-b882-24ee9a37d45c",-73756259,40702329,"P.S. 892 - QUEENS","199-10 112 AVENUE"
1,0,1,"ae56635c-33f4-ea11-b882-24ee9a37d45c","New Visions AIM Charter High School II - X200 - X401 - 84X200 - 1010 REV. J. A. POLITE AVENUE","8ce03d56-33f4-ea11-b882-24ee9a37d45c",-73898265,40823124,"BRONX REGIONAL HS (OLD 133) - X","1010 REV. J. A. POLITE AVENUE"
2,1,1,"8b11b2e2-32f4-ea11-b882-24ee9a37d45c","Staten Island School of Civic Leadership - R861 - R861 - 31R861 - 280 REGIS DRIVE","8a11b2e2-32f4-ea11-b882-24ee9a37d45c",-74164427,40620310,"ELIZABETH A. CONNELLY CAMPUS - S.I.","280 REGIS DRIVE"
2,2,0,"d1b36d80-30f4-ea11-b882-24ee9a37d45c","P.S. 186 Dr. Irving A Gladstone - K186 - K186 - 20K186 - 7601 19 AVENUE","d2b36d80-30f4-ea11-b882-24ee9a37d45c",-73994258,40610917,"P.S. 186 - BROOKLYN","7601 19 AVENUE"
1,0,1,"3cb205ac-33f4-ea11-b882-24ee9a37d45c","Bronx Arts and Science Charter School - X619 - XAGG - 84X619 - 925 HUTCHINSON RIVER PARKWAY","3db205ac-33f4-ea11-b882-24ee9a37d45c",-73838299,40825715,"ST HELENA'S HIGH SCHOOL","925 HUTCHINSON RIVER PARKWAY"
1,1,0,"ea09e2e1-30f4-ea11-b882-24ee9a37d45c","PROGRESS High School for Professional Careers - K474 - K450 - 14K474 - 850 GRAND STREET","e909e2e1-30f4-ea11-b882-24ee9a37d45c",-73938921,40711134,"GRAND STREET CAMPUS (OLD E.D.HS)- K","850 GRAND STREET"
2,2,0,"d28442ee-31f4-ea11-b882-24ee9a37d45c","P.S. 035 Nathaniel Woodhull - Q035 - Q035 - 29Q035 - 90-01 191 Street","bb8442ee-31f4-ea11-b882-24ee9a37d45c",-73768894,40713438,"P.S. 35 - QUEENS","191-02 90 Avenue"
1,1,0,"8f2aa42b-33f4-ea11-b882-24ee9a37d45c","Theatre Arts Production Company School - X225 - X137 - 10X225 - 2225 WEBSTER AVENUE","8e2aa42b-33f4-ea11-b882-24ee9a37d45c",-73897404,40854257,"I.S. 391 (UDC) - BRONX","2225 WEBSTER AVENUE"
1,1,0,"bd69c231-32f4-ea11-b882-24ee9a37d45c","P.S. 212 - Q212 - Q212 - 30Q212 - 34-25 82 STREET","b969c231-32f4-ea11-b882-24ee9a37d45c",-73884458,40753035,"P.S. 212 - QUEENS","34-25 82 STREET"
1,0,1,"9548b1f5-eaf6-ea11-b883-24ee9a37d459","Brooklyn Navy Yard STEAM Center - K891 - K777 - 33K891 - 141 FLUSHING AVENUE","5a2f7d06-31f4-ea11-b882-24ee9a37d45c",-73972767,40702258,"H.S. STEAM CENTER@BUILDING 77 - BROOKLYN","141 FLUSHING AVENUE"
1,0,1,"728946f4-31f4-ea11-b882-24ee9a37d45c","M.S. 053 Brian Piccolo - Q053 - Q053 - 27Q053 - 10-45 NAMEOKE STREET","648946f4-31f4-ea11-b882-24ee9a37d45c",-73749891,40604019,"I.S. 53 - QUEENS","10-45 NAMEOKE STREET"
1,1,0,"e4b36d80-30f4-ea11-b882-24ee9a37d45c","P.S. 192 - The Magnet School for Math and Science Inquiry - K192 - K192 - 20K192 - 4715 18 AVENUE","e5b36d80-30f4-ea11-b882-24ee9a37d45c",-73979540,40628800,"P.S. 192 - BROOKLYN","4715 18 AVENUE"
1,0,1,"95977d2b-32f4-ea11-b882-24ee9a37d45c","Goldie Maple Academy - Q333 - Q198 - 27Q333 - 3-65 BEACH 56 STREET","85977d2b-32f4-ea11-b882-24ee9a37d45c",-73786649,40594008,"I.S. 198 - QUEENS","3-65 BEACH 56 STREET"
1,1,0,"1203cefa-32f4-ea11-b882-24ee9a37d45c","P.S. 041 Gun Hill Road - X041 - X041 - 11X041 - 3352 OLINVILLE AVENUE","1303cefa-32f4-ea11-b882-24ee9a37d45c",-73867834,40874754,"P.S. 41 - BRONX","3352 OLINVILLE AVENUE"
1,1,0,"e42ece86-32f4-ea11-b882-24ee9a37d45c","Young Women's Leadership School, Astoria - Q286 - Q739 - 30Q286 - 23-15 Newtown Avenue","e52ece86-32f4-ea11-b882-24ee9a37d45c",-73923830,40770769,"YOUNG WOMEN'S LEADERSHIP ACADEMY- QUEENS","23-15 Newtown Avenue"
1,1,0,"9353dd74-33f4-ea11-b882-24ee9a37d45c","Mott Haven Village Preparatory High School - X473 - X470 - 07X473 - 701 ST. ANNS AVENUE","9253dd74-33f4-ea11-b882-24ee9a37d45c",-73911633,40818041,"SOUTH BRONX EDUCATIONAL CAMPUS (OLD 38) - X","701 ST. ANNS AVENUE"
1,1,0,"13e63126-ebf6-ea11-b883-24ee9a37d459","Kings Collegiate Charter School - K608 - K232 - 84K608 - 905 WINTHROP STREET","0222d292-30f4-ea11-b882-24ee9a37d45c",-73928744,40659088,"I.S. 232 - BROOKLYN","905 WINTHROP STREET"
1,1,0,"3f8dbfcf-30f4-ea11-b882-24ee9a37d45c","International High School at Lafayette - K337 - K400 - 21K337 - 2630 BENSON AVENUE","3a8dbfcf-30f4-ea11-b882-24ee9a37d45c",-73986313,40593028,"Lafayette Educational Campus","2630 BENSON AVENUE"
1,0,1,"d4b36d80-30f4-ea11-b882-24ee9a37d45c","P.S. 188 Michael E. Berdy - K188 - K188 - 21K188 - 3314 Neptune Avenue","cdb36d80-30f4-ea11-b882-24ee9a37d45c",-74000489,40576733,"P.S. 188 - BROOKLYN","3314 Neptune Avenue"
1,0,1,"e72ece86-32f4-ea11-b882-24ee9a37d45c","Civic Leadership Academy - Q293 - Q744 - 24Q293 - 45-10 94th Street","e22ece86-32f4-ea11-b882-24ee9a37d45c",-73871505,40743228,"ELMHURST EDUCATIONAL CAMPUS - Q","45-10 94th Street"
1,1,0,"d6968d36-30f4-ea11-b882-24ee9a37d45c","Brooklyn Arbor Elementary School - K414 - K019 - 14K414 - 325 SOUTH 3 STREET","d7968d36-30f4-ea11-b882-24ee9a37d45c",-73954678,40710107,"P.S. 19 - BROOKLYN","325 SOUTH 3 STREET"
2,1,1,"1e06003e-32f4-ea11-b882-24ee9a37d45c","East-West School of International Studies - Q281 - Q237 - 25Q281 - 46-21 COLDEN STREET","1b06003e-32f4-ea11-b882-24ee9a37d45c",-73821402,40749430,"J.H.S. 237 - QUEENS","46-21 COLDEN STREET"
1,0,1,"686e70b7-31f4-ea11-b882-24ee9a37d45c","West End Secondary School - M291 - M837 - 03M291 - 227-243 West 61st Street","696e70b7-31f4-ea11-b882-24ee9a37d45c",-73988338,40772608,"BEACON HS - MANHATTAN","227-243 West 61st Street"
1,1,0,"4e2b3eee-30f4-ea11-b882-24ee9a37d45c","The Christa McAuliffe School\I.S. 187 - K187 - K486 - 20K187 - 1171 65 STREET","4f2b3eee-30f4-ea11-b882-24ee9a37d45c",-74003883,40627929,"I.S. 187 - BROOKLYN","1171 65 STREET"
2,1,1,"9069c231-32f4-ea11-b882-24ee9a37d45c","Robert H. Goddard High School of Communication Arts and Technology - Q308 - Q202 - 27Q308 - 138-30 LAFAYETTE STREET","9169c231-32f4-ea11-b882-24ee9a37d45c",-73845992,40670905,"I.S. 202 - QUEENS","138-30 LAFAYETTE STREET"
3,3,0,"ed1aad3c-30f4-ea11-b882-24ee9a37d45c","P.S. 029 John M. Harrigan - K029 - K029 - 15K029 - 425 HENRY STREET","ee1aad3c-30f4-ea11-b882-24ee9a37d45c",-73997447,40686843,"P.S. 29 - BROOKLYN","425 HENRY STREET"
2,2,0,"8436d900-33f4-ea11-b882-24ee9a37d45c","P.S. 062 Inocensio Casanova - X062 - X062 - 08X062 - 660 FOX STREET","8336d900-33f4-ea11-b882-24ee9a37d45c",-73900161,40813736,"P.S. 62 - BRONX","660 FOX STREET"
1,0,1,"fa21d292-30f4-ea11-b882-24ee9a37d45c","Home Instruction - Brooklyn - K999 - K231 - 75K503 - 360 36 STREET","fb21d292-30f4-ea11-b882-24ee9a37d45c",-74005168,40654306,"P.S. 231 - BROOKLYN","360 36 STREET"
1,1,0,"bebfa431-33f4-ea11-b882-24ee9a37d45c","South Bronx Preparatory: A College Board School - X221 - X149 - 07X221 - 360 EAST 145 STREET","bcbfa431-33f4-ea11-b882-24ee9a37d45c",-73920851,40813612,"J.H.S. 149 - BRONX","360 EAST 145 STREET"
3,3,0,"b49c11e8-30f4-ea11-b882-24ee9a37d45c","The Brooklyn School for Math and Research - K168 - K480 - 32K168 - 400 IRVING AVENUE","b39c11e8-30f4-ea11-b882-24ee9a37d45c",-73911751,40696457,"BUSHWICK EDUCATIONAL CAMPUS - K","400 IRVING AVENUE"
2,0,2,"068b0044-33f4-ea11-b882-24ee9a37d45c","Bronx Delta School - X392 - X192 - 08X392 - 650 HOLLYWOOD AVENUE","078b0044-33f4-ea11-b882-24ee9a37d45c",-73818083,40826794,"I.S. 192 - BRONX","650 HOLLYWOOD AVENUE"
1,0,1,"bd8442ee-31f4-ea11-b882-24ee9a37d45c","P.S. 28 - The Thomas Emanuel Early Childhood Center - Q028 - Q028 - 24Q028 - 109-10 47 AVENUE","be8442ee-31f4-ea11-b882-24ee9a37d45c",-73854268,40747017,"P.S. 28 - QUEENS","109-10 47 AVENUE"
2,0,2,"6f41e65b-31f4-ea11-b882-24ee9a37d45c","P.S. 075 Emily Dickinson - M075 - M075 - 03M075 - 735 WEST END AVENUE","6a41e65b-31f4-ea11-b882-24ee9a37d45c",-73973996,40795109,"P.S. 75 - MANHATTAN","735 WEST END AVENUE"
2,2,0,"ba9c11e8-30f4-ea11-b882-24ee9a37d45c","The Academy of Urban Planning and Engineering - K552 - K480 - 32K552 - 400 IRVING AVENUE","b39c11e8-30f4-ea11-b882-24ee9a37d45c",-73911751,40696457,"BUSHWICK EDUCATIONAL CAMPUS - K","400 IRVING AVENUE"
1,0,1,"60507380-31f4-ea11-b882-24ee9a37d45c","P.S. 138 - M138 - M189 - 75M138 - 2580 AMSTERDAM AVENUE","5f507380-31f4-ea11-b882-24ee9a37d45c",-73928048,40853045,"P.S. 189 - MANHATTAN","2580 AMSTERDAM AVENUE"
1,0,1,"d6689025-33f4-ea11-b882-24ee9a37d45c","P.S. 134 George F. Bristow - X134 - X134 - 12X134 - 1330 BRISTOW STREET","d7689025-33f4-ea11-b882-24ee9a37d45c",-73894241,40831613,"P.S. 134 - BRONX","1330 BRISTOW STREET"
1,1,0,"7407e99e-31f4-ea11-b882-24ee9a37d45c","Jacqueline Kennedy Onassis High School - M529 - M486 - 02M529 - 120 WEST 46 STREET","7507e99e-31f4-ea11-b882-24ee9a37d45c",-73983460,40757626,"J. K. ONASSIS HS FOR INT CAREERS-M","120 WEST 46 STREET"
3,1,2,"10ba8b86-30f4-ea11-b882-24ee9a37d45c","P.S. 205 Clarion - K205 - K205 - 20K205 - 6701 20 AVENUE","11ba8b86-30f4-ea11-b882-24ee9a37d45c",-73986792,40614737,"P.S. 205 - BROOKLYN","6701 20 AVENUE"
1,1,0,"9669c231-32f4-ea11-b882-24ee9a37d45c","P.S. 201 The Discovery School for Inquiry and Research - Q201 - Q201 - 25Q201 - 65-11 155 STREET","9769c231-32f4-ea11-b882-24ee9a37d45c",-73813011,40736541,"P.S. 201 - QUEENS","65-11 155 STREET"
1,1,0,"18af1f69-ebf6-ea11-b883-24ee9a37d459","Special Music School - M859 - M490 - 03M859 - 122 AMSTERDAM AVENUE","7c07e99e-31f4-ea11-b882-24ee9a37d45c",-73985608,40774891,"MARTIN LUTHER KING, JR. HS - M","122 AMSTERDAM AVENUE"
1,1,0,"9c2aa42b-33f4-ea11-b882-24ee9a37d45c","Academy of Applied Mathematics and Technology - X343 - X139 - 07X343 - 345 BROOK AVENUE","942aa42b-33f4-ea11-b882-24ee9a37d45c",-73918774,40810314,"J.H.S. 222 - BRONX","345 BROOK AVENUE"
2,1,1,"63b50aa5-30f4-ea11-b882-24ee9a37d45c","The Fresh Creek School - K325 - K260 - 19K325 - 875 WILLIAMS AVENUE","64b50aa5-30f4-ea11-b882-24ee9a37d45c",-73893294,40653368,"P.S. 260 - BROOKLYN","875 WILLIAMS AVENUE"
1,1,0,"fa1aad3c-30f4-ea11-b882-24ee9a37d45c","P.S. 034 Oliver H. Perry - K034 - K034 - 14K034 - 131 NORMAN AVENUE","f91aad3c-30f4-ea11-b882-24ee9a37d45c",-73949756,40726378,"P.S. 34 - BROOKLYN","131 NORMAN AVENUE"
1,0,1,"5a5bc58c-30f4-ea11-b882-24ee9a37d45c","School for Classics High School - K683 - K218 - 19K683 - 370 FOUNTAIN AVENUE","5b5bc58c-30f4-ea11-b882-24ee9a37d45c",-73874537,40670020,"I.S. 218 - BROOKLYN","370 FOUNTAIN AVENUE"
1,1,0,"95845cb8-33f4-ea11-b882-24ee9a37d45c","KIPP Infinity Charter School - M336 - XAVN - 84M336 - 201 EAST 144TH STREET","96845cb8-33f4-ea11-b882-24ee9a37d45c",-73926486,40816100,"KIPP High School Building","201 EAST 144TH STREET"
1,1,0,"18f32ce2-31f4-ea11-b882-24ee9a37d45c","P.S. 019 Marino Jeantet - Q019 - Q019 - 24Q019 - 98-02 ROOSEVELT AVENUE","19f32ce2-31f4-ea11-b882-24ee9a37d45c",-73866557,40748600,"P.S. 19 - QUEENS","98-02 ROOSEVELT AVENUE"
1,0,1,"af32c3fb-eaf6-ea11-b883-24ee9a37d459","Success Academy Charter School - Rosedale - Q337 - Q374 - 84Q337 - 147-65 249th Street","8feb6056-32f4-ea11-b882-24ee9a37d45c",-73738793,40655811,"Success Academy - Rosedale","147-65 249th Street"
1,0,1,"2cde261e-4afb-ea11-b883-24ee9a37d459","YOUNG MINDS DAY CARE - KBLI - KBLI -  - 972 FULTON STREET","2dde261e-4afb-ea11-b883-24ee9a37d459",-73962221,40682256,"YOUNG MINDS DAY CARE","972 FULTON STREET"
1,0,1,"9828a20c-31f4-ea11-b882-24ee9a37d45c","Brooklyn International High School - K439 - K805 - 13K439 - 49 FLATBUSH AVENUE EXTENSION","9428a20c-31f4-ea11-b882-24ee9a37d45c",-73984528,40697330,"WATER'S EDGE EDUCATIONAL CAMPUS - K","49 FLATBUSH AVENUE EXTENSION"
1,1,0,"b479df48-30f4-ea11-b882-24ee9a37d45c","Success Academy Charter School - Bed Stuy 2 - K125 - K059 - 84K125 - 211 THROOP AVENUE","b579df48-30f4-ea11-b882-24ee9a37d45c",-73943279,40697619,"P.S. 59 - BROOKLYN","211 THROOP AVENUE"
2,2,0,"92eb0e7b-33f4-ea11-b882-24ee9a37d45c","New Visions Charter High School for Advanced Math and Science II - X202 - X650 - 84X202 - 900 TINTON AVENUE","91eb0e7b-33f4-ea11-b882-24ee9a37d45c",-73902892,40821723,"JANE ADDAMS HS - X","900 TINTON AVENUE"
2,1,1,"3e0b210d-33f4-ea11-b882-24ee9a37d45c","I.S. X303 Leadership & Community Service - X303 - X082 - 09X303 - 1700 MACOMBS ROAD","3f0b210d-33f4-ea11-b882-24ee9a37d45c",-73915217,40849416,"I.S. 232 - BRONX","1700 MACOMBS ROAD"
2,1,1,"3e02fdd0-ebf6-ea11-b883-24ee9a37d459","The Michael J. Petrides School - R080 - R010 - 31R080 - 715 OCEAN TERRACE","4bfdc1bd-32f4-ea11-b882-24ee9a37d45c",-74105883,40607637,"P.S. 80 (PETRIDES COMPLEX) AF - STATEN ISLAND","715 OCEAN TERRACE"
1,1,0,"e98a0044-33f4-ea11-b882-24ee9a37d45c","M.S. 180 Dr. Daniel Hale Williams - X180 - X180 - 11X180 - 700 BAYCHESTER AVENUE","ea8a0044-33f4-ea11-b882-24ee9a37d45c",-73831669,40874035,"I.S. 180 - BRONX","700 BAYCHESTER AVENUE"
2,1,1,"d8201dab-30f4-ea11-b882-24ee9a37d45c","Brooklyn Democracy Academy - K643 - K275 - 23K643 - 985 ROCKAWAY AVENUE","d2201dab-30f4-ea11-b882-24ee9a37d45c",-73906662,40655644,"I.S. 275 - BROOKLYN","985 ROCKAWAY AVENUE"
1,0,1,"8d41e65b-31f4-ea11-b882-24ee9a37d45c","P.S. 087 William Sherman - M087 - M087 - 03M087 - 160 WEST 78 STREET","8e41e65b-31f4-ea11-b882-24ee9a37d45c",-73978020,40781710,"P.S. 87 - MANHATTAN","160 WEST 78 STREET"
1,1,0,"0a6e3d68-31f4-ea11-b882-24ee9a37d45c","P.S. 112 Jose Celso Barbosa - M112 - M112 - 04M112 - 535 EAST 119 STREET","0b6e3d68-31f4-ea11-b882-24ee9a37d45c",-73930528,40796889,"P.S. 112 (TANDEM M206) - MANHATTAN","535 EAST 119 STREET"
1,0,1,"39474313-33f4-ea11-b882-24ee9a37d45c","P.S. 095 Sheila Mencher - X095 - X095 - 10X095 - 3961 HILLMAN AVENUE","34474313-33f4-ea11-b882-24ee9a37d45c",-73891664,40883049,"P.S. 95 - BRONX","3961 HILLMAN AVENUE"
1,1,0,"dd9b4c1f-32f4-ea11-b882-24ee9a37d45c","P.S. 152 Gwendoline N. Alleyne School - Q152 - Q152 - 30Q152 - 33-52 62 STREET","de9b4c1f-32f4-ea11-b882-24ee9a37d45c",-73900584,40753094,"P.S. 152 - QUEENS","33-52 62 STREET"
2,2,0,"30c15a75-ebf6-ea11-b883-24ee9a37d459","Adult and Continuing Education - K755 - M827 - 79K755 - 500 8 AVENUE","576e70b7-31f4-ea11-b882-24ee9a37d45c",-73992405,40753038,"AUX. SERV-MAN. LEARNING CENTER - M","500 8 AVENUE"
1,1,0,"e437fba4-31f4-ea11-b882-24ee9a37d45c","Urban Assembly Maker Academy - M282 - M520 - 02M282 - 411 PEARL STREET","e037fba4-31f4-ea11-b882-24ee9a37d45c",-74000851,40711441,"MURRY BERGTRAUM HS (ECF) - M","411 PEARL STREET"
1,0,1,"533cbf01-ebf6-ea11-b883-24ee9a37d459","South Richmond High School I.S./P.S. 25 - R025 - R825 - 75R025 - 6581 HYLAN BOULEVARD","77be7adc-32f4-ea11-b882-24ee9a37d45c",-74218688,40512019,"P.S. 25 (MOUNT LORETTO) - S.I.","6581 HYLAN BOULEVARD"
3,0,3,"077eed06-32f4-ea11-b882-24ee9a37d45c","P.S. 082 Hammond - Q082 - Q082 - 28Q082 - 88-02 144 STREET","e3e8ce00-32f4-ea11-b882-24ee9a37d45c",-73812200,40703897,"P.S. 82 - QUEENS","88-02 144 STREET"
1,1,0,"692f77fa-31f4-ea11-b882-24ee9a37d45c","P.S. 063 Old South - Q063 - Q063 - 27Q063 - 90-15 SUTTER AVENUE","6a2f77fa-31f4-ea11-b882-24ee9a37d45c",-73846796,40676978,"P.S. 63 - QUEENS","90-15 SUTTER AVENUE"
2,2,0,"64bc9674-32f4-ea11-b882-24ee9a37d45c","Richmond Hill High School - Q475 - Q475 - 27Q475 - 89-30 114 Street","3002926e-32f4-ea11-b882-24ee9a37d45c",-73833815,40695171,"RICHMOND HILL HS - Q","89-30 114 Street"
