"TotalCases","StudentCases","EmployeeCases","nycsr_locationsiteid","nycsr_sitename","nycsr_building.nycsr_buildingid","nycsr_building.nycsr_longitude","nycsr_building.nycsr_latitude","nycsr_building.nycsr_buildingname","nycsr_building.nycsr_address"
4,3,1,"2bb4977a-32f4-ea11-b882-24ee9a37d45c","Queens High School of Teaching, Liberal Arts and the Sciences - Q566 - Q566 - 26Q566 - 74-20 COMMONWEALTH BLVD","27b4977a-32f4-ea11-b882-24ee9a37d45c",-73728834,40744197,"QNS HS OF TEACH., LIB. ARTS&SCI-Q","74-20 COMMONWEALTH BLVD"
1,1,0,"b3315367-30f4-ea11-b882-24ee9a37d45c","P.S. 119 Amersfort - K119 - K119 - 22K119 - 3829 AVENUE K","b4315367-30f4-ea11-b882-24ee9a37d45c",-73938733,40626038,"P.S. 119 - BROOKLYN","3829 AVENUE K"
4,4,0,"96d810ab-31f4-ea11-b882-24ee9a37d45c","The High School of Fashion Industries - M600 - M600 - 02M600 - 225 WEST  24 STREET","94d810ab-31f4-ea11-b882-24ee9a37d45c",-73996354,40745677,"FASHION INDUSTRIES VOC HS - M","225 WEST  24 STREET"
6,2,4,"7c8d8486-31f4-ea11-b882-24ee9a37d45c","P.S. 197 John B. Russwurm - M197 - M197 - 05M197 - 2230 5 AVENUE","7b8d8486-31f4-ea11-b882-24ee9a37d45c",-73938347,40813532,"P.S. 197 - MANHATTAN","2230 5 AVENUE"
6,6,0,"8a34aa92-31f4-ea11-b882-24ee9a37d45c","Essex Street Academy - M294 - M445 - 02M294 - 350 GRAND STREET","8834aa92-31f4-ea11-b882-24ee9a37d45c",-73989329,40717329,"SEWARD PARK HS - MANHATTAN","350 GRAND STREET"
1,1,0,"bd48b1f5-eaf6-ea11-b883-24ee9a37d459","Manhattan School for Career Development - M751 - M751 - 75M751 - 113 EAST  4TH STREET","6c0c1bb1-31f4-ea11-b882-24ee9a37d45c",-73987791,40725892,"P.S. 751 (CAR.DEV/OLD 25) - M","113 EAST  4TH STREET"
3,0,3,"bbfab455-31f4-ea11-b882-24ee9a37d45c","James Weldon Johnson - M057 - M057 - 04M057 - 176 EAST 115 STREET","bcfab455-31f4-ea11-b882-24ee9a37d45c",-73941598,40797205,"P.S. 57 - MANHATTAN","176 EAST 115 STREET"
1,0,1,"cb689025-33f4-ea11-b882-24ee9a37d45c","Soundview Academy for Culture and Scholarship - X448 - X131 - 08X448 - 885 Bolton Avenue","c8689025-33f4-ea11-b882-24ee9a37d45c",-73859998,40822925,"I.S. 131 - BRONX","885 Bolton Avenue"
2,2,0,"52767649-31f4-ea11-b882-24ee9a37d45c","P.S. 041 Greenwich Village - M041 - M041 - 02M041 - 116 WEST  11 STREET","53767649-31f4-ea11-b882-24ee9a37d45c",-73999094,40735450,"P.S. 41 - MANHATTAN","116 WEST  11 STREET"
4,3,1,"60b50aa5-30f4-ea11-b882-24ee9a37d45c","J.H.S. 259 William McKinley - K259 - K259 - 20K259 - 7305 Ft Hamilton Parkway","61b50aa5-30f4-ea11-b882-24ee9a37d45c",-74014633,40626089,"I.S. 259 - BROOKLYN","7305 Ft Hamilton Parkway"
1,0,1,"f18ac007-ebf6-ea11-b883-24ee9a37d459","Rose Hill Pre-K Center - X535 - X444 - 10X535 - 2512 Marion Avenue","60ffcc6e-33f4-ea11-b882-24ee9a37d45c",-73893236,40861316,"PRE-K CENTER @MARION AVENUE - BRONX","2512 Marion Avenue"
1,1,0,"56db4f91-5920-ec11-b8bc-24ee9a37d45c","P.S. 033 Timothy Dwight - X033 - X347 - 10X033 - 2400 Jerome Avenue","57db4f91-5920-ec11-b8bc-24ee9a37d45c",-73901674,40961359,"P.S. 33 ANNEX - BRONX","2400 Jerome Avenue"
1,0,1,"12a31781-33f4-ea11-b882-24ee9a37d45c","The Bronx STEM and Arts Academy - X051 - X781 - 10X051 - 695 East 182nd Street","13a31781-33f4-ea11-b882-24ee9a37d45c",-73886997,40850674,"P.S. 51 - BRONX","695 East 182nd Street"
2,2,0,"6234aa92-31f4-ea11-b882-24ee9a37d45c","Thurgood Marshall Academy Lower School - M318 - M371 - 05M318 - 276 WEST 151ST STREET","6334aa92-31f4-ea11-b882-24ee9a37d45c",-73937833,40825831,"P.S. 318 - MANHATTAN","276 WEST 151ST STREET"
18,13,5,"ed1aad3c-30f4-ea11-b882-24ee9a37d45c","P.S. 029 John M. Harrigan - K029 - K029 - 15K029 - 425 HENRY STREET","ee1aad3c-30f4-ea11-b882-24ee9a37d45c",-73997447,40686843,"P.S. 29 - BROOKLYN","425 HENRY STREET"
7,1,6,"0906003e-32f4-ea11-b882-24ee9a37d45c","I.S. 230 - Q230 - Q230 - 30Q230 - 73-10 34 AVENUE","0806003e-32f4-ea11-b882-24ee9a37d45c",-73892883,40752618,"I.S. 230 - QUEENS","73-10 34 AVENUE"
1,1,0,"3bb4977a-32f4-ea11-b882-24ee9a37d45c","Queens Satellite High School for Opportunity - Q338 - Q595 - 28Q338 - 162-02 HILLSIDE AVENUE","39b4977a-32f4-ea11-b882-24ee9a37d45c",-73799532,40708204,"AUX. SERV. - JAMAICA LEARN CT - Q","162-02 HILLSIDE AVENUE"
4,3,1,"3d0410ca-32f4-ea11-b882-24ee9a37d45c","P.S. 56 The Louis Desario School - R056 - R056 - 31R056 - 250 KRAMER AVENUE","3e0410ca-32f4-ea11-b882-24ee9a37d45c",-74213943,40541856,"P.S. 56 - STATEN ISLAND","250 KRAMER AVENUE"
2,1,1,"653cbf01-ebf6-ea11-b883-24ee9a37d459","P469X - The Bronx School for Continuous Learners - X469 - X177 - 75X469 - 3177 WEBSTER AVENUE","dc8a0044-33f4-ea11-b882-24ee9a37d45c",-73875375,40872559,"THE NORWOOD EAST CAMPUS - BRONX","3177 WEBSTER AVENUE"
5,1,4,"cc201dab-30f4-ea11-b882-24ee9a37d45c","P.S. 272 Curtis Estabrook - K272 - K272 - 18K272 - 101-24 SEAVIEW AVENUE","cd201dab-30f4-ea11-b882-24ee9a37d45c",-73886373,40635542,"P.S. 272 - BROOKLYN","101-24 SEAVIEW AVENUE"
4,4,0,"02ba8b86-30f4-ea11-b882-24ee9a37d45c","J.H.S. 201 The Dyker Heights - K201 - K201 - 20K201 - 8010 12 AVENUE","03ba8b86-30f4-ea11-b882-24ee9a37d45c",-74013749,40619043,"I.S. 201 - BROOKLYN","8010 12 AVENUE"
1,1,0,"e880b5c9-df1e-eb11-b885-24ee9a37d45c","MS 936 Arts Off 3rd - K936 - K746 - 20K936 - 270 59th Street","e980b5c9-df1e-eb11-b885-24ee9a37d45c",-74020748,40642914,"P.S. @ 270 59TH STREET- BROOKLYN","270 59th Street"
1,0,1,"553cbf01-ebf6-ea11-b883-24ee9a37d459","The David Marquis School of the Arts - R037 - R840 - 75R037 - 15 Fairfield Street","81be7adc-32f4-ea11-b882-24ee9a37d45c",-74151368,40564100,"P.S. 37 ( OLD I24X)-STATEN ISLAND","15 Fairfield Street"
5,4,1,"c979df48-30f4-ea11-b882-24ee9a37d45c","Achievement First East New York Charter School - K358 - K065 - 84K358 - 158 RICHMOND STREET","ca79df48-30f4-ea11-b882-24ee9a37d45c",-73877256,40683399,"P.S. 65 - BROOKLYN","158 RICHMOND STREET"
1,1,0,"84b50aa5-30f4-ea11-b882-24ee9a37d45c","P.S. 361 East Flatbush Early Childhood School - K361 - K269 - 22K361 - 1957 NOSTRAND AVENUE","80b50aa5-30f4-ea11-b882-24ee9a37d45c",-73947672,40637625,"P.S. 269 - BROOKLYN","1957 NOSTRAND AVENUE"
1,0,1,"f98a0044-33f4-ea11-b882-24ee9a37d45c","South Bronx Academy for Applied Media - X296 - X184 - 07X296 - 778 FOREST AVENUE","f88a0044-33f4-ea11-b882-24ee9a37d45c",-73905389,40818703,"I.S. 184 - BRONX","778 FOREST AVENUE"
3,3,0,"4c8dbfcf-30f4-ea11-b882-24ee9a37d45c","Midwood High School - K405 - K405 - 22K405 - 2839 BEDFORD AVENUE","4d8dbfcf-30f4-ea11-b882-24ee9a37d45c",-73952356,40632829,"MIDWOOD HS - K","2839 BEDFORD AVENUE"
2,2,0,"141bad3c-30f4-ea11-b882-24ee9a37d45c","I.S. 98 Bay Academy - K098 - K043 - 21K098 - 1401 EMMONS AVENUE","151bad3c-30f4-ea11-b882-24ee9a37d45c",-73954047,40583893,"I.S. 98 - BROOKLYN","1401 EMMONS AVENUE"
2,0,2,"c348b1f5-eaf6-ea11-b883-24ee9a37d459","P.S. M811 - Mickey Mantle School - M811 - M841 - 75M811 - 466 West End Avenue","676e70b7-31f4-ea11-b882-24ee9a37d45c",-73979217,40786330,"P.S. 811 (OLD P148/LIVINGS HS) - M","466 West End Avenue"
3,2,1,"10ba8b86-30f4-ea11-b882-24ee9a37d45c","P.S. 205 Clarion - K205 - K205 - 20K205 - 6701 20 AVENUE","11ba8b86-30f4-ea11-b882-24ee9a37d45c",-73986792,40614737,"P.S. 205 - BROOKLYN","6701 20 AVENUE"
3,2,1,"dc0d3c5b-30f4-ea11-b882-24ee9a37d45c","P.S./I.S. 104 The Fort Hamilton School - K104 - K104 - 20K104 - 9115 5 AVENUE","dd0d3c5b-30f4-ea11-b882-24ee9a37d45c",-74028492,40618077,"P.S. 104 - BROOKLYN","9115 5 AVENUE"
4,3,1,"788946f4-31f4-ea11-b882-24ee9a37d45c","P.S. 054 Hillside - Q054 - Q054 - 28Q054 - 86-02 127 STREET","778946f4-31f4-ea11-b882-24ee9a37d45c",-73824629,40702656,"P.S. 54 - QUEENS","86-02 127 STREET"
7,5,2,"75bc9674-32f4-ea11-b882-24ee9a37d45c","Grover Cleveland High School - Q485 - Q485 - 24Q485 - 21-27 HIMROD STREET","74bc9674-32f4-ea11-b882-24ee9a37d45c",-73909202,40711881,"GROVER CLEVELAND HS - Q","21-27 HIMROD STREET"
6,5,1,"fcae0313-32f4-ea11-b882-24ee9a37d45c","I.S. 125 Thom J. McCann Woodside - Q125 - Q125 - 24Q125 - 46-02 47 AVENUE","fdae0313-32f4-ea11-b882-24ee9a37d45c",-73918762,40740452,"I.S. 125 - QUEENS","46-02 47 AVENUE"
2,1,1,"df2ece86-32f4-ea11-b882-24ee9a37d45c","Bard High School Early College Queens - Q299 - Q735 - 24Q299 - 30-20 THOMSON AVENUE","db2ece86-32f4-ea11-b882-24ee9a37d45c",-73937004,40744175,"QUEENS HIGH SCHOOL COMPLEX - Q","30-20 THOMSON AVENUE"
1,1,0,"1312a0be-ebf6-ea11-b883-24ee9a37d459","Mosaic Pre-K Center - Q331 - Q855 - 24Q331 - 80-55 CORNISH AVENUE","adedf392-32f4-ea11-b882-24ee9a37d45c",-73882443,40739651,"P.S. 7 TRANSPORTABLE - QUEENS","80-55 CORNISH AVENUE"
1,1,0,"3c9f4974-31f4-ea11-b882-24ee9a37d45c","P.S. 142 Amalia Castro - M142 - M142 - 01M142 - 100 ATTORNEY STREET","379f4974-31f4-ea11-b882-24ee9a37d45c",-73984116,40718121,"P.S. 142 - MANHATTAN","100 ATTORNEY STREET"
2,2,0,"4e2b3eee-30f4-ea11-b882-24ee9a37d45c","The Christa McAuliffe School\I.S. 187 - K187 - K486 - 20K187 - 1171 65 STREET","4f2b3eee-30f4-ea11-b882-24ee9a37d45c",-74003883,40627929,"I.S. 187 - BROOKLYN","1171 65 STREET"
1,1,0,"76b50aa5-30f4-ea11-b882-24ee9a37d45c","P.S. 264 Bay Ridge Elementary School For The Arts - K264 - K264 - 20K264 - 371 89th Street","74b50aa5-30f4-ea11-b882-24ee9a37d45c",-74029444,40621025,"PS 264 BAY RIDGE ELEM SCL FOR THE ARTS - BROOKLYN","371 89th Street"
1,1,0,"47953aac-ebf6-ea11-b883-24ee9a37d459","Mosaic Pre-K Center - Q331 - Q372 - 24Q331 - 104-14 ROOSEVELT AVENUE","8beb6056-32f4-ea11-b882-24ee9a37d45c",-73861044,40749771,"PRE-K CENTER @ 104-14 ROOSEVELT AVENUE - QUEENS","104-14 ROOSEVELT AVENUE"
1,0,1,"d58a0044-33f4-ea11-b882-24ee9a37d45c","Women's Academy of Excellence - X282 - X174 - 08X282 - 456 WHITE PLAINS ROAD","2a2ed53d-33f4-ea11-b882-24ee9a37d45c",-73856070,40815043,"I.S. 174 - BRONX","456 WHITE PLAINS ROAD"
1,0,1,"55fdc1bd-32f4-ea11-b882-24ee9a37d45c","P.S. 016 John J. Driscoll - R016 - R016 - 31R016 - 195 DANIEL LOW TERRACE","56fdc1bd-32f4-ea11-b882-24ee9a37d45c",-74079594,40639638,"P.S. 16 - STATEN ISLAND","195 DANIEL LOW TERRACE"
2,1,1,"b3fc24e8-31f4-ea11-b882-24ee9a37d45c","P.S. 022 Thomas Jefferson - Q022 - Q022 - 25Q022 - 153-33 SANFORD AVENUE","b1fc24e8-31f4-ea11-b882-24ee9a37d45c",-73811373,40761744,"P.S. 22 - QUEENS","153-33 SANFORD AVENUE"
1,0,1,"2a767649-31f4-ea11-b882-24ee9a37d45c","P.S. 019 Asher Levy - M019 - M019 - 01M019 - 185 1 AVENUE","2b767649-31f4-ea11-b882-24ee9a37d45c",-73984496,40730009,"P.S. 19 - MANHATTAN","185 1 AVENUE"
1,1,0,"e78442ee-31f4-ea11-b882-24ee9a37d45c","P.S. 041 Crocheron - Q041 - Q041 - 26Q041 - 214-43 35 AVENUE","e58442ee-31f4-ea11-b882-24ee9a37d45c",-73771225,40770155,"P.S. 41 - QUEENS","214-43 35 AVENUE"
1,0,1,"d53159fa-30f4-ea11-b882-24ee9a37d45c","George Westinghouse Career and Technical Education High School - K605 - K580 - 13K605 - 105 TECH PLACE","d33159fa-30f4-ea11-b882-24ee9a37d45c",-73986105,40695444,"GEORGE WESTINGHOUSE VOC HS - K","105 TECH PLACE"
18,18,0,"5d07e99e-31f4-ea11-b882-24ee9a37d45c","Stuyvesant High School - M475 - M477 - 02M475 - 345 CHAMBERS STREET","5c07e99e-31f4-ea11-b882-24ee9a37d45c",-74013921,40718025,"STUYVESANT HS (NEW) - MANHATTAN","345 CHAMBERS STREET"
1,1,0,"d0fab455-31f4-ea11-b882-24ee9a37d45c","The STAR Academy - P.S.63 - M063 - M063 - 01M063 - 121 EAST  3 STREET","cefab455-31f4-ea11-b882-24ee9a37d45c",-73986214,40724440,"P.S. 63 - MANHATTAN","121 EAST  3 STREET"
1,1,0,"5b507380-31f4-ea11-b882-24ee9a37d45c","P.S. 188 The Island School - M188 - M188 - 01M188 - 442 EAST HOUSTON STREET","4b507380-31f4-ea11-b882-24ee9a37d45c",-73977380,40719888,"P.S. 188 - MANHATTAN","442 EAST HOUSTON STREET"
2,2,0,"33767649-31f4-ea11-b882-24ee9a37d45c","School for Global Leaders - M378 - M025 - 01M378 - 145 Stanton Street","29767649-31f4-ea11-b882-24ee9a37d45c",-73986038,40720040,"J.H.S. 25 - MANHATTAN","145 Stanton Street"
1,0,1,"440b210d-33f4-ea11-b882-24ee9a37d45c","I.S. 232 - X232 - X082 - 09X232 - 1700 MACOMBS ROAD","3f0b210d-33f4-ea11-b882-24ee9a37d45c",-73915217,40849416,"I.S. 232 - BRONX","1700 MACOMBS ROAD"
1,0,1,"5236d900-33f4-ea11-b882-24ee9a37d45c","P.S. 048 Joseph R. Drake - X048 - X048 - 08X048 - 1290 SPOFFORD AVENUE","5336d900-33f4-ea11-b882-24ee9a37d45c",-73886834,40814034,"P.S. 48 - BRONX","1290 SPOFFORD AVENUE"
1,1,0,"dbfab455-31f4-ea11-b882-24ee9a37d45c","Tompkins Square Middle School - M839 - M064 - 01M839 - 600 EAST  6 STREET","d3fab455-31f4-ea11-b882-24ee9a37d45c",-73981597,40723130,"P.S. 64 (OLD 71) - MANHATTAN","600 EAST  6 STREET"
1,0,1,"1606003e-32f4-ea11-b882-24ee9a37d45c","P.S. 234 - Q234 - Q234 - 30Q234 - 30-15 29 STREET","1506003e-32f4-ea11-b882-24ee9a37d45c",-73923044,40766898,"P.S. 234 - QUEENS","30-14 30 STREET"
1,1,0,"89977d2b-32f4-ea11-b882-24ee9a37d45c","J.H.S. 194 William Carr - Q194 - Q194 - 25Q194 - 154-60 17 AVENUE","8a977d2b-32f4-ea11-b882-24ee9a37d45c",-73806990,40783231,"J.H.S. 194 - QUEENS","154-60 17 AVENUE"
1,0,1,"882aa42b-33f4-ea11-b882-24ee9a37d45c","P186X Walter J. Damrosch School - X186 - X136 - 75X186 - 750 Jennings Street","892aa42b-33f4-ea11-b882-24ee9a37d45c",-73897797,40831388,"P.S. 186 (OLD J136) - BRONX","750 Jennings Street"
1,0,1,"7534aa92-31f4-ea11-b882-24ee9a37d45c","Isaac Newton Middle School for Math & Science - M825 - M435 - 04M825 - 260 PLEASANT AVENUE","7234aa92-31f4-ea11-b882-24ee9a37d45c",-73932868,40794184,"MANHTN CT FOR MATH & SCI. HS - M","260 PLEASANT AVENUE"
2,2,0,"0dba8b86-30f4-ea11-b882-24ee9a37d45c","P.S. 204 Vince Lombardi - K204 - K204 - 20K204 - 8101 15 AVENUE","0eba8b86-30f4-ea11-b882-24ee9a37d45c",-74006137,40613535,"P.S. 204 - BROOKLYN","8101 15 AVENUE"
19,16,3,"3088e6db-30f4-ea11-b882-24ee9a37d45c","Brooklyn Technical High School - K430 - K430 - 13K430 - 29 FT GREENE PLACE","3188e6db-30f4-ea11-b882-24ee9a37d45c",-73976435,40688896,"BROOKLYN TECH HS - K","29 FT GREENE PLACE"
1,1,0,"65507380-31f4-ea11-b882-24ee9a37d45c","P.S. 290 Manhattan New School - M290 - M190 - 02M290 - 311 EAST  82 STREET","66507380-31f4-ea11-b882-24ee9a37d45c",-73952777,40775181,"P.S. 290 - MANHATTAN","311 EAST  82 STREET"
1,0,1,"31e61462-31f4-ea11-b882-24ee9a37d45c","M.S. 319 - Maria Teresa - M319 - M090 - 06M319 - 21 JUMEL PLACE","2ce61462-31f4-ea11-b882-24ee9a37d45c",-73935815,40839139,"I.S. 90 - MANHATTAN","21 JUMEL PLACE"
2,0,2,"6ce2635c-32f4-ea11-b882-24ee9a37d45c","Bayside High School - Q495 - Q405 - 26Q495 - 32-24 CORPORAL KENNEDY STREET","6be2635c-32f4-ea11-b882-24ee9a37d45c",-73781041,40771398,"BAYSIDE HS - Q","32-24 CORPORAL KENNEDY STREET"
1,1,0,"0ba198c3-30f4-ea11-b882-24ee9a37d45c","Hyde Leadership Charter School- Brooklyn - K769 - K328 - 84K769 - 330 ALABAMA AVENUE","0ca198c3-30f4-ea11-b882-24ee9a37d45c",-73898249,40667985,"P.S. 328 - BROOKLYN","330 ALABAMA AVENUE"
2,2,0,"e09b4c1f-32f4-ea11-b882-24ee9a37d45c","P.S. 153 Maspeth Elem - Q153 - Q153 - 24Q153 - 60-02 60 LANE","e19b4c1f-32f4-ea11-b882-24ee9a37d45c",-73904463,40716296,"P.S. 153 - QUEENS","60-02 60 LANE"
1,0,1,"270b210d-33f4-ea11-b882-24ee9a37d45c","P.S. 195 - X195 - X077 - 12X195 - 1250 WARD AVENUE","230b210d-33f4-ea11-b882-24ee9a37d45c",-73877305,40830811,"P.S. 195 - BRONX","1250 WARD AVENUE"
2,1,1,"cdba3c50-33f4-ea11-b882-24ee9a37d45c","The Highbridge Green School - X361 - X285 - 09X361 - 200 West 167th Street","ceba3c50-33f4-ea11-b882-24ee9a37d45c",-73927892,40838232,"HIGHBRIDGE ENVIRONMENTAL EDUCATION CAMPUS - BRONX","200 West 167th Street"
4,2,2,"dfa2f813-ebf6-ea11-b883-24ee9a37d459","P.S. K369 - Coy L. Cox School - K369 - K067 - 75K369 - 51 SAINT EDWARDS STREET","d179df48-30f4-ea11-b882-24ee9a37d45c",-73977674,40695339,"P.S. 67 - BROOKLYN","51 SAINT EDWARDS STREET"
1,0,1,"dc8521d0-32f4-ea11-b882-24ee9a37d45c","P.S. 069 Daniel D. Tompkins - R069 - R069 - 31R069 - 144 KEATING PLACE","dd8521d0-32f4-ea11-b882-24ee9a37d45c",-74157327,40591480,"P.S. 69 - STATEN ISLAND","144 KEATING PLACE"
5,5,0,"e292e6d5-30f4-ea11-b882-24ee9a37d45c","James Madison High School - K425 - K425 - 22K425 - 3787 BEDFORD AVENUE","e092e6d5-30f4-ea11-b882-24ee9a37d45c",-73947661,40610499,"JAMES MADISON HS - K","3787 BEDFORD AVENUE"
1,0,1,"8128a20c-31f4-ea11-b882-24ee9a37d45c","Achievement First Endeavor Charter School - K508 - K784 - 84K508 - 510 WAVERLY AVENUE","8228a20c-31f4-ea11-b882-24ee9a37d45c",-73965928,40682422,"ACHIEVEMENT FIRST ENDEAVOR CHARTER SCHOOL - K","510 WAVERLY AVENUE"
1,0,1,"72c17bb2-e11e-eb11-b885-24ee9a37d45c","P.S. Q256 - Q256 - Q438 - 75Q256 - 445 Beach 135 Street","73c17bb2-e11e-eb11-b885-24ee9a37d45c",-73855146,40577474,"P.S. 256 ANNEX - QUEENS","445 Beach 135 Street"
3,2,1,"692f77fa-31f4-ea11-b882-24ee9a37d45c","P.S. 063 Old South - Q063 - Q063 - 27Q063 - 90-15 SUTTER AVENUE","6a2f77fa-31f4-ea11-b882-24ee9a37d45c",-73846796,40676978,"P.S. 63 - QUEENS","90-15 SUTTER AVENUE"
1,0,1,"d99319d7-ebf6-ea11-b883-24ee9a37d459","The Richmond Pre-K Center - R066 - R068 - 31R066 - 1 TELEPORT DRIVE","d98521d0-32f4-ea11-b882-24ee9a37d45c",-74178183,40607104,"PRE-K CENTER @ 1 TELEPORT DRIVE - STATEN ISLAND","1 TELEPORT DRIVE"
1,0,1,"df8442ee-31f4-ea11-b882-24ee9a37d45c","P.S. 038 Rosedale - Q038 - Q038 - 29Q038 - 135-21 241 STREET","e08442ee-31f4-ea11-b882-24ee9a37d45c",-73733774,40671150,"P.S. 38 - QUEENS","135-21 241 STREET"
1,0,1,"42a10a44-32f4-ea11-b882-24ee9a37d45c","New York City Academy for Discovery - Q306 - Q262 - 27Q306 - 95-16 89TH AVENUE","43a10a44-32f4-ea11-b882-24ee9a37d45c",-73848577,40691482,"P.S. 262 - QUEENS","95-16 89TH AVENUE"
4,4,0,"8ba87f90-5a04-ec11-b8b4-24ee9a37d45c","Hunters Point Elementary School - Q384 - Q375 - 30Q384 - 1-35 57 Avenue","8ca87f90-5a04-ec11-b8b4-24ee9a37d45c",-73960836,40738864,"Hunters Point","1-35 57 Avenue"
5,5,0,"7107e99e-31f4-ea11-b882-24ee9a37d45c","Fiorello H. LaGuardia High School of Music & Art and Performing Arts - M485 - M485 - 03M485 - 100 Amsterdam Avenue","7207e99e-31f4-ea11-b882-24ee9a37d45c",-73985976,40774202,"FIORELLO LAGUARDIA HS - MANHATTAN","100 Amsterdam Avenue"
1,0,1,"ab32c3fb-eaf6-ea11-b883-24ee9a37d459","P.S. Q224 - Q224 - Q186 - 75Q224 - 252-12 72 AVENUE","67977d2b-32f4-ea11-b882-24ee9a37d45c",-73721594,40749556,"P.S. 186 - QUEENS","252-12 72 AVENUE"
1,0,1,"8f53dd74-33f4-ea11-b882-24ee9a37d45c","Eagle Academy for Young Men - X231 - X465 - 09X231 - 4143 THIRD AVENUE","8b53dd74-33f4-ea11-b882-24ee9a37d45c",-73897479,40845366,"Eagle Academy For Young Men - Bronx","4143 THIRD AVENUE"
1,1,0,"4febaa73-30f4-ea11-b882-24ee9a37d45c","New Bridges Elementary - K532 - K167 - 17K532 - 1025 EASTERN PARKWAY","4cebaa73-30f4-ea11-b882-24ee9a37d45c",-73934316,40669557,"P.S. 167 - BROOKLYN","1025 EASTERN PARKWAY"
1,1,0,"5e34aa92-31f4-ea11-b882-24ee9a37d45c","The Peck Slip School - M343 - M343 - 02M343 - 1 PECK SLIP","e7e0838c-31f4-ea11-b882-24ee9a37d45c",-74002407,40708774,"THE PECK SLIP SCHOOL - MANHATTAN","1 PECK SLIP"
1,1,0,"bf315367-30f4-ea11-b882-24ee9a37d45c","P.S. 123 Suydam - K123 - K123 - 32K123 - 100 IRVING AVENUE","bb315367-30f4-ea11-b882-24ee9a37d45c",-73922388,40704076,"P.S. 123 - BROOKLYN","100 IRVING AVENUE"
1,0,1,"239ebaee-32f4-ea11-b882-24ee9a37d45c","P.S. 011 Highbridge - X011 - X011 - 09X011 - 1257 OGDEN AVENUE","249ebaee-32f4-ea11-b882-24ee9a37d45c",-73925890,40839693,"P.S. 11 - BRONX","1257 OGDEN AVENUE"
1,1,0,"9d69c231-32f4-ea11-b882-24ee9a37d45c","P.S. 203 Oakland Gardens - Q203 - Q203 - 26Q203 - 53-11 SPRINGFIELD BOULEVARD","9e69c231-32f4-ea11-b882-24ee9a37d45c",-73759822,40753606,"P.S. 203 - QUEENS","53-11 SPRINGFIELD BOULEVARD"
1,0,1,"50ef7338-ebf6-ea11-b883-24ee9a37d459","Brooklyn Academy High School - K553 - K457 - 13K553 - 708 MAPLE STREET","070ae2e1-30f4-ea11-b882-24ee9a37d45c",-73935766,40661049,"BOYS HS AF (OLD) - BROOKLYN","708 MAPLE STREET"
2,0,2,"673cbf01-ebf6-ea11-b883-24ee9a37d459","P.S. X596 - X596 - X178 - 75X596 - 850 BAYCHESTER AVENUE","e38a0044-33f4-ea11-b882-24ee9a37d45c",-73831669,40874035,"P.S. 178 - BRONX","850 BAYCHESTER AVENUE"
2,1,1,"417c21b7-32f4-ea11-b882-24ee9a37d45c","P.S. 6 Corporal Allan F. Kivlehan School - R006 - R006 - 31R006 - 555 PAGE AVENUE","3c7c21b7-32f4-ea11-b882-24ee9a37d45c",-74230118,40510207,"P.S. 6 - STATEN ISLAND","555 PAGE AVENUE"
1,1,0,"29a198c3-30f4-ea11-b882-24ee9a37d45c","P.S. 889 - K889 - K338 - 22K889 - 21 HINCKLEY PLACE","27a198c3-30f4-ea11-b882-24ee9a37d45c",-73971010,40644861,"P.S. 338 - Brooklyn","21 HINCKLEY PLACE"
2,1,1,"320b210d-33f4-ea11-b882-24ee9a37d45c","School for Environmental Citizenship - X386 - X079 - 10X386 - 125 EAST 181 STREET","2c0b210d-33f4-ea11-b882-24ee9a37d45c",-73903139,40855337,"P.S. 79 - BRONX","125 EAST 181 STREET"
1,1,0,"e7883319-32f4-ea11-b882-24ee9a37d45c","P.S. 146 Howard Beach - Q146 - Q146 - 27Q146 - 98-01 159 AVENUE","e8883319-32f4-ea11-b882-24ee9a37d45c",-73834896,40660531,"P.S. 146 - QUEENS","98-01 159 AVENUE"
2,2,0,"6e36d900-33f4-ea11-b882-24ee9a37d45c","P.S. 056 Norwood Heights - X056 - X056 - 10X056 - 341 EAST 207 STREET","6f36d900-33f4-ea11-b882-24ee9a37d45c",-73874912,40875481,"P.S. 56 - BRONX","341 EAST 207 STREET"
2,0,2,"520b210d-33f4-ea11-b882-24ee9a37d45c","P.S. 085 Great Expectations - X085 - X085 - 10X085 - 2400 MARION AVENUE","530b210d-33f4-ea11-b882-24ee9a37d45c",-73894682,40858689,"P.S. 85 - BRONX","2400 MARION AVENUE"
1,1,0,"2f06003e-32f4-ea11-b882-24ee9a37d45c","The Active Learning Elementary School - Q244 - Q244 - 25Q244 - 137-20 FRANKLIN AVENUE","2b06003e-32f4-ea11-b882-24ee9a37d45c",-73826192,40754483,"P.S. 244 ECC (@ FRANKLIN AVE) - Q","137-20 FRANKLIN AVENUE"
1,1,0,"d3d27c6d-30f4-ea11-b882-24ee9a37d45c","Young Women's Leadership School of Brooklyn - K614 - K147 - 14K614 - 325 BUSHWICK AVENUE","d4d27c6d-30f4-ea11-b882-24ee9a37d45c",-73938790,40705005,"P.S. 147 - BROOKLYN","325 BUSHWICK AVENUE"
4,1,3,"307c21b7-32f4-ea11-b882-24ee9a37d45c","I.S. R002 George L. Egbert - R002 - R002 - 31R002 - 333 Midland Avenue","2b7c21b7-32f4-ea11-b882-24ee9a37d45c",-74099685,40576728,"I.S. 2 - STATEN ISLAND","333 Midland Avenue"
4,2,2,"1e0410ca-32f4-ea11-b882-24ee9a37d45c","P.S. 045 John Tyler - R045 - R045 - 31R045 - 58 LAWRENCE AVENUE","1f0410ca-32f4-ea11-b882-24ee9a37d45c",-74107537,40628419,"P.S. 45 - STATEN ISLAND","58 LAWRENCE AVENUE"
1,0,1,"8d83ff9e-30f4-ea11-b882-24ee9a37d45c","P.S. 247 Brooklyn - K247 - K247 - 20K247 - 7000 21 AVENUE","8e83ff9e-30f4-ea11-b882-24ee9a37d45c",-73987195,40612247,"P.S. 247 - BROOKLYN","7000 21 AVENUE"
1,0,1,"516e70b7-31f4-ea11-b882-24ee9a37d45c","P.S. 527 - East Side School for Social Action - M527 - M816 - 02M527 - 323 EAST 91 STREET","526e70b7-31f4-ea11-b882-24ee9a37d45c",-73947856,40780652,"P.S. 527 - East Side School for Social Action","323 EAST 91 STREET"
2,1,1,"cd315367-30f4-ea11-b882-24ee9a37d45c","P.S. 127 Mckinley Park - K127 - K127 - 20K127 - 7805 7 Avenue","ce315367-30f4-ea11-b882-24ee9a37d45c",-74018429,40623687,"P.S. 127 - BROOKLYN","7805 7 Avenue"
1,0,1,"409f4974-31f4-ea11-b882-24ee9a37d45c","J.H.S. 143 Eleanor Roosevelt - M143 - M143 - 06M143 - 511 WEST 182ND STREET","3f9f4974-31f4-ea11-b882-24ee9a37d45c",-73930991,40849311,"I.S. 143 - MANHATTAN","511 WEST 182ND STREET"
5,4,1,"63ffcc6e-33f4-ea11-b882-24ee9a37d45c","The Bronx High School of Science - X445 - X445 - 10X445 - 75 WEST 205 STREET","64ffcc6e-33f4-ea11-b882-24ee9a37d45c",-73889011,40879958,"BRONX HS OF SCIENCE - X","75 WEST 205 STREET"
2,2,0,"f59b4c1f-32f4-ea11-b882-24ee9a37d45c","P.S. 159 - Q159 - Q159 - 26Q159 - 205-01 33 AVENUE","f69b4c1f-32f4-ea11-b882-24ee9a37d45c",-73783973,40770108,"P.S. 159 - QUEENS","205-01 33 AVENUE"
2,1,1,"54ebaa73-30f4-ea11-b882-24ee9a37d45c","P.S. 169 Sunset Park - K169 - K169 - 15K169 - 4305 7 AVENUE","55ebaa73-30f4-ea11-b882-24ee9a37d45c",-74001700,40645825,"P.S. 169 - BROOKLYN","4305 7 AVENUE"
3,3,0,"1206003e-32f4-ea11-b882-24ee9a37d45c","P.S. 232 Lindenwood - Q232 - Q232 - 27Q232 - 153-23 83 STREET","1106003e-32f4-ea11-b882-24ee9a37d45c",-73850622,40665408,"P.S. 232 - QUEENS","153-23 83 STREET"
2,1,1,"cf201dab-30f4-ea11-b882-24ee9a37d45c","P.S. 273 Wortman - K273 - K273 - 19K273 - 923 JEROME STREET","cb201dab-30f4-ea11-b882-24ee9a37d45c",-73879276,40658500,"P.S. 273 - BROOKLYN","923 JEROME STREET"
1,1,0,"92dc32dc-31f4-ea11-b882-24ee9a37d45c","P.S. 002 Alfred Zimberg - Q002 - Q002 - 30Q002 - 75-10 21 Avenue","93dc32dc-31f4-ea11-b882-24ee9a37d45c",-73894108,40769798,"P.S. 2 - QUEENS","75-10 21 Avenue"
1,0,1,"f0f22ce2-31f4-ea11-b882-24ee9a37d45c","York Early College Academy - Q284 - Q008 - 28Q284 - 108-35 167 STREET","f1f22ce2-31f4-ea11-b882-24ee9a37d45c",-73786403,40696910,"J.H.S. 8 - QUEENS","108-35 167 STREET"
2,2,0,"f9ae0313-32f4-ea11-b882-24ee9a37d45c","P.S. 124 Osmond A Church - Q124 - Q124 - 27Q124 - 129-15 150 AVENUE","faae0313-32f4-ea11-b882-24ee9a37d45c",-73811266,40665669,"P.S. 124 - QUEENS","129-15 150 AVENUE"
1,0,1,"fc1aad3c-30f4-ea11-b882-24ee9a37d45c","P.S. K141 - K141 - K035 - 75K141 - 272 Macdonough Street","fd1aad3c-30f4-ea11-b882-24ee9a37d45c",-73935891,40681528,"I.S. 35 - BROOKLYN","272 Macdonough Street"
1,0,1,"ded27c6d-30f4-ea11-b882-24ee9a37d45c","P.S. 373 - Brooklyn Transition Center - K373 - K148 - 75K373 - 185 ELLERY STREET","dcd27c6d-30f4-ea11-b882-24ee9a37d45c",-73945211,40699214,"P.S. 373 (OLD P148) - BROOKLYN","185 ELLERY STREET"
1,0,1,"4a953aac-ebf6-ea11-b883-24ee9a37d459","The Ezra Jack Keats Pre-K Center - Q335 - Q382 - 28Q335 - 89-14 PARSONS BOULEVARD","99eb6056-32f4-ea11-b882-24ee9a37d45c",-73802503,40705525,"PRE-K CENTER @ 89-14 PARSONS BOULEVARD - QUEENS","89-14 PARSONS BOULEVARD"
1,1,0,"b056635c-33f4-ea11-b882-24ee9a37d45c","Arturo A. Schomburg Satellite Academy Bronx - X446 - X401 - 12X446 - 1010 REV. J. A. POLITE AVENUE","8ce03d56-33f4-ea11-b882-24ee9a37d45c",-73898265,40823124,"BRONX REGIONAL HS (OLD 133) - X","1010 REV. J. A. POLITE AVENUE"
3,2,1,"cd8521d0-32f4-ea11-b882-24ee9a37d45c","I.S. 061 William A Morris - R061 - R061 - 31R061 - 445 CASTLETON AVENUE","460410ca-32f4-ea11-b882-24ee9a37d45c",-74097941,40634497,"I.S. 61 - STATEN ISLAND","445 CASTLETON AVENUE"
1,0,1,"dbe13320-ebf6-ea11-b883-24ee9a37d459","Sid Miller Academy - K396 - K167 - 75K396 - 1025 EASTERN PARKWAY","4cebaa73-30f4-ea11-b882-24ee9a37d45c",-73934316,40669557,"P.S. 167 - BROOKLYN","1025 EASTERN PARKWAY"
3,3,0,"43fdc1bd-32f4-ea11-b882-24ee9a37d45c","I.S. 007 Elias Bernstein - R007 - R007 - 31R007 - 1270 Huguenot Avenue","447c21b7-32f4-ea11-b882-24ee9a37d45c",-74186096,40522971,"I.S. 7 - STATEN ISLAND","1270 Huguenot Avenue"
1,1,0,"3bebaa73-30f4-ea11-b882-24ee9a37d45c","P.S. 748 Brooklyn School for Global Scholars - K748 - K163 - 20K748 - 1664 BENSON AVENUE","3cebaa73-30f4-ea11-b882-24ee9a37d45c",-74007469,40606739,"P.S. 163 - BROOKLYN","1664 BENSON AVENUE"
1,1,0,"45767649-31f4-ea11-b882-24ee9a37d45c","M.S. 255 Salk School of Science - M255 - M040 - 02M255 - 320 EAST 20TH STREET","46767649-31f4-ea11-b882-24ee9a37d45c",-73981536,40735328,"P.S. 40 - MANHATTAN","320 EAST 20TH STREET"
1,0,1,"fdd0de79-30f4-ea11-b882-24ee9a37d45c","P.S. 172 Beacon School of Excellence - K172 - K172 - 15K172 - 825 4 AVENUE","fed0de79-30f4-ea11-b882-24ee9a37d45c",-74000191,40657682,"P.S. 172 - BROOKLYN","825 4 AVENUE"
1,1,0,"d4e8ce00-32f4-ea11-b882-24ee9a37d45c","P.S. 076 William Hallet - Q076 - Q076 - 30Q076 - 36-36 10 Street","d2e8ce00-32f4-ea11-b882-24ee9a37d45c",-73941630,40760862,"P.S. 76 - QUEENS","36-36 10 Street"
1,1,0,"41005d7a-31f4-ea11-b882-24ee9a37d45c","P.S. 171 Patrick Henry - M171 - M171 - 04M171 - 19 EAST 103 STREET","42005d7a-31f4-ea11-b882-24ee9a37d45c",-73951425,40792302,"P.S. 171 - MANHATTAN","19 EAST 103 STREET"
1,0,1,"db92e6d5-30f4-ea11-b882-24ee9a37d45c","Academy for Young Writers - K404 - K422 - 19K404 - 1065 ELTON STREET","da92e6d5-30f4-ea11-b882-24ee9a37d45c",-73874064,40657266,"SPRING CREEK EDUCATIONAL CAMPUS - BROOKLYN","1065 ELTON STREET"
1,0,1,"204f5ffd-e11e-eb11-b885-24ee9a37d45c","District 29 Pre-K Center - Q381 - Q363 - 29Q381 - 134-35 Springfield Boulevard","214f5ffd-e11e-eb11-b885-24ee9a37d45c",-73753270,40679089,"3K CENTER @ SPRINGFIELD BOULEVARD - QUEENS","134-35 Springfield Boulevard"
7,7,0,"d2b66262-32f4-ea11-b882-24ee9a37d45c","Forest Hills High School - Q440 - Q440 - 28Q440 - 67-01 110 STREET","d3b66262-32f4-ea11-b882-24ee9a37d45c",-73843972,40730017,"FOREST HILLS HS - Q","67-01 110 STREET"
1,1,0,"94283fb1-30f4-ea11-b882-24ee9a37d45c","Digital Arts and Cinema Technology High School - K429 - K293 - 15K429 - 284 Baltic Street","91283fb1-30f4-ea11-b882-24ee9a37d45c",-73993293,40685006,"J.H.S. 293 - BROOKLYN","284 Baltic Street"
2,1,1,"8801ce37-33f4-ea11-b882-24ee9a37d45c","P.S. 157 Grove Hill - X157 - X157 - 07X157 - 757 CAULDWELL AVENUE","8901ce37-33f4-ea11-b882-24ee9a37d45c",-73908965,40819419,"P.S. 157 - BRONX","757 CAULDWELL AVENUE"
1,1,0,"920e6e25-32f4-ea11-b882-24ee9a37d45c","P.S. 174 William Sidney Mount - Q174 - Q174 - 28Q174 - 65-10 DIETERLE CRESCENT","930e6e25-32f4-ea11-b882-24ee9a37d45c",-73861462,40720583,"P.S. 174 - QUEENS","65-10 DIETERLE CRESCENT"
1,1,0,"b779df48-30f4-ea11-b882-24ee9a37d45c","P.S. 058 The Carroll - K058 - K058 - 15K058 - 330 SMITH STREET","b879df48-30f4-ea11-b882-24ee9a37d45c",-73995486,40680379,"P.S. 58 - BROOKLYN","330 SMITH STREET"
3,3,0,"722f77fa-31f4-ea11-b882-24ee9a37d45c","J.H.S. 067 Louis Pasteur - Q067 - Q067 - 26Q067 - 51-60 MARATHON PARKWAY","732f77fa-31f4-ea11-b882-24ee9a37d45c",-73734832,40762241,"J.H.S. 67 - QUEENS","51-60 MARATHON PARKWAY"
2,1,1,"f609e2e1-30f4-ea11-b882-24ee9a37d45c","Boys and Girls High School - K455 - K455 - 16K455 - 1700 FULTON STREET","f209e2e1-30f4-ea11-b882-24ee9a37d45c",-73931604,40678478,"BOYS & GIRLS HS - K","1700 FULTON STREET"
15,11,4,"6dd92255-30f4-ea11-b882-24ee9a37d45c","P.S. 084 Jose De Diego - K084 - K084 - 14K084 - 250 Berry Street","6ed92255-30f4-ea11-b882-24ee9a37d45c",-73963808,40715089,"P.S. 84 - BROOKLYN","250 Berry Street"
4,3,1,"64977d2b-32f4-ea11-b882-24ee9a37d45c","J.H.S. 185 Edward Bleeker - Q185 - Q185 - 25Q185 - 147-26 25 DRIVE","ae0e6e25-32f4-ea11-b882-24ee9a37d45c",-73818607,40774906,"J.H.S. 185 - QUEENS","147-26 25 DRIVE"
2,1,1,"45e61462-31f4-ea11-b882-24ee9a37d45c","Bard High School Early College - M696 - M097 - 01M696 - 525 EAST HOUSTON STREET","46e61462-31f4-ea11-b882-24ee9a37d45c",-73976093,40718276,"BARD COLLEGE HS (OLD M097) - M","525 EAST HOUSTON STREET"
2,2,0,"572b3eee-30f4-ea11-b882-24ee9a37d45c","Origins High School - K611 - K495 - 22K611 - 3000 AVENUE X","552b3eee-30f4-ea11-b882-24ee9a37d45c",-73936635,40593157,"Frank J. Macchiarola Educational Complex","3000 AVENUE X"
1,0,1,"a52aa42b-33f4-ea11-b882-24ee9a37d45c","Riverdale / Kingsbridge Academy (Middle School / High School 141) - X141 - X141 - 10X141 - 660 West 237 Street","a62aa42b-33f4-ea11-b882-24ee9a37d45c",-73914141,40887407,"M.S./H.S. 141 - BRONX","660 West 237 Street"
3,3,0,"aaab074a-33f4-ea11-b882-24ee9a37d45c","Urban Institute of Mathematics - X371 - X192 - 08X371 - 650 HOLLYWOOD AVENUE","078b0044-33f4-ea11-b882-24ee9a37d45c",-73818083,40826794,"I.S. 192 - BRONX","650 HOLLYWOOD AVENUE"
1,0,1,"58e61462-31f4-ea11-b882-24ee9a37d45c","P.S. 102 Jacques Cartier - M102 - M102 - 04M102 - 315 EAST 113 STREET","56e61462-31f4-ea11-b882-24ee9a37d45c",-73938418,40795000,"P.S. 102 - MANHATTAN","315 EAST 113 STREET"
2,2,0,"9553dd74-33f4-ea11-b882-24ee9a37d45c","University Heights Secondary School - X495 - X470 - 07X495 - 701 ST. ANNS AVENUE","9253dd74-33f4-ea11-b882-24ee9a37d45c",-73911633,40818041,"SOUTH BRONX EDUCATIONAL CAMPUS (OLD 38) - X","701 ST. ANNS AVENUE"
2,0,2,"652f77fa-31f4-ea11-b882-24ee9a37d45c","P. S. 62 - Chester Park School - Q062 - Q062 - 27Q062 - 97-25 108 STREET","642f77fa-31f4-ea11-b882-24ee9a37d45c",-73835567,40688359,"P.S. 62 - QUEENS","97-25 108 STREET"
1,1,0,"8ca9d9c3-32f4-ea11-b882-24ee9a37d45c","P.S. 35 The Clove Valley School - R035 - R035 - 31R035 - 60 FOOTE AVENUE","8da9d9c3-32f4-ea11-b882-24ee9a37d45c",-74098994,40613548,"P.S. 35 - STATEN ISLAND","60 FOOTE AVENUE"
1,1,0,"7e34aa92-31f4-ea11-b882-24ee9a37d45c","Quest to Learn - M422 - M440 - 02M422 - 351 WEST  18 STREET","7834aa92-31f4-ea11-b882-24ee9a37d45c",-74002540,40743407,"BAYARD RUSTIN EDUCATIONAL COMP-M","351 WEST  18 STREET"
1,1,0,"cee8ce00-32f4-ea11-b882-24ee9a37d45c","J.H.S. 074 Nathaniel Hawthorne - Q074 - Q074 - 26Q074 - 61-15 Oceania Street","cfe8ce00-32f4-ea11-b882-24ee9a37d45c",-73766653,40744743,"I.S. 74 - QUEENS","61-15 Oceania Street"
1,1,0,"88c1797b-ebf6-ea11-b883-24ee9a37d459","Restart Academy - M973 - MAKG -  - 411 WEST 114 STREET","8a3eb8c9-31f4-ea11-b882-24ee9a37d45c",-73960923,40805305,"CARES","411 WEST 114 STREET"
2,1,1,"0dd1de79-30f4-ea11-b882-24ee9a37d45c","P.S. 177 The Marlboro - K177 - K177 - 21K177 - 346 AVENUE P","0ed1de79-30f4-ea11-b882-24ee9a37d45c",-73974425,40608169,"P.S. 177 - BROOKLYN","346 AVENUE P"
2,1,1,"31a10a44-32f4-ea11-b882-24ee9a37d45c","P.S. 251 Queens - Q251 - Q251 - 29Q251 - 144-51 Arthur Street","32a10a44-32f4-ea11-b882-24ee9a37d45c",-73759396,40664809,"P.S. 251 (TANDEM Q231) - QUEENS","144-51 Arthur Street"
1,1,0,"c548b1f5-eaf6-ea11-b883-24ee9a37d459","Urban Assembly New York Harbor School - M551 - M877 - 02M551 - 10 South Street, Slip 7","86c280bd-31f4-ea11-b882-24ee9a37d45c",-74018941,40689493,"NEW YORK HARBOR SCHOOL - MANHATTAN","10 South Street, Slip 7"
2,1,1,"3788e6db-30f4-ea11-b882-24ee9a37d45c","FDNY - Captain Vernon A. Richard High School for Fire and Life Safety - K502 - K435 - 19K502 - 400 PENNSYLVANIA AVENUE","3688e6db-30f4-ea11-b882-24ee9a37d45c",-73895122,40666868,"THOMAS JEFFERSON HS - K","400 PENNSYLVANIA AVENUE"
2,2,0,"90c280bd-31f4-ea11-b882-24ee9a37d45c","Harvest Collegiate High School - M534 - M883 - 02M534 - 34 WEST  14 STREET","8fc280bd-31f4-ea11-b882-24ee9a37d45c",-73995731,40736416,"LEGACY HS FOR INTEGR. STUDIES - M","34 WEST  14 STREET"
1,0,1,"62be7adc-32f4-ea11-b882-24ee9a37d45c","Ralph R. McKee Career and Technical Education High School - R600 - R600 - 31R600 - 101 Belmont Place","5ebe7adc-32f4-ea11-b882-24ee9a37d45c",-74079263,40642820,"RALPH MCKEE VOC HS - S. I.","101 Belmont Place"
1,1,0,"89d810ab-31f4-ea11-b882-24ee9a37d45c","Urban Assembly School of Design and Construction, The - M300 - M535 - 02M300 - 525 WEST  50TH STREET","f137fba4-31f4-ea11-b882-24ee9a37d45c",-73992700,40765474,"PARK WEST HS (ECF) - MANHATTAN","525 WEST  50TH STREET"
2,2,0,"dd92e6d5-30f4-ea11-b882-24ee9a37d45c","Spring Creek Community School - K422 - K422 - 19K422 - 1065 ELTON STREET","da92e6d5-30f4-ea11-b882-24ee9a37d45c",-73874064,40657266,"SPRING CREEK EDUCATIONAL CAMPUS - BROOKLYN","1065 ELTON STREET"
1,1,0,"b4a00518-4afb-ea11-b883-24ee9a37d459","MEDGAR EVERS COLLEGE - KBVL - K880 -  - 1150 Carroll Street","1204d718-31f4-ea11-b882-24ee9a37d45c",-73951823,40666790,"MIDDLE COLLLEGE HS - BROOKLYN","1150 Carroll Street"
1,0,1,"074456d0-48fb-ea11-b883-24ee9a37d459","Imagine Dumbo - Monroe - KCEH - KAGS -  - 50 MONROE PLACE","084456d0-48fb-ea11-b883-24ee9a37d459",-73992646,40695340,"LOW MEMORIAL SCHOOL","50 MONROE PLACE"
4,0,4,"18474313-33f4-ea11-b882-24ee9a37d45c","P.S. 086 Kingsbridge Heights - X086 - X086 - 10X086 - 2756 RESERVOIR AVENUE","19474313-33f4-ea11-b882-24ee9a37d45c",-73897066,40869061,"P.S. 86 - BRONX","2756 RESERVOIR AVENUE"
1,1,0,"d0e0838c-31f4-ea11-b882-24ee9a37d45c","Richard R. Green High School of Teaching - M580 - M282 - 02M580 - 7 BEAVER STREET","d1e0838c-31f4-ea11-b882-24ee9a37d45c",-74013303,40705688,"BROADWAY EDUCATION CAMPUS - M","26 BROADWAY"
4,2,2,"86e657bd-30f4-ea11-b882-24ee9a37d45c","P.S. 312 Bergen Beach - K312 - K312 - 22K312 - 7103 Avenue T","87e657bd-30f4-ea11-b882-24ee9a37d45c",-73909554,40622442,"P.S. 312 - BROOKLYN","7103 Avenue T"
6,6,0,"ace657bd-30f4-ea11-b882-24ee9a37d45c","P.S. 321 William Penn - K321 - K321 - 15K321 - 180 7 AVENUE","ade657bd-30f4-ea11-b882-24ee9a37d45c",-73978633,40671816,"P.S. 321 - BROOKLYN","180 7 AVENUE"
1,1,0,"4c5bc58c-30f4-ea11-b882-24ee9a37d45c","P.S. 214 Michael Friedsam - K214 - K214 - 19K214 - 2944 PITKIN AVENUE","4b5bc58c-30f4-ea11-b882-24ee9a37d45c",-73862961,40675881,"P.S. 214 - BROOKLYN","2944 PITKIN AVENUE"
1,0,1,"5ae61462-31f4-ea11-b882-24ee9a37d45c","P.S. 108 Assemblyman Angelo Del Toro Educational Complex - M108 - M108 - 04M108 - 1615 MADISON AVENUE","5be61462-31f4-ea11-b882-24ee9a37d45c",-73947855,40795032,"P.S. 108 - MANHATTAN","1615 MADISON AVENUE"
1,1,0,"e7f22ce2-31f4-ea11-b882-24ee9a37d45c","I.S. 5 - The Walter Crowley Intermediate School - Q005 - Q005 - 24Q005 - 50-40 JACOBUS STREET","9adc32dc-31f4-ea11-b882-24ee9a37d45c",-73888133,40737405,"I.S. 5 - QUEENS","50-40 JACOBUS STREET"
1,1,0,"bbba3c50-33f4-ea11-b882-24ee9a37d45c","Comprehensive Model School Project M.S. 327 - X327 - X240 - 09X327 - 1501 JEROME AVENUE","baba3c50-33f4-ea11-b882-24ee9a37d45c",-73916084,40842503,"DOE NEW SETTLEMENT COMMUNITY CAMPUS - X","1501 JEROME AVENUE"
3,3,0,"de315367-30f4-ea11-b882-24ee9a37d45c","P.S. 135 Sheldon A. Brookner - K135 - K135 - 18K135 - 684 LINDEN BOULEVARD","df315367-30f4-ea11-b882-24ee9a37d45c",-73932949,40653093,"P.S. 135 - BROOKLYN","684 LINDEN BOULEVARD"
1,1,0,"538dbfcf-30f4-ea11-b882-24ee9a37d45c","Abraham Lincoln High School - K410 - K410 - 21K410 - 2800 OCEAN PARKWAY","518dbfcf-30f4-ea11-b882-24ee9a37d45c",-73968733,40582627,"ABRAHAM LINCOLN HS - K","2800 OCEAN PARKWAY"
1,0,1,"8b11b2e2-32f4-ea11-b882-24ee9a37d45c","Staten Island School of Civic Leadership - R861 - R861 - 31R861 - 280 REGIS DRIVE","8a11b2e2-32f4-ea11-b882-24ee9a37d45c",-74164427,40620310,"ELIZABETH A. CONNELLY CAMPUS - S.I.","280 REGIS DRIVE"
1,1,0,"06b7c337-32f4-ea11-b882-24ee9a37d45c","J.H.S. 217 Robert A. Van Wyck - Q217 - Q217 - 28Q217 - 85-05 144 STREET","fcb6c337-32f4-ea11-b882-24ee9a37d45c",-73811461,40710384,"I.S. 217 - QUEENS","85-05 144 STREET"
3,3,0,"04f32ce2-31f4-ea11-b882-24ee9a37d45c","P.S. 013 Clement C. Moore - Q013 - Q013 - 24Q013 - 55-01 94 STREET","05f32ce2-31f4-ea11-b882-24ee9a37d45c",-73867662,40737441,"P.S. 13 - QUEENS","55-01 94 STREET"
1,1,0,"c5689025-33f4-ea11-b882-24ee9a37d45c","P.S. 130 Abram Stevens Hewitt - X130 - X130 - 08X130 - 750 PROSPECT AVENUE","c4689025-33f4-ea11-b882-24ee9a37d45c",-73901709,40817742,"P.S. 130 - BRONX","750 PROSPECT AVENUE"
1,0,1,"8dd810ab-31f4-ea11-b882-24ee9a37d45c","Manhattan Bridges High School - M542 - M535 - 02M542 - 525 WEST  50TH STREET","f137fba4-31f4-ea11-b882-24ee9a37d45c",-73992700,40765474,"PARK WEST HS (ECF) - MANHATTAN","525 WEST  50TH STREET"
2,2,0,"6c9d7c62-33f4-ea11-b882-24ee9a37d45c","Bronx Lab School - X265 - X425 - 11X265 - 800 EAST GUN HILL ROAD","699d7c62-33f4-ea11-b882-24ee9a37d45c",-73861649,40875172,"EVANDER CHILDS HS - X","800 EAST GUN HILL ROAD"
3,3,0,"172ed53d-33f4-ea11-b882-24ee9a37d45c","P.S. 214 - X214 - X167 - 12X214 - 1970 WEST FARMS ROAD","152ed53d-33f4-ea11-b882-24ee9a37d45c",-73879931,40839297,"P.S. 214 - BRONX","1970 WEST FARMS ROAD"
2,1,1,"07fc3df4-30f4-ea11-b882-24ee9a37d45c","John Dewey High School - K540 - K540 - 21K540 - 50 AVENUE X","05fc3df4-30f4-ea11-b882-24ee9a37d45c",-73981925,40588070,"JOHN DEWEY HS - K","50 AVENUE X"
6,6,0,"ed21d292-30f4-ea11-b882-24ee9a37d45c","J.H.S. 227 Edward B. Shallow - K227 - K227 - 20K227 - 6500 16 AVENUE","ee21d292-30f4-ea11-b882-24ee9a37d45c",-73995961,40622102,"I.S. 227 - BROOKLYN","6500 16 AVENUE"
3,1,2,"db8fd20d-ebf6-ea11-b883-24ee9a37d459","P.S. K771 - K771 - K014 - 75K771 - 2424 BATCHELDER STREET","eef57030-30f4-ea11-b882-24ee9a37d45c",-73938107,40593232,"I.S. 14 - BROOKLYN","2424 BATCHELDER STREET"
1,0,1,"39de5eb7-30f4-ea11-b882-24ee9a37d45c","P.S. 297 Abraham Stockton - K297 - K297 - 14K297 - 700 PARK AVENUE","38de5eb7-30f4-ea11-b882-24ee9a37d45c",-73948166,40697377,"P.S. 297 - BROOKLYN","700 PARK AVENUE"
1,1,0,"5f3cbf01-ebf6-ea11-b883-24ee9a37d459","P.S. X010 - X010 - X101 - 75X010 - 2750 LAFAYETTE AVENUE","4e474313-33f4-ea11-b882-24ee9a37d45c",-73829211,40827080,"I.S. 101 - BRONX","2750 LAFAYETTE AVENUE"
1,1,0,"502f7d06-31f4-ea11-b882-24ee9a37d45c","The Maurice Sendak Community School - K118 - K763 - 15K118 - 211 8TH STREET","512f7d06-31f4-ea11-b882-24ee9a37d45c",-73987602,40671145,"P.S. 118 MAURICE SENDAK COMMUNITY SCHOOL- BROOKLYN","211 8TH STREET"
5,3,2,"8b476368-32f4-ea11-b882-24ee9a37d45c","Newtown High School - Q455 - Q455 - 24Q455 - 48-01 90 STREET","8c476368-32f4-ea11-b882-24ee9a37d45c",-73874129,40740824,"NEWTOWN HS - Q","48-01 90 STREET"
3,3,0,"55a5db98-30f4-ea11-b882-24ee9a37d45c","J.H.S. 234 Arthur W. Cunningham - K234 - K234 - 22K234 - 1875 EAST  17 STREET","56a5db98-30f4-ea11-b882-24ee9a37d45c",-73955217,40604447,"I.S. 234 - BROOKLYN","1875 EAST  17 STREET"
2,2,0,"81b50aa5-30f4-ea11-b882-24ee9a37d45c","P.S. 268 Emma Lazarus - K268 - K268 - 18K268 - 133 EAST  53 STREET","82b50aa5-30f4-ea11-b882-24ee9a37d45c",-73927560,40657421,"P.S. 268 - BROOKLYN","133 EAST  53 STREET"
5,4,1,"a472c880-32f4-ea11-b882-24ee9a37d45c","Metropolitan Expeditionary Learning School - Q167 - Q686 - 28Q167 - 91-30 METROPOLITAN AVENUE","a372c880-32f4-ea11-b882-24ee9a37d45c",-73855543,40708431,"METROPOLITAN AVENUE CAMPUS - QUEENS","91-30 METROPOLITAN AVENUE"
1,1,0,"be79df48-30f4-ea11-b882-24ee9a37d45c","M.S. 061 Dr. Gladstone H. Atwell - K061 - K061 - 17K061 - 400 EMPIRE BOULEVARD","bd79df48-30f4-ea11-b882-24ee9a37d45c",-73949198,40663605,"I.S. 61 - BROOKLYN","400 EMPIRE BOULEVARD"
10,10,0,"bdb66262-32f4-ea11-b882-24ee9a37d45c","Francis Lewis High School - Q430 - Q430 - 26Q430 - 58-20 UTOPIA PARKWAY","bcb66262-32f4-ea11-b882-24ee9a37d45c",-73795049,40740875,"FRANCIS LEWIS HS - Q","58-20 UTOPIA PARKWAY"
1,0,1,"fde1abc9-30f4-ea11-b882-24ee9a37d45c","P.S. 156 Waverly - K156 - K356 - 23K156 - 104 SUTTER AVENUE","35a198c3-30f4-ea11-b882-24ee9a37d45c",-73917880,40665553,"P.S. 156 - BROOKLYN","104 SUTTER AVENUE"
3,3,0,"b03fce93-7c88-ec11-b8d0-24ee9a37d45c","Academy of American Studies - Q575 - Q575 - 30Q575 - 40-11 28th Street","b13fce93-7c88-ec11-b8d0-24ee9a37d45c",-73936596,40751839,"ACADEMY OF AMERICAN STUDIES - QUEENS","40-11 28th Street"
1,1,0,"e3ed94c3-31f4-ea11-b882-24ee9a37d45c","Harlem Renaissance High School - M285 - M911 - 05M285 - 22 East 128 Street","dfed94c3-31f4-ea11-b882-24ee9a37d45c",-73939974,40807692,"HARLEM RENAISSANCE HS (OLD M24)-M","22 East 128 Street"
3,3,0,"27e2abc9-30f4-ea11-b882-24ee9a37d45c","The School of Integrated Learning - K354 - K390 - 17K354 - 1224 PARK PLACE","25e2abc9-30f4-ea11-b882-24ee9a37d45c",-73937601,40672290,"I.S. 390 - BROOKLYN","1224 PARK PLACE"
3,1,2,"ebd10307-33f4-ea11-b882-24ee9a37d45c","P.S. 069 Journey Prep School - X069 - X069 - 08X069 - 560 THIERIOT AVENUE","ecd10307-33f4-ea11-b882-24ee9a37d45c",-73860460,40816700,"P.S. 69 - BRONX","560 THIERIOT AVENUE"
1,1,0,"8b01ce37-33f4-ea11-b882-24ee9a37d45c","Bronx Latin - X267 - X158 - 12X267 - 800 HOME STREET","8601ce37-33f4-ea11-b882-24ee9a37d45c",-73900593,40826933,"I.S. 158 - BRONX","800 HOME STREET"
4,2,2,"59be7adc-32f4-ea11-b882-24ee9a37d45c","Susan E. Wagner High School - R460 - R460 - 31R460 - 1200 MANOR ROAD","5abe7adc-32f4-ea11-b882-24ee9a37d45c",-74130819,40588985,"SUSAN E. WAGNER HS - S. I.","1200 MANOR ROAD"
1,0,1,"6f2f77fa-31f4-ea11-b882-24ee9a37d45c","P.S. 066 Jacqueline Kennedy Onassis - Q066 - Q066 - 27Q066 - 85-11 102 Street","702f77fa-31f4-ea11-b882-24ee9a37d45c",-73846135,40697941,"P.S. 66 - QUEENS","85-11 102 Street"
2,2,0,"6f283fb1-30f4-ea11-b882-24ee9a37d45c","I.S. 285 Meyer Levin - K285 - K285 - 18K285 - 5909 BEVERLY ROAD","70283fb1-30f4-ea11-b882-24ee9a37d45c",-73920784,40647818,"I.S. 285 - BROOKLYN","5909 BEVERLY ROAD"
2,1,1,"f721d292-30f4-ea11-b882-24ee9a37d45c","P.S. 230 Doris L. Cohen - K230 - K230 - 15K230 - 1 ALBEMARLE ROAD","f321d292-30f4-ea11-b882-24ee9a37d45c",-73980515,40645609,"P.S. 230 - BROOKLYN","1 ALBEMARLE ROAD"
1,1,0,"d60d3c5b-30f4-ea11-b882-24ee9a37d45c","P.S. 101 The Verrazano - K101 - K101 - 21K101 - 8696 24 Avenue","d70d3c5b-30f4-ea11-b882-24ee9a37d45c",-73991962,40597379,"P.S. 101 - BROOKLYN","8696 24 Avenue"
1,0,1,"ba689025-33f4-ea11-b882-24ee9a37d45c","J.H.S. 127 The Castle Hill - X127 - X127 - 11X127 - 1560 PURDY STREET","b9689025-33f4-ea11-b882-24ee9a37d45c",-73853203,40838759,"I.S. 127 - BRONX","1560 PURDY STREET"
1,0,1,"f32ece86-32f4-ea11-b882-24ee9a37d45c","Queens High School for the Sciences at York College - Q687 - Q774 - 28Q687 - 94-50 159 Street","f42ece86-32f4-ea11-b882-24ee9a37d45c",-73798364,40700884,"QUEENS HIGH SCHOOL FOR THE SCIENCES","94-50 159 Street"
4,3,1,"1eb4977a-32f4-ea11-b882-24ee9a37d45c","Townsend Harris High School - Q525 - Q515 - 25Q525 - 149-11 MELBOURNE AVENUE","1db4977a-32f4-ea11-b882-24ee9a37d45c",-73821532,40737038,"TOWNSEND HARRIS HS - Q","149-11 MELBOURNE AVENUE"
2,2,0,"66b50aa5-30f4-ea11-b882-24ee9a37d45c","P.S. 261 Philip Livingston - K261 - K261 - 15K261 - 314 PACIFIC STREET","5fb50aa5-30f4-ea11-b882-24ee9a37d45c",-73988667,40687218,"P.S. 261 - BROOKLYN","314 PACIFIC STREET"
1,1,0,"3245378b-4afb-ea11-b883-24ee9a37d459","Trabajamos Community Head Start, Inc. Center # 6 - XAHH - XAKP -  - 1997 BATHGATE AVENUE","3345378b-4afb-ea11-b883-24ee9a37d459",-73896075,40848824,"BATHGATE LEARNING CENTER","1997 BATHGATE AVENUE"
1,1,0,"21e6ada5-070b-ec11-b8b4-24ee9a37d45c","Learning through Play Pre-K Center - X533 - X494 - 07X533 - 443 East 162nd Street","22e6ada5-070b-ec11-b8b4-24ee9a37d45c",-73911527,40824527,"3K CENTER @ EAST 162ND STREET - BRONX","443 East 162nd Street"
3,3,0,"798d8486-31f4-ea11-b882-24ee9a37d45c","KIPP STAR College Prep Charter School - M726 - M195 - 84M726 - 625 WEST 133 STREET","758d8486-31f4-ea11-b882-24ee9a37d45c",-73956814,40819793,"TERENCE D. TOLBERT EDUCATION COMPLEX - MANHATTAN","625 WEST 133 STREET"
1,1,0,"bae0838c-31f4-ea11-b882-24ee9a37d45c","P.S. 234 Independence School - M234 - M234 - 02M234 - 292 GREENWICH STREET","bbe0838c-31f4-ea11-b882-24ee9a37d45c",-74010880,40719530,"P.S. 234 - MANHATTAN","292 GREENWICH STREET"
3,3,0,"07a31781-33f4-ea11-b882-24ee9a37d45c","Pharos Academy Charter School - X185 - X716 - 84X185 - 1001 Intervale Avenue","08a31781-33f4-ea11-b882-24ee9a37d45c",-73897394,40823228,"BRONX LIGHTHOUSE CHARTER SCHOOL - BRONX","1001 Intervale Avenue"
2,1,1,"692b3eee-30f4-ea11-b882-24ee9a37d45c","Franklin Delano Roosevelt High School - K505 - K505 - 20K505 - 5800 20 AVENUE","682b3eee-30f4-ea11-b882-24ee9a37d45c",-73982583,40621299,"FRANKLIN D. ROOSEVELT HS - K","5800 20 AVENUE"
3,2,1,"87c280bd-31f4-ea11-b882-24ee9a37d45c","Gregorio Luperon High School for Science and Mathematics - M552 - M876 - 06M552 - 501 WEST 165TH STREET","88c280bd-31f4-ea11-b882-24ee9a37d45c",-73938300,40838100,"GREGORIO LUPERON PREP. SCHOOL - M","501 WEST 165TH STREET"
1,1,0,"6db46b14-e31e-eb11-b885-24ee9a37d45c","Pharos Academy Charter School - X185 - XATV - 84X185 - 1005 INTERVALE AVENUE","6eb46b14-e31e-eb11-b885-24ee9a37d45c",-73897394,40823228,"BRONX LIGHTHOUSE CHARTER SCHOOL ANNEX - BRONX","1005 INTERVALE AVENUE"
3,2,1,"e68521d0-32f4-ea11-b882-24ee9a37d45c","I.S. 075 Frank D. Paulo - R075 - R075 - 31R075 - 455 HUGUENOT AVENUE","e28521d0-32f4-ea11-b882-24ee9a37d45c",-74197033,40544535,"I.S. 75 - STATEN ISLAND","455 HUGUENOT AVENUE"
1,1,0,"f021d292-30f4-ea11-b882-24ee9a37d45c","I.S. 228 David A. Boody - K228 - K228 - 21K228 - 228 AVENUE S","e921d292-30f4-ea11-b882-24ee9a37d45c",-73976801,40600660,"I.S. 228 - BROOKLYN","228 AVENUE S"
1,0,1,"35a6ba98-31f4-ea11-b882-24ee9a37d45c","The Urban Assembly School for Green Careers - M402 - M470 - 03M402 - 145 WEST  84 STREET","33a6ba98-31f4-ea11-b882-24ee9a37d45c",-73974483,40786134,"LOUIS D. BRANDEIS HS - MANHATTAN","145 WEST  84 STREET"
2,2,0,"9d476368-32f4-ea11-b882-24ee9a37d45c","Queens High School for Language Studies - Q241 - Q460 - 25Q241 - 35-01 UNION STREET","97476368-32f4-ea11-b882-24ee9a37d45c",-73826811,40764892,"FLUSHING HS - Q","35-01 UNION STREET"
1,1,0,"496dc81a-e9fe-eb11-b8b2-24ee9a37d45c","Yvonne's  Daycare - Apt 8G - MCAT - MCAT -  - 179 Bennett Avenue","4a6dc81a-e9fe-eb11-b8b2-24ee9a37d45c",-73933777,40856586,"179 BENNETT AVENUE","179 Bennett Avenue"
1,1,0,"369f4974-31f4-ea11-b882-24ee9a37d45c","Manhattan Charter School - M320 - M142 - 84M320 - 100 ATTORNEY STREET","379f4974-31f4-ea11-b882-24ee9a37d45c",-73984116,40718121,"P.S. 142 - MANHATTAN","100 ATTORNEY STREET"
3,2,1,"a7e657bd-30f4-ea11-b882-24ee9a37d45c","P.S. 375 Jackie Robinson School - K375 - K320 - 17K375 - 46 MCKEEVER PLACE","a1e657bd-30f4-ea11-b882-24ee9a37d45c",-73959484,40665199,"P.S. 375 - BROOKLYN","46 MCKEEVER PLACE"
2,2,0,"bbfc24e8-31f4-ea11-b882-24ee9a37d45c","P.S. 024 Andrew Jackson - Q024 - Q024 - 25Q024 - 45-57 UNION STREET","b6fc24e8-31f4-ea11-b882-24ee9a37d45c",-73818100,40751972,"P.S. 24 - QUEENS","45-57 UNION STREET"
1,1,0,"aad91731-31f4-ea11-b882-24ee9a37d45c","Home Schooling - QH30 - Q000 - 30Q444 - NOT AVAILABLE","abd91731-31f4-ea11-b882-24ee9a37d45c",0,0,"UNASSIGNED","NOT AVAILABLE"
2,2,0,"993aa668-33f4-ea11-b882-24ee9a37d45c","High School for Contemporary Arts - X544 - X425 - 11X544 - 800 EAST GUN HILL ROAD","699d7c62-33f4-ea11-b882-24ee9a37d45c",-73861649,40875172,"EVANDER CHILDS HS - X","800 EAST GUN HILL ROAD"
2,2,0,"1c06003e-32f4-ea11-b882-24ee9a37d45c","I.S. 237 - Q237 - Q237 - 25Q237 - 46-21 COLDEN STREET","1b06003e-32f4-ea11-b882-24ee9a37d45c",-73821402,40749430,"J.H.S. 237 - QUEENS","46-21 COLDEN STREET"
1,1,0,"bd0d3c5b-30f4-ea11-b882-24ee9a37d45c","P.S. 094 The Henry Longfellow - K094 - K094 - 15K094 - 5010 6 AVENUE","8fd92255-30f4-ea11-b882-24ee9a37d45c",-74008795,40643730,"P.S. 94 - BROOKLYN","5010 6 AVENUE"
2,2,0,"4f0d6d19-33f4-ea11-b882-24ee9a37d45c","P.S. 111 Seton Falls - X111 - X111 - 11X111 - 3740 Baychester Avenue","4d0d6d19-33f4-ea11-b882-24ee9a37d45c",-73839288,40884371,"P.S. 111 - BRONX","3740 Baychester Avenue"
1,1,0,"0c5d0a12-4afb-ea11-b883-24ee9a37d459","Tabernacle Day Care Center, Inc. - KBCV - KBCV -  - 34-52 KOSCIUSKO STREET","0d5d0a12-4afb-ea11-b883-24ee9a37d459",-73953631,40690133,"TABERNACLE DAY CARE CENTER, INC.","34-52 KOSCIUSKO STREET"
1,1,0,"20c0c20d-ecf6-ea11-b883-24ee9a37d459","Rose Hill Pre-K Center - X535 - XACL - 10X535 - 2512 MARION AVENUE","8a45e7a5-33f4-ea11-b882-24ee9a37d45c",-73892899,40861128,"OUR LADY OF MERCY SCHOOL","2512 MARION AVENUE"
1,0,1,"fbf22ce2-31f4-ea11-b882-24ee9a37d45c","I.S. 010 Horace Greeley - Q010 - Q010 - 30Q010 - 45-11 31st Ave","fcf22ce2-31f4-ea11-b882-24ee9a37d45c",-73911962,40760122,"I.S. 10 - QUEENS","45-11 31st Ave"
1,1,0,"6c03194f-30f4-ea11-b882-24ee9a37d45c","I.S. 068 Isaac Bildersee - K068 - K068 - 18K068 - 956 EAST  82 STREET","6b03194f-30f4-ea11-b882-24ee9a37d45c",-73911215,40635388,"I.S. 68 - BROOKLYN","956 EAST  82 STREET"
1,0,1,"489d7c62-33f4-ea11-b882-24ee9a37d45c","Astor Collegiate Academy - X299 - X415 - 11X299 - 925 ASTOR AVENUE","439d7c62-33f4-ea11-b882-24ee9a37d45c",-73860729,40860443,"CHRISTOPHER COLUMBUS HS - X","925 ASTOR AVENUE"
3,2,1,"c20d3c5b-30f4-ea11-b882-24ee9a37d45c","P.S. 095 The Gravesend - K095 - K095 - 21K095 - 345 VAN SICKLEN STREET","c30d3c5b-30f4-ea11-b882-24ee9a37d45c",-73974664,40595996,"P.S. 95 - BROOKLYN","345 VAN SICKLEN STREET"
1,1,0,"83e03d56-33f4-ea11-b882-24ee9a37d45c","Morris Academy for Collaborative Studies - X297 - X400 - 09X297 - 1110 BOSTON ROAD","82e03d56-33f4-ea11-b882-24ee9a37d45c",-73903920,40827455,"MORRIS HS - X","1110 BOSTON ROAD"
2,1,1,"fa77931f-33f4-ea11-b882-24ee9a37d45c","Academy For Personal Leadership And Excellence - X363 - X115 - 10X363 - 120 EAST 184 STREET","5b0d6d19-33f4-ea11-b882-24ee9a37d45c",-73900490,40859496,"I.S. 399 (OLD X HS/X115) - BRONX","120 EAST 184 STREET"
2,2,0,"8407e99e-31f4-ea11-b882-24ee9a37d45c","Manhattan / Hunter Science High School - M541 - M490 - 03M541 - 122 AMSTERDAM AVENUE","7c07e99e-31f4-ea11-b882-24ee9a37d45c",-73985608,40774891,"MARTIN LUTHER KING, JR. HS - M","122 AMSTERDAM AVENUE"
5,5,0,"7ea5db98-30f4-ea11-b882-24ee9a37d45c","Brooklyn Science and Engineering Academy - K763 - K244 - 18K763 - 5404 TILDEN AVENUE","7fa5db98-30f4-ea11-b882-24ee9a37d45c",-73925592,40647851,"P.S. 244 - BROOKLYN","5404 TILDEN AVENUE"
1,1,0,"77e2635c-32f4-ea11-b882-24ee9a37d45c","Channel View School for Research - Q262 - Q410 - 27Q262 - 100-00 BEACH CHANNEL DRIVE","71e2635c-32f4-ea11-b882-24ee9a37d45c",-73825317,40586012,"Beach Channel Educational Campus","100-00 BEACH CHANNEL DRIVE"
1,1,0,"fc454b50-32f4-ea11-b882-24ee9a37d45c","College Point Collaborative - Q379 - Q336 - 25Q379 - 12406 14TH AVENUE","fd454b50-32f4-ea11-b882-24ee9a37d45c",-73843504,40785129,"The College Point Collaborative Educational Buildi","12406 14TH AVENUE"
1,1,0,"d3ed94c3-31f4-ea11-b882-24ee9a37d45c","Young Women's Leadership School - M610 - M895 - 04M610 - 105 East 106th Street","d4ed94c3-31f4-ea11-b882-24ee9a37d45c",-73947171,40792932,"YOUNG WOMEN'S LEADERSHIP HS - M","105 East 106th Street"
4,3,1,"848946f4-31f4-ea11-b882-24ee9a37d45c","P.S. 58 - The School of Heroes - Q058 - Q058 - 24Q058 - 72-24 GRAND AVENUE","808946f4-31f4-ea11-b882-24ee9a37d45c",-73890638,40728517,"P.S. 58 - QUEENS","72-24 GRAND AVENUE"
2,1,1,"f3f22ce2-31f4-ea11-b882-24ee9a37d45c","J.H.S. 008 Richard S. Grossley - Q008 - Q008 - 28Q008 - 108-35 167 STREET","f1f22ce2-31f4-ea11-b882-24ee9a37d45c",-73786403,40696910,"J.H.S. 8 - QUEENS","108-35 167 STREET"
1,0,1,"1f005d7a-31f4-ea11-b882-24ee9a37d45c","P.S. 158 Bayard Taylor - M158 - M158 - 02M158 - 1458 YORK AVENUE","1d005d7a-31f4-ea11-b882-24ee9a37d45c",-73950745,40770215,"P.S. 158 - MANHATTAN","1458 YORK AVENUE"
1,0,1,"ae17ab87-ebf6-ea11-b883-24ee9a37d459","Restart Academy - M973 - OAUX -  - P.O. Box 547/5808 Rt. 42","83dc32dc-31f4-ea11-b882-24ee9a37d45c",0,0,"Dynamite Youth Center - FALLSBURG","P.O. Box 547/5808 Rt. 42"
6,6,0,"b82ff20c-32f4-ea11-b882-24ee9a37d45c","P.S. 108 Captain Vincent G. Fowler - Q108 - Q108 - 27Q108 - 108-10 109 AVENUE","b92ff20c-32f4-ea11-b882-24ee9a37d45c",-73831025,40679083,"P.S. 108 - QUEENS","108-10 109 AVENUE"
1,1,0,"19ba8b86-30f4-ea11-b882-24ee9a37d45c","P.S. 208 Elsa Ebeling - K208 - K208 - 18K208 - 4801 AVENUE D","1aba8b86-30f4-ea11-b882-24ee9a37d45c",-73930898,40642700,"P.S. 208 - BROOKLYN","4801 AVENUE D"
4,4,0,"150410ca-32f4-ea11-b882-24ee9a37d45c","Gaynor McCown Expeditionary Learning School - R064 - R043 - 31R064 - 100 ESSEX DRIVE","a0a9d9c3-32f4-ea11-b882-24ee9a37d45c",-74159343,40581958,"JEROME PARKER CAMPUS - S.I.","100 ESSEX DRIVE"
1,1,0,"7303194f-30f4-ea11-b882-24ee9a37d45c","P.S. 69 Vincent D. Grippo School - K069 - K069 - 20K069 - 6302 9TH AVENUE","7203194f-30f4-ea11-b882-24ee9a37d45c",-74009752,40632392,"P.S. 69 - BROOKLYN","6302 9TH AVENUE"
1,1,0,"81a5db98-30f4-ea11-b882-24ee9a37d45c","P.S. 244 Richard R. Green - K244 - K244 - 18K244 - 5404 TILDEN AVENUE","7fa5db98-30f4-ea11-b882-24ee9a37d45c",-73925592,40647851,"P.S. 244 - BROOKLYN","5404 TILDEN AVENUE"
1,0,1,"4a9d7c62-33f4-ea11-b882-24ee9a37d45c","Bronxdale High School - X508 - X415 - 11X508 - 925 ASTOR AVENUE","439d7c62-33f4-ea11-b882-24ee9a37d45c",-73860729,40860443,"CHRISTOPHER COLUMBUS HS - X","925 ASTOR AVENUE"
4,4,0,"5588e6db-30f4-ea11-b882-24ee9a37d45c","New Utrecht High School - K445 - K445 - 20K445 - 1601 80 STREET","5488e6db-30f4-ea11-b882-24ee9a37d45c",-74002308,40613041,"NEW UTRECHT HS - K","1601 80 STREET"
2,0,2,"cbe8ce00-32f4-ea11-b882-24ee9a37d45c","I.S. 73 - The Frank Sansivieri Intermediate School - Q073 - Q073 - 24Q073 - 70-02 54 AVENUE","cce8ce00-32f4-ea11-b882-24ee9a37d45c",-73893318,40728558,"I.S. 73 - QUEENS","70-02 54 AVENUE"
1,1,0,"58507380-31f4-ea11-b882-24ee9a37d45c","P.S./I.S. 187 Hudson Cliffs - M187 - M187 - 06M187 - 349 CABRINI BOULEVARD","59507380-31f4-ea11-b882-24ee9a37d45c",-73936840,40856239,"P.S./I.S. 187 - MANHATTAN","349 CABRINI BOULEVARD"
2,0,2,"d03159fa-30f4-ea11-b882-24ee9a37d45c","Sunset Park High School - K667 - K564 - 15K667 - 153 35TH STREET","18fc3df4-30f4-ea11-b882-24ee9a37d45c",-74004342,40655583,"SUNSET PARK HS - BROOKLYN","153 35TH STREET"
2,2,0,"ea21d292-30f4-ea11-b882-24ee9a37d45c","P.S. 226 Alfred De B. Mason - K226 - K226 - 21K226 - 6006 23 AVENUE","eb21d292-30f4-ea11-b882-24ee9a37d45c",-73977099,40615405,"P.S. 226 - BROOKLYN","6006 23 AVENUE"
2,1,1,"4e6e70b7-31f4-ea11-b882-24ee9a37d45c","Community Health Academy of the Heights - M346 - M814 - 06M346 - 504 WEST 158TH STREET","4f6e70b7-31f4-ea11-b882-24ee9a37d45c",-73942074,40833695,"THE COMMUNITY HEALTH ACADEMY OF THE HEIGHTS - M","504 WEST 158TH STREET"
2,2,0,"c9fab455-31f4-ea11-b882-24ee9a37d45c","The East Village Community School - M315 - M061 - 01M315 - 610 EAST  12 STREET","c8fab455-31f4-ea11-b882-24ee9a37d45c",-73978254,40727537,"P.S. 61 - MANHATTAN","610 EAST  12 STREET"
2,2,0,"ceb36d80-30f4-ea11-b882-24ee9a37d45c","P.S. 185 Walter Kassenbrock - K185 - K185 - 20K185 - 8601 RIDGE BOULEVARD","cfb36d80-30f4-ea11-b882-24ee9a37d45c",-74033429,40623598,"P.S. 185 - BROOKLYN","8601 RIDGE BOULEVARD"
1,1,0,"eed10307-33f4-ea11-b882-24ee9a37d45c","P.S. 070 Max Schoenfeld - X070 - X070 - 09X070 - 1691 WEEKS AVENUE","efd10307-33f4-ea11-b882-24ee9a37d45c",-73908070,40844236,"P.S. 70 - BRONX","1691 WEEKS AVENUE"
1,1,0,"40b4977a-32f4-ea11-b882-24ee9a37d45c","Queens Technical High School - Q600 - Q600 - 24Q600 - 37-02 47 AVENUE","41b4977a-32f4-ea11-b882-24ee9a37d45c",-73927995,40741658,"QUEENS VOC HS - Q","37-02 47 AVENUE"
1,1,0,"8d7e21a6-ebf6-ea11-b883-24ee9a37d459","Mosaic Pre-K Center - Q331 - Q298 - 24Q331 - 50-51 98th Street","30c73b4a-32f4-ea11-b882-24ee9a37d45c",-73863408,40741139,"Marie M. Daly Educational Building","50-51 98th Street"
3,2,1,"2aeabc42-30f4-ea11-b882-24ee9a37d45c","P.S. 052 Sheepshead Bay - K052 - K052 - 22K052 - 2675 EAST  29 STREET","26eabc42-30f4-ea11-b882-24ee9a37d45c",-73940135,40588372,"P.S. 52 - BROOKLYN","2675 EAST  29 STREET"
1,0,1,"bebfa431-33f4-ea11-b882-24ee9a37d45c","South Bronx Preparatory: A College Board School - X221 - X149 - 07X221 - 360 EAST 145 STREET","bcbfa431-33f4-ea11-b882-24ee9a37d45c",-73920851,40813612,"J.H.S. 149 - BRONX","360 EAST 145 STREET"
1,1,0,"c0fc24e8-31f4-ea11-b882-24ee9a37d45c","I.S. 025 Adrien Block - Q025 - Q025 - 25Q025 - 34-65 192 STREET","befc24e8-31f4-ea11-b882-24ee9a37d45c",-73789365,40764884,"J.H.S. 25 - QUEENS","34-65 192 STREET"
3,2,1,"397eed06-32f4-ea11-b882-24ee9a37d45c","P.S. 100 Glen Morris - Q100 - Q100 - 27Q100 - 111-11 118 Street","267eed06-32f4-ea11-b882-24ee9a37d45c",-73821545,40679694,"P.S. 100 - QUEENS","111-11 118 Street"
3,3,0,"18a6ba98-31f4-ea11-b882-24ee9a37d45c","Success Academy Charter School - Union Square - M174 - M460 - 84M174 - 40 IRVING PLACE","16a6ba98-31f4-ea11-b882-24ee9a37d45c",-73987064,40735361,"WASHINGTON IRVING HS - MANHATTAN","40 IRVING PLACE"
12,9,3,"32416e00-31f4-ea11-b882-24ee9a37d45c","The Math & Science Exploratory School - K447 - K655 - 15K447 - 345 DEAN STREET","30416e00-31f4-ea11-b882-24ee9a37d45c",-73980266,40683951,"BKLYN HS OF THE ARTS (OL S J HL)-K","345 DEAN STREET"
1,1,0,"22d8cf12-31f4-ea11-b882-24ee9a37d45c","Success Academy Charter School - Bergen Beach - New York 4 - K781 - K864 - 84K781 - 3109 NEWKIRK AVENUE","23d8cf12-31f4-ea11-b882-24ee9a37d45c",-73947025,40640551,"P.S. 361  (OLD 89) - BROOKLYN","3109 NEWKIRK AVENUE"
1,1,0,"0322d292-30f4-ea11-b882-24ee9a37d45c","The Middle School of Media, Law and Fine Arts - K581 - K232 - 18K581 - 905 WINTHROP STREET","0222d292-30f4-ea11-b882-24ee9a37d45c",-73928744,40659088,"I.S. 232 - BROOKLYN","905 WINTHROP STREET"
1,1,0,"0baf0313-32f4-ea11-b882-24ee9a37d45c","P.S. 130 - Q130 - Q130 - 25Q130 - 200-01 42 AVENUE","04af0313-32f4-ea11-b882-24ee9a37d45c",-73784009,40760219,"P.S. 130 - QUEENS","200-01 42 AVENUE"
1,1,0,"580d6d19-33f4-ea11-b882-24ee9a37d45c","Leaders of Tomorrow - X370 - X113 - 11X370 - 3710 BARNES AVENUE","520d6d19-33f4-ea11-b882-24ee9a37d45c",-73860126,40880649,"I.S. 113 - BRONX","3710 BARNES AVENUE"
1,0,1,"400410ca-32f4-ea11-b882-24ee9a37d45c","P.S. 057 Hubert H. Humphrey - R057 - R057 - 31R057 - 140 PALMA DRIVE","410410ca-32f4-ea11-b882-24ee9a37d45c",-74083799,40611136,"P.S. 57 - STATEN ISLAND","140 PALMA DRIVE"
1,1,0,"762b3eee-30f4-ea11-b882-24ee9a37d45c","Academy for Conservation and the Environment - K637 - K515 - 18K637 - 6565 FLATLANDS AVENUE","6d2b3eee-30f4-ea11-b882-24ee9a37d45c",-73916927,40634451,"SOUTH SHORE EDUCATIONAL CAMPUS - K","6565 FLATLANDS AVENUE"
1,0,1,"ed207b48-4afb-ea11-b883-24ee9a37d459","Birch Family Services, Inc - MBBI - MADU -  - 554 FORT WASHINGTON AVENUE","ee207b48-4afb-ea11-b883-24ee9a37d459",-73936827,40853755,"HERBERT G. BIRCH ANNEX","554 FORT WASHINGTON AVENUE"
2,1,1,"722b3eee-30f4-ea11-b882-24ee9a37d45c","Victory Collegiate High School - K576 - K515 - 18K576 - 6565 FLATLANDS AVENUE","6d2b3eee-30f4-ea11-b882-24ee9a37d45c",-73916927,40634451,"SOUTH SHORE EDUCATIONAL CAMPUS - K","6565 FLATLANDS AVENUE"
1,0,1,"280d6d19-33f4-ea11-b882-24ee9a37d45c","P.S. 536 - X536 - X102 - 12X536 - 1827 ARCHER STREET","290d6d19-33f4-ea11-b882-24ee9a37d45c",-73866038,40838151,"P.S. 102 - BRONX","1827 ARCHER STREET"
1,1,0,"4f36d900-33f4-ea11-b882-24ee9a37d45c","P.S. 047 John Randolph - X047 - X047 - 12X047 - 1794 EAST 172 STREET","5036d900-33f4-ea11-b882-24ee9a37d45c",-73866974,40832529,"P.S. 47 - BRONX","1794 EAST 172 STREET"
1,1,0,"56275a30-4afb-ea11-b883-24ee9a37d459","BROOKLYN CHINESE AMERICAN ASSOCIATION - KBMM - KBMM -  - 812 54TH STREET","57275a30-4afb-ea11-b883-24ee9a37d459",-74005822,40638466,"BROOKLYN CHINESE AMERICAN ASSOCIATION","812 54TH STREET"
1,0,1,"21af0313-32f4-ea11-b882-24ee9a37d45c","M.S. 137 America's School of Heroes - Q137 - Q137 - 27Q137 - 109-15 98 STREET","22af0313-32f4-ea11-b882-24ee9a37d45c",-73839377,40678112,"M.S. 137 - QUEENS","109-15 98 STREET"
2,2,0,"abd810ab-31f4-ea11-b882-24ee9a37d45c","Stephen T. Mather Building Arts & Craftsmanship High School - M139 - M625 - 02M139 - 439 WEST 49TH STREET","a9d810ab-31f4-ea11-b882-24ee9a37d45c",-73990318,40763655,"HS OF GRAPHIC COMMUNICATION ARTS-M","439 WEST 49TH STREET"
4,3,1,"0a9c4c1f-32f4-ea11-b882-24ee9a37d45c","P.S. 165 Edith K. Bergtraum - Q165 - Q165 - 25Q165 - 70-35 150 Street","0b9c4c1f-32f4-ea11-b882-24ee9a37d45c",-73816966,40729746,"P.S. 165 - QUEENS","70-35 150 Street"
1,0,1,"cc92e6d5-30f4-ea11-b882-24ee9a37d45c","Brooklyn Lab School - K639 - K420 - 19K639 - 999 JAMAICA AVENUE","c692e6d5-30f4-ea11-b882-24ee9a37d45c",-73869305,40693002,"FRANKLIN K. LANE HS - K","999 JAMAICA AVENUE"
3,3,0,"9672c880-32f4-ea11-b882-24ee9a37d45c","High School for Construction Trades, Engineering and Architecture - Q650 - Q650 - 27Q650 - 94-06 104TH STREET","8f72c880-32f4-ea11-b882-24ee9a37d45c",-73841475,40689177,"HS FOR CONST.TRADES,ENGG.,& ARCH-Q","94-06 104TH STREET"
4,4,0,"8f977d2b-32f4-ea11-b882-24ee9a37d45c","P.S. 196 Grand Central Parkway - Q196 - Q196 - 28Q196 - 71-25 113 STREET","90977d2b-32f4-ea11-b882-24ee9a37d45c",-73837379,40722792,"P.S. 196 - QUEENS","71-25 113 STREET"
2,2,0,"c256635c-33f4-ea11-b882-24ee9a37d45c","Westchester Square Academy - X558 - X405 - 08X558 - 3000 EAST TREMONT AVENUE","b556635c-33f4-ea11-b882-24ee9a37d45c",-73839583,40839775,"HERBERT H. LEHMAN HS - X","3000 EAST TREMONT AVENUE"
1,1,0,"f0f57030-30f4-ea11-b882-24ee9a37d45c","J.H.S. 014 Shell Bank - K014 - K014 - 22K014 - 2424 BATCHELDER STREET","eef57030-30f4-ea11-b882-24ee9a37d45c",-73938107,40593232,"I.S. 14 - BROOKLYN","2424 BATCHELDER STREET"
2,2,0,"07ba8b86-30f4-ea11-b882-24ee9a37d45c","Explore Empower Charter School - K742 - K210 - 84K742 - 188 ROCHESTER AVENUE","08ba8b86-30f4-ea11-b882-24ee9a37d45c",-73928917,40672710,"I.S. 394 - BROOKLYN","188 ROCHESTER AVENUE"
1,1,0,"9d48b1f5-eaf6-ea11-b883-24ee9a37d459","P.S. K077 - K077 - K902 - 75K077 - 62 PARK PLACE","2604d718-31f4-ea11-b882-24ee9a37d45c",-73976648,40678809,"P.S. 77 ANNEX - BROOKLYN","62 PARK PLACE"
2,2,0,"2502926e-32f4-ea11-b882-24ee9a37d45c","Jamaica Gateway to the Sciences - Q350 - Q470 - 28Q350 - 167-01 GOTHIC DRIVE","1f02926e-32f4-ea11-b882-24ee9a37d45c",-73798658,40714551,"JAMAICA HS - Q","167-01 GOTHIC DRIVE"
2,1,1,"ebb98b86-30f4-ea11-b882-24ee9a37d45c","P.S. 194 Raoul Wallenberg - K194 - K194 - 22K194 - 3117 AVENUE W","ecb98b86-30f4-ea11-b882-24ee9a37d45c",-73934163,40598069,"P.S. 194 - BROOKLYN","3117 AVENUE W"
3,2,1,"492b3eee-30f4-ea11-b882-24ee9a37d45c","High School of Telecommunication Arts and Technology - K485 - K485 - 20K485 - 350 67 STREET","bf9c11e8-30f4-ea11-b882-24ee9a37d45c",-74023419,40636721,"TELECOM. ARTS & TECH. - K","350 67 STREET"
1,1,0,"0aba8b86-30f4-ea11-b882-24ee9a37d45c","P.S. 203 Floyd Bennett School - K203 - K203 - 22K203 - 5101 AVENUE M","0bba8b86-30f4-ea11-b882-24ee9a37d45c",-73925732,40622108,"P.S. 203 - BROOKLYN","5101 AVENUE M"
1,1,0,"6241e65b-31f4-ea11-b882-24ee9a37d45c","Yorkville Community School - M151 - M066 - 02M151 - 421 East  88 Street","6341e65b-31f4-ea11-b882-24ee9a37d45c",-73947287,40777948,"RICHARD R GREEN HS OF TEACHING - M","421 East  88 Street"
2,1,1,"568946f4-31f4-ea11-b882-24ee9a37d45c","P.S. 043 - Q043 - Q043 - 27Q043 - 160 BEACH  29 STREET","ee8442ee-31f4-ea11-b882-24ee9a37d45c",-73761086,40593480,"P.S. 43 - QUEENS","160 BEACH  29 STREET"
1,1,0,"29b7c337-32f4-ea11-b882-24ee9a37d45c","I.S. 227 Louis Armstrong - Q227 - Q227 - 30Q227 - 32-02 JUNCTION BOULEVARD","27b7c337-32f4-ea11-b882-24ee9a37d45c",-73874614,40757567,"I.S. 227 - QUEENS","32-02 JUNCTION BOULEVARD"
1,1,0,"09a198c3-30f4-ea11-b882-24ee9a37d45c","P.S. 327 Dr. Rose B. English - K327 - K327 - 23K327 - 111 BRISTOL STREET","08a198c3-30f4-ea11-b882-24ee9a37d45c",-73911788,40668232,"P.S. 327 (TANDEM K396-D75)-K","111 BRISTOL STREET"
2,0,2,"2803cefa-32f4-ea11-b882-24ee9a37d45c","P.S. 046 Edgar Allan Poe - X046 - X046 - 10X046 - 2760 BRIGGS AVENUE","2703cefa-32f4-ea11-b882-24ee9a37d45c",-73890402,40867169,"P.S. 46 - BRONX","279 EAST 196 STREET"
1,1,0,"179ebaee-32f4-ea11-b882-24ee9a37d45c","Milton Fein School - X007 - X007 - 10X007 - 3201 KINGSBRIDGE AVENUE","189ebaee-32f4-ea11-b882-24ee9a37d45c",-73905697,40881562,"P.S. 7 - BRONX","3201 KINGSBRIDGE AVENUE"
1,1,0,"3268ee1e-31f4-ea11-b882-24ee9a37d45c","School of Math, Science, and Healthy Living - K971 - K971 - 20K971 - 6214 4TH AVENUE","3368ee1e-31f4-ea11-b882-24ee9a37d45c",-74020343,40639518,"P.S. 971 - BROOKLYN","6214 4TH AVENUE"
1,1,0,"df883319-32f4-ea11-b882-24ee9a37d45c","P.S. 144 Col Jeromus Remsen - Q144 - Q144 - 28Q144 - 69-20 JUNO STREET","e0883319-32f4-ea11-b882-24ee9a37d45c",-73852398,40714890,"P.S. 144 - QUEENS","69-20 JUNO STREET"
3,2,1,"d7b66262-32f4-ea11-b882-24ee9a37d45c","William Cullen Bryant High School - Q445 - Q445 - 30Q445 - 48-10 31 AVENUE","d8b66262-32f4-ea11-b882-24ee9a37d45c",-73911165,40757072,"WILLIAM C. BRYANT HS - Q","48-10 31 AVENUE"
1,1,0,"f7d27c6d-30f4-ea11-b882-24ee9a37d45c","P.S. 153 Homecrest - K153 - K153 - 21K153 - 1970 HOMECREST AVENUE","f8d27c6d-30f4-ea11-b882-24ee9a37d45c",-73960027,40601179,"P.S. 153 - BROOKLYN","1970 HOMECREST AVENUE"
1,1,0,"bfba3c50-33f4-ea11-b882-24ee9a37d45c","P186X Walter J. Damrosch School - X186 - X306 - 75X186 - 40 WEST TREMONT AVENUE","c0ba3c50-33f4-ea11-b882-24ee9a37d45c",-73910827,40850722,"P.S. 306 - BRONX","40 WEST TREMONT AVENUE"
2,1,1,"35005d7a-31f4-ea11-b882-24ee9a37d45c","P.S. 166 The Richard Rodgers School of The Arts and Technology - M166 - M166 - 03M166 - 132 WEST  89 STREET","36005d7a-31f4-ea11-b882-24ee9a37d45c",-73972557,40788925,"P.S. 166 - MANHATTAN","132 WEST  89 STREET"
2,2,0,"66fdc1bd-32f4-ea11-b882-24ee9a37d45c","P.S. 21 Margaret Emery-Elm Park - R021 - R021 - 31R021 - 168 Hooker Place","67fdc1bd-32f4-ea11-b882-24ee9a37d45c",-74144599,40631165,"P.S. 21 - STATEN ISLAND","168 Hooker Place"
5,4,1,"c3e0838c-31f4-ea11-b882-24ee9a37d45c","P.S./I.S. 217 Roosevelt Island - M217 - M271 - 02M217 - 645 MAIN STREET","b8e0838c-31f4-ea11-b882-24ee9a37d45c",-73956435,40753598,"P.S./I.S. 217 - MANHATTAN","645 MAIN STREET"
2,2,0,"b0c10fab-32f4-ea11-b882-24ee9a37d45c","Academy of the City Charter School - Q359 - QARF - 84Q359 - 23-40 Astoria Boulevard","aec10fab-32f4-ea11-b882-24ee9a37d45c",-73923830,40770769,"Astoria Community Center","23-40 Astoria Boulevard"
1,1,0,"fbfa079f-32f4-ea11-b882-24ee9a37d45c","Academy of the City Charter School - Q359 - QABE - 84Q359 - 31-29 60 STREET","fcfa079f-32f4-ea11-b882-24ee9a37d45c",-73902197,40756181,"CORPUS CHRISTI SCHOOL","31-29 60 STREET"
1,1,0,"2e005d7a-31f4-ea11-b882-24ee9a37d45c","Mott Hall II - M862 - M165 - 03M862 - 234 West 109 Street","2f005d7a-31f4-ea11-b882-24ee9a37d45c",-73965949,40802653,"P.S. 165 - MANHATTAN","234 West 109 Street"
1,1,0,"210410ca-32f4-ea11-b882-24ee9a37d45c","P.S. 046 Albert V. Maniscalco - R046 - R046 - 31R046 - 41 REID AVENUE","220410ca-32f4-ea11-b882-24ee9a37d45c",-74080829,40594455,"P.S. 46 - STATEN ISLAND","41 REID AVENUE"
3,3,0,"810e6e25-32f4-ea11-b882-24ee9a37d45c","BELL Academy - Q294 - Q169 - 25Q294 - 18-25 212 STREET","820e6e25-32f4-ea11-b882-24ee9a37d45c",-73778430,40782331,"P.S. 169 - QUEENS","18-25 212 STREET"
2,2,0,"2a8dbfcf-30f4-ea11-b882-24ee9a37d45c","P.S. 109 - K109 - K395 - 22K109 - 1001 EAST  45 STREET","2fe2abc9-30f4-ea11-b882-24ee9a37d45c",-73933099,40635842,"P.S./I.S. 395 - BROOKLYN","1001 EAST  45 STREET"
1,1,0,"af0e6e25-32f4-ea11-b882-24ee9a37d45c","P.S. 184 Flushing Manor - Q184 - Q184 - 25Q184 - 163-15 21 ROAD","b00e6e25-32f4-ea11-b882-24ee9a37d45c",-73799158,40778334,"P.S. 184 - QUEENS","163-15 21 ROAD"
1,1,0,"130410ca-32f4-ea11-b882-24ee9a37d45c","CSI High School for International Studies - R047 - R043 - 31R047 - 100 ESSEX DRIVE","a0a9d9c3-32f4-ea11-b882-24ee9a37d45c",-74159343,40581958,"JEROME PARKER CAMPUS - S.I.","100 ESSEX DRIVE"
2,1,1,"8234aa92-31f4-ea11-b882-24ee9a37d45c","Humanities Preparatory Academy - M605 - M440 - 02M605 - 351 WEST  18 STREET","7834aa92-31f4-ea11-b882-24ee9a37d45c",-74002540,40743407,"BAYARD RUSTIN EDUCATIONAL COMP-M","351 WEST  18 STREET"
2,1,1,"635b4cd6-32f4-ea11-b882-24ee9a37d45c","Tottenville High School - R455 - R455 - 31R455 - 100 LUTEN AVENUE","605b4cd6-32f4-ea11-b882-24ee9a37d45c",-74193431,40528152,"TOTTENVILLE HS - S. I.","100 LUTEN AVENUE"
1,1,0,"c6e8ce00-32f4-ea11-b882-24ee9a37d45c","Redwood Middle School - Q332 - Q072 - 28Q332 - 133-25 GUY R BREWER BOULEVARD","852f77fa-31f4-ea11-b882-24ee9a37d45c",-73775643,40675014,"J.H.S. 72 - QUEENS","133-25 GUY R BREWER BOULEVARD"
1,1,0,"e5d10307-33f4-ea11-b882-24ee9a37d45c","P.S. 067 Mohegan School - X067 - X067 - 12X067 - 2024 MOHEGAN AVENUE","e6d10307-33f4-ea11-b882-24ee9a37d45c",-73884192,40843781,"P.S. 67 - BRONX","2024 MOHEGAN AVENUE"
2,2,0,"ffe1abc9-30f4-ea11-b882-24ee9a37d45c","I.S. 392 - K392 - K356 - 23K392 - 104 SUTTER AVENUE","35a198c3-30f4-ea11-b882-24ee9a37d45c",-73917880,40665553,"P.S. 156 - BROOKLYN","104 SUTTER AVENUE"
4,4,0,"5b5b4cd6-32f4-ea11-b882-24ee9a37d45c","Curtis High School - R450 - R450 - 31R450 - 105 HAMILTON AVENUE","5a5b4cd6-32f4-ea11-b882-24ee9a37d45c",-74082149,40645436,"CURTIS HS - S. I.","105 HAMILTON AVENUE"
1,1,0,"aabf14dd-ebf6-ea11-b883-24ee9a37d459","Pathways to Graduation - Q950 - R801 - 79Q950 - 450 ST MARKS PLACE","69be7adc-32f4-ea11-b882-24ee9a37d45c",-74077564,40638388,"AUX. SERV - ST. GEORGE SCHOOL-S.I.","450 ST MARKS PLACE"
1,0,1,"74f4a0ef-eaf6-ea11-b883-24ee9a37d459","P.S. 370 - K370 - K370 - 75K370 - 3000 WEST 1 STREET","0be2abc9-30f4-ea11-b882-24ee9a37d45c",-73969872,40577709,"P.S. 370 - BROOKLYN","3000 WEST 1 STREET"
2,2,0,"13ba8b86-30f4-ea11-b882-24ee9a37d45c","P.S. 206 Joseph F Lamb - K206 - K206 - 22K206 - 2200 GRAVESEND NECK ROAD","14ba8b86-30f4-ea11-b882-24ee9a37d45c",-73948453,40596876,"P.S. 206 - BROOKLYN","2200 GRAVESEND NECK ROAD"
1,1,0,"db77bb9f-33f4-ea11-b882-24ee9a37d45c","P.S. 067 Mohegan School - X067 - X967 - 12X067 - 2024 Mohegan Avenue","dc77bb9f-33f4-ea11-b882-24ee9a37d45c",-73884192,40843781,"P.S. 67 TRANSPORTABLE - X","2024 Mohegan Avenue"
1,1,0,"15a6ba98-31f4-ea11-b882-24ee9a37d45c","Gramercy Arts High School - M374 - M460 - 02M374 - 40 IRVING PLACE","16a6ba98-31f4-ea11-b882-24ee9a37d45c",-73987064,40735361,"WASHINGTON IRVING HS - MANHATTAN","40 IRVING PLACE"
1,1,0,"1a30f69f-ebf6-ea11-b883-24ee9a37d459","Robert E. Peary School - Q075 - Q223 - 75Q075 - 125-20 SUTPHIN BOULEVARD","09b7c337-32f4-ea11-b882-24ee9a37d45c",-73789530,40673898,"P.S. 223 - QUEENS","125-20 SUTPHIN BOULEVARD"
1,0,1,"26bef08c-32f4-ea11-b882-24ee9a37d45c","P.S. 199 Maurice A. Fitzgerald - Q199 - Q841 - 24Q199 - 48-25 37th Street","27bef08c-32f4-ea11-b882-24ee9a37d45c",-73928640,40739438,"P.S. 199 ANNEX - QUEENS","48-25 37th Street"
1,1,0,"53ffcc6e-33f4-ea11-b882-24ee9a37d45c","World View High School - X353 - X440 - 10X353 - 100 WEST MOSHOLU PARKWAY SOUTH","4cffcc6e-33f4-ea11-b882-24ee9a37d45c",-73889011,40879958,"DEWITT CLINTON HS - X","100 WEST MOSHOLU PARKWAY SOUTH"
2,0,2,"a672c880-32f4-ea11-b882-24ee9a37d45c","Queens Metropolitan High School - Q686 - Q686 - 28Q686 - 91-30 METROPOLITAN AVENUE","a372c880-32f4-ea11-b882-24ee9a37d45c",-73855543,40708431,"METROPOLITAN AVENUE CAMPUS - QUEENS","91-30 METROPOLITAN AVENUE"
2,2,0,"16ba8b86-30f4-ea11-b882-24ee9a37d45c","P.S. 207 Elizabeth G. Leary - K207 - K207 - 22K207 - 4011 FILLMORE AVENUE","17ba8b86-30f4-ea11-b882-24ee9a37d45c",-73930485,40613981,"P.S. 207 - BROOKLYN","4011 FILLMORE AVENUE"
1,1,0,"72977d2b-32f4-ea11-b882-24ee9a37d45c","Flushing International High School - Q263 - Q189 - 25Q263 - 144-80 BARCLAY AVENUE","6b977d2b-32f4-ea11-b882-24ee9a37d45c",-73818399,40759963,"J.H.S. 189 - QUEENS","144-80 BARCLAY AVENUE"
1,1,0,"5c2f77fa-31f4-ea11-b882-24ee9a37d45c","P.S. 060 Woodhaven - Q060 - Q060 - 27Q060 - 91-02 88 AVENUE","8e8946f4-31f4-ea11-b882-24ee9a37d45c",-73852792,40691467,"P.S. 60 - QUEENS","91-02 88 AVENUE"
1,0,1,"d6454b50-32f4-ea11-b882-24ee9a37d45c","The Children's Lab School - Q343 - Q313 - 24Q343 - 45-45 42ND STREET","d7454b50-32f4-ea11-b882-24ee9a37d45c",-73922604,40742580,"THE WALTER MCCAFFREY CAMPUS - QUEENS","45-45 42ND STREET"
2,2,0,"ec968d36-30f4-ea11-b882-24ee9a37d45c","P.S. 024 - K024 - K024 - 15K024 - 427 38 STREET","ed968d36-30f4-ea11-b882-24ee9a37d45c",-74004533,40652832,"P.S. 24 - BROOKLYN","427 38 STREET"
1,1,0,"39a6ba98-31f4-ea11-b882-24ee9a37d45c","Frank McCourt High School - M417 - M470 - 03M417 - 145 WEST  84 STREET","33a6ba98-31f4-ea11-b882-24ee9a37d45c",-73974483,40786134,"LOUIS D. BRANDEIS HS - MANHATTAN","145 WEST  84 STREET"
3,3,0,"0b06003e-32f4-ea11-b882-24ee9a37d45c","Community Voices Middle School - Q356 - Q231 - 29Q356 - 145-00 SPRINGFIELD BOULEVARD","0c06003e-32f4-ea11-b882-24ee9a37d45c",-73759396,40664809,"I.S. 231 (TANDEM Q251) - QUEENS","145-00 SPRINGFIELD BOULEVARD"
3,3,0,"dd968d36-30f4-ea11-b882-24ee9a37d45c","P.S. 021 Crispus Attucks - K021 - K021 - 16K021 - 180 CHAUNCEY STREET","dc968d36-30f4-ea11-b882-24ee9a37d45c",-73926673,40680350,"P.S. 21 - BROOKLYN","180 CHAUNCEY STREET"
3,3,0,"1c005d7a-31f4-ea11-b882-24ee9a37d45c","Yorkville East Middle School - M177 - M158 - 02M177 - 1458 YORK AVENUE","1d005d7a-31f4-ea11-b882-24ee9a37d45c",-73950745,40770215,"P.S. 158 - MANHATTAN","1458 YORK AVENUE"
1,1,0,"950e6e25-32f4-ea11-b882-24ee9a37d45c","P.S. 175 The Lynn Gross Discovery School - Q175 - Q175 - 28Q175 - 64-35 102 STREET","960e6e25-32f4-ea11-b882-24ee9a37d45c",-73852210,40731016,"P.S. 175 - QUEENS","64-35 102 STREET"
3,2,1,"9034aa92-31f4-ea11-b882-24ee9a37d45c","High School for Dual Language and Asian Studies - M545 - M445 - 02M545 - 350 GRAND STREET","8834aa92-31f4-ea11-b882-24ee9a37d45c",-73989329,40717329,"SEWARD PARK HS - MANHATTAN","350 GRAND STREET"
2,2,0,"2a7eed06-32f4-ea11-b882-24ee9a37d45c","P.S. 095 Eastwood - Q095 - Q095 - 29Q095 - 179-01 90 AVENUE","2b7eed06-32f4-ea11-b882-24ee9a37d45c",-73783283,40711295,"P.S. 95 - QUEENS","179-01 90 AVENUE"
1,0,1,"93a00518-4afb-ea11-b883-24ee9a37d459","CENTRAL QUEENS YM & YWHA - QAWH - QAWH -  - 67-09 108 STREET","94a00518-4afb-ea11-b883-24ee9a37d459",-73847081,40728714,"CENTRAL QUEENS YM & YWHA","67-09 108 STREET"
1,1,0,"e3d27c6d-30f4-ea11-b882-24ee9a37d45c","P.S. 149 Danny Kaye - K149 - K149 - 19K149 - 700 SUTTER AVENUE","e1d27c6d-30f4-ea11-b882-24ee9a37d45c",-73892760,40669361,"P.S. 149 - BROOKLYN","700 SUTTER AVENUE"
2,2,0,"858d8486-31f4-ea11-b882-24ee9a37d45c","P.S. 199 Jessie Isador Straus - M199 - M199 - 03M199 - 270 WEST  70 STREET","868d8486-31f4-ea11-b882-24ee9a37d45c",-73984423,40777603,"P.S. 199 - MANHATTAN","270 WEST  70 STREET"
10,5,5,"6ea5db98-30f4-ea11-b882-24ee9a37d45c","Andries Hudde - K240 - K240 - 22K240 - 2500 NOSTRAND AVENUE","69a5db98-30f4-ea11-b882-24ee9a37d45c",-73946836,40623788,"I.S. 240 - BROOKLYN","2500 NOSTRAND AVENUE"
1,0,1,"380d6d19-33f4-ea11-b882-24ee9a37d45c","P.S. 105 Sen Abraham Bernstein - X105 - X105 - 11X105 - 725 Brady Avenue","390d6d19-33f4-ea11-b882-24ee9a37d45c",-73866264,40853075,"P.S. 105 - BRONX","725 Brady Avenue"
5,3,2,"5a9f4974-31f4-ea11-b882-24ee9a37d45c","P.S. 152 Dyckman Valley - M152 - M152 - 06M152 - 93 NAGLE AVENUE","5b9f4974-31f4-ea11-b882-24ee9a37d45c",-73927578,40859804,"P.S. 152 - MANHATTAN","93 NAGLE AVENUE"
1,1,0,"9b3aa668-33f4-ea11-b882-24ee9a37d45c","Bronx Aerospace High School - X545 - X425 - 11X545 - 800 EAST GUN HILL ROAD","699d7c62-33f4-ea11-b882-24ee9a37d45c",-73861649,40875172,"EVANDER CHILDS HS - X","800 EAST GUN HILL ROAD"
2,2,0,"7b07e99e-31f4-ea11-b882-24ee9a37d45c","Urban Assembly School for Media Studies, The - M307 - M490 - 03M307 - 122 AMSTERDAM AVENUE","7c07e99e-31f4-ea11-b882-24ee9a37d45c",-73985608,40774891,"MARTIN LUTHER KING, JR. HS - M","122 AMSTERDAM AVENUE"
3,3,0,"23005d7a-31f4-ea11-b882-24ee9a37d45c","P.S. 161 Pedro Albizu Campos - M161 - M161 - 05M161 - 499 WEST 133 STREET","22005d7a-31f4-ea11-b882-24ee9a37d45c",-73952476,40817719,"P.S. 161 - MANHATTAN","499 WEST 133 STREET"
4,3,1,"df0d3c5b-30f4-ea11-b882-24ee9a37d45c","P.S. 105 The Blythebourne - K105 - K105 - 20K105 - 1031 59 STREET","e00d3c5b-30f4-ea11-b882-24ee9a37d45c",-74003635,40633320,"P.S. 105 - BROOKLYN","1031 59 STREET"
1,1,0,"48005d7a-31f4-ea11-b882-24ee9a37d45c","P.S. 175 Henry H Garnet - M175 - M175 - 05M175 - 175 WEST 134 STREET","47005d7a-31f4-ea11-b882-24ee9a37d45c",-73942706,40814388,"P.S. 175 - MANHATTAN","175 WEST 134 STREET"
1,1,0,"4c507380-31f4-ea11-b882-24ee9a37d45c","Professor Juan Bosch Public School - M178 - M178 - 06M178 - 12-18 ELLWOOD STREET","4d507380-31f4-ea11-b882-24ee9a37d45c",-73928301,40859240,"P.S. 178 - MANHATTAN","12-18 ELLWOOD STREET"
1,1,0,"02ee94c3-31f4-ea11-b882-24ee9a37d45c","Thurgood Marshall Academy for Learning and Social Change - M670 - M970 - 05M670 - 200-214 WEST 135TH STREET","03ee94c3-31f4-ea11-b882-24ee9a37d45c",-73944299,40815237,"THURGOOD MARSHALL ACAD. - M","200-214 WEST 135TH STREET"
1,1,0,"399ebaee-32f4-ea11-b882-24ee9a37d45c","P.S. 019 Judith K. Weiss - X019 - X019 - 11X019 - 318 Katonah Avenue","319ebaee-32f4-ea11-b882-24ee9a37d45c",-73866949,40899351,"P.S. 19 - BRONX","318 Katonah Avenue"
2,2,0,"7536d900-33f4-ea11-b882-24ee9a37d45c","P.S. 058 - X058 - X058 - 09X058 - 459 EAST 176 STREET","7636d900-33f4-ea11-b882-24ee9a37d45c",-73898826,40846383,"P.S. 58 - BRONX","459 EAST 176 STREET"
3,2,1,"2d0b210d-33f4-ea11-b882-24ee9a37d45c","P.S. 078 Anne Hutchinson - X078 - X078 - 11X078 - 1400 NEEDHAM AVENUE","2e0b210d-33f4-ea11-b882-24ee9a37d45c",-73850563,40878474,"P.S. 78 - BRONX","1400 NEEDHAM AVENUE"
3,1,2,"36b4977a-32f4-ea11-b882-24ee9a37d45c","Maspeth High School - Q585 - Q585 - 24Q585 - 54-40 74TH STREET","34b4977a-32f4-ea11-b882-24ee9a37d45c",-73887909,40729104,"MASPETH HIGH SCHOOL - QUEENS","54-40 74TH STREET"
1,0,1,"cb56635c-33f4-ea11-b882-24ee9a37d45c","DreamYard Preparatory School - X329 - X410 - 09X329 - 240 EAST 172 STREET","c856635c-33f4-ea11-b882-24ee9a37d45c",-73911366,40839307,"WILLIAM H. TAFT HS - X","240 EAST 172 STREET"
2,2,0,"40474313-33f4-ea11-b882-24ee9a37d45c","P.S. 097 Bronx - X097 - X097 - 11X097 - 1375 Mace Avenue","41474313-33f4-ea11-b882-24ee9a37d45c",-73846768,40863524,"P.S. 97 - BRONX","1375 Mace Avenue"
4,3,1,"4e767649-31f4-ea11-b882-24ee9a37d45c","P.S. 040 Augustus Saint-Gaudens - M040 - M040 - 02M040 - 320 EAST 20TH STREET","46767649-31f4-ea11-b882-24ee9a37d45c",-73981536,40735328,"P.S. 40 - MANHATTAN","320 EAST 20TH STREET"
1,1,0,"3a0410ca-32f4-ea11-b882-24ee9a37d45c","P.S. 055 Henry M. Boehm - R055 - R055 - 31R055 - 54 OSBORNE STREET","3b0410ca-32f4-ea11-b882-24ee9a37d45c",-74163037,40536625,"P.S. 55 - STATEN ISLAND","54 OSBORNE STREET"
2,2,0,"585bc58c-30f4-ea11-b882-24ee9a37d45c","P.S. 217 Colonel David Marcus School - K217 - K217 - 22K217 - 1100 NEWKIRK AVENUE","545bc58c-30f4-ea11-b882-24ee9a37d45c",-73966442,40633482,"P.S. 217 - BROOKLYN","1100 NEWKIRK AVENUE"
1,1,0,"440d6d19-33f4-ea11-b882-24ee9a37d45c","P.S. 108 Philip J. Abinanti - X108 - X108 - 11X108 - 1166 NEILL AVENUE","450d6d19-33f4-ea11-b882-24ee9a37d45c",-73853200,40854700,"P.S. 108 - BRONX","1166 NEILL AVENUE"
1,1,0,"953aa668-33f4-ea11-b882-24ee9a37d45c","High School of Computers and Technology - X275 - X425 - 11X275 - 800 EAST GUN HILL ROAD","699d7c62-33f4-ea11-b882-24ee9a37d45c",-73861649,40875172,"EVANDER CHILDS HS - X","800 EAST GUN HILL ROAD"
1,1,0,"469d7c62-33f4-ea11-b882-24ee9a37d45c","Collegiate Institute for Math and Science - X288 - X415 - 11X288 - 925 ASTOR AVENUE","439d7c62-33f4-ea11-b882-24ee9a37d45c",-73860729,40860443,"CHRISTOPHER COLUMBUS HS - X","925 ASTOR AVENUE"
1,0,1,"e2f57030-30f4-ea11-b882-24ee9a37d45c","Dr. Jacqueline Peek-Davis School - K012 - K012 - 17K012 - 430 HOWARD AVENUE","def57030-30f4-ea11-b882-24ee9a37d45c",-73920095,40673124,"P.S. 12 - BROOKLYN","430 HOWARD AVENUE"
1,1,0,"ed17b7f4-32f4-ea11-b882-24ee9a37d45c","P.S. 024 Spuyten Duyvil - X024 - X024 - 10X024 - 660 WEST 236 STREET","ee17b7f4-32f4-ea11-b882-24ee9a37d45c",-73915114,40886922,"P.S. 24 - BRONX","660 WEST 236 STREET"
1,1,0,"449f4974-31f4-ea11-b882-24ee9a37d45c","Future Leaders Institute Charter School - M861 - M144 - 84M861 - 134 WEST 122 STREET","459f4974-31f4-ea11-b882-24ee9a37d45c",-73948385,40806055,"P.S. 242 (OLD P144) - MANHATTAN","134 WEST 122 STREET"
1,1,0,"e0ba3c50-33f4-ea11-b882-24ee9a37d45c","The Matilda Avenue School - X483 - X314 - 11X483 - 4520 MATILDA AVENUE","dfba3c50-33f4-ea11-b882-24ee9a37d45c",-73854402,40901436,"P.S. 314 - BRONX","4520 MATILDA AVENUE"
1,1,0,"a32ff20c-32f4-ea11-b882-24ee9a37d45c","P.S. 101 School in the Gardens - Q101 - Q101 - 28Q101 - 2 RUSSELL PLACE","a42ff20c-32f4-ea11-b882-24ee9a37d45c",-73843400,40715543,"P.S. 101 - QUEENS","2 RUSSELL PLACE"
1,1,0,"4be61462-31f4-ea11-b882-24ee9a37d45c","M.S. 224 Manhattan East School for Arts & Academics - M224 - M099 - 04M224 - 410 EAST 100 STREET","3de61462-31f4-ea11-b882-24ee9a37d45c",-73942154,40785107,"I.S. 99 - MANHATTAN","410 EAST 100 STREET"
1,1,0,"fcb98b86-30f4-ea11-b882-24ee9a37d45c","P.S. 199 Frederick Wachtel - K199 - K199 - 21K199 - 1100 ELM AVENUE","fdb98b86-30f4-ea11-b882-24ee9a37d45c",-73963026,40616310,"P.S. 199 - BROOKLYN","1100 ELM AVENUE"
1,0,1,"62a5db98-30f4-ea11-b882-24ee9a37d45c","Brooklyn School of Inquiry - K686 - K237 - 20K686 - 50 AVENUE P","5fa5db98-30f4-ea11-b882-24ee9a37d45c",-73986678,40606994,"LUCRETIA MARCIGLIANO CAMPUS - K","50 AVENUE P"
1,1,0,"d39b4c1f-32f4-ea11-b882-24ee9a37d45c","P.S. 149 Christa McAuliffe - Q149 - Q149 - 30Q149 - 93-11 34 AVENUE","f3883319-32f4-ea11-b882-24ee9a37d45c",-73874505,40755759,"P.S. 149 - QUEENS","93-11 34 AVENUE"
2,2,0,"8f2aa42b-33f4-ea11-b882-24ee9a37d45c","Theatre Arts Production Company School - X225 - X137 - 10X225 - 2225 WEBSTER AVENUE","8e2aa42b-33f4-ea11-b882-24ee9a37d45c",-73897404,40854257,"I.S. 391 (UDC) - BRONX","2225 WEBSTER AVENUE"
1,1,0,"8f593c87-33f4-ea11-b882-24ee9a37d45c","P.S. 246 Poe Center - X246 - X843 - 10X246 - 2641 Grand Concourse","90593c87-33f4-ea11-b882-24ee9a37d45c",-73895300,40865972,"P.S. 246 (POE CENTER) - BRONX","2641 Grand Concourse"
2,0,2,"24e2abc9-30f4-ea11-b882-24ee9a37d45c","KIPP AMP Charter School - K357 - K390 - 84K357 - 1224 PARK PLACE","25e2abc9-30f4-ea11-b882-24ee9a37d45c",-73937601,40672290,"I.S. 390 - BROOKLYN","1224 PARK PLACE"
1,0,1,"2ee61462-31f4-ea11-b882-24ee9a37d45c","KIPP NYC Washington Heights Academy Charter School - M068 - M090 - 84M068 - 21 JUMEL PLACE","2ce61462-31f4-ea11-b882-24ee9a37d45c",-73935815,40839139,"I.S. 90 - MANHATTAN","21 JUMEL PLACE"
1,1,0,"0a4456d0-48fb-ea11-b883-24ee9a37d459","A2Z Kidz Center, LLC - KCKZ - KBQZ -  - 190 EXETER STREET","0b4456d0-48fb-ea11-b883-24ee9a37d459",-73948558,40577627,"HAPPYLAND MANHATTAN BEACH DAY SCHOOL","190 EXETER STREET"
1,0,1,"2dc73b4a-32f4-ea11-b882-24ee9a37d45c","I.S. 230 - Q230 - Q297 - 30Q230 - 33-55 74TH STREET","2ec73b4a-32f4-ea11-b882-24ee9a37d45c",-73892623,40753829,"I.S. 230 ANNEX - QUEENS","33-55 74TH STREET"
2,1,1,"7136d900-33f4-ea11-b882-24ee9a37d45c","P.S. 057 Crescent - X057 - X057 - 12X057 - 2111 CROTONA AVENUE","6c36d900-33f4-ea11-b882-24ee9a37d45c",-73888987,40848748,"P.S. 57 - BRONX","2111 CROTONA AVENUE"
1,1,0,"9f6b4ae9-ea40-ec11-b8c3-24ee9a37d45c","KIPP Bronx II Charter School - X616 - XCHO - 84X616 - 501 Gerard Avenue","a06b4ae9-ea40-ec11-b8c3-24ee9a37d45c",-73929502,40818347,"501 Gerard Avenue","501 Gerard Avenue"
1,0,1,"d78442ee-31f4-ea11-b882-24ee9a37d45c","P.S. 036 Saint Albans School - Q036 - Q036 - 29Q036 - 187-01 FOCH BOULEVARD","d88442ee-31f4-ea11-b882-24ee9a37d45c",-73764081,40691306,"P.S. 36 - QUEENS","187-01 FOCH BOULEVARD"
2,0,2,"35ff3d8d-33f4-ea11-b882-24ee9a37d45c","Luisa Pineiro Fuentes School of Science and Discovery - X307 - X886 - 10X307 - 124 EAMES PLACE","36ff3d8d-33f4-ea11-b882-24ee9a37d45c",-73901821,40869142,"P.S. 86 ANNEX - BRONX","124 EAMES PLACE"
1,1,0,"a948b1f5-eaf6-ea11-b883-24ee9a37d459","Success Academy Charter School - Harlem 1 - M351 - M149 - 84M351 - 34 West 118 Street","539f4974-31f4-ea11-b882-24ee9a37d45c",-73948088,40802649,"P.S. 149 (TANDEM M207) - MANHATTAN","34 West 118 Street"
1,1,0,"499f4974-31f4-ea11-b882-24ee9a37d45c","West Prep Academy - M421 - M145 - 03M421 - 150 West 105 Street","4a9f4974-31f4-ea11-b882-24ee9a37d45c",-73965611,40799098,"P.S. 145 - MANHATTAN","150 West 105 Street"
1,0,1,"a0dab801-ecf6-ea11-b883-24ee9a37d459","P.S. X721 - Stephen McSweeney School - X721 - X423 - 75X721 - 1551 EAST 172ND STREET","639d7c62-33f4-ea11-b882-24ee9a37d45c",-73878191,40832508,"JAMES MONROE HS CAMPUS ANNEX - BRONX","1551 EAST 172ND STREET"
2,1,1,"f01aad3c-30f4-ea11-b882-24ee9a37d45c","P.S. 031 Samuel F. Dupont - K031 - K031 - 14K031 - 75 MESEROLE AVENUE","f11aad3c-30f4-ea11-b882-24ee9a37d45c",-73954139,40726970,"P.S. 31 (OLD 126) - K","75 MESEROLE AVENUE"
3,2,1,"9f28a20c-31f4-ea11-b882-24ee9a37d45c","P.S. 163 Bath Beach - K163 - K807 - 20K163 - 109 BAY 14TH STREET","9b28a20c-31f4-ea11-b882-24ee9a37d45c",-74007469,40606739,"P.S./ I.S. 163 - BROOKLYN","109 BAY 14TH STREET"
1,1,0,"0922d292-30f4-ea11-b882-24ee9a37d45c","New American Academy Charter School - K736 - K233 - 84K736 - 9301 AVENUE B","0a22d292-30f4-ea11-b882-24ee9a37d45c",-73914282,40651642,"P.S. 233 - BROOKLYN","9301 AVENUE B"
1,1,0,"f717b7f4-32f4-ea11-b882-24ee9a37d45c","M.S. 390 - X390 - X026 - 10X390 - 1930 ANDREWS AVENUE","e917b7f4-32f4-ea11-b882-24ee9a37d45c",-73913016,40854335,"P.S. 396 - BRONX","1930 ANDREWS AVENUE"
1,1,0,"f5454b50-32f4-ea11-b882-24ee9a37d45c","P.S. 376 - Q376 - Q332 - 26Q376 - 210-21 48 AVENUE","f6454b50-32f4-ea11-b882-24ee9a37d45c",-73770314,40754954,"Bayside Hills School of Excellence","210-21 48 AVENUE"
2,2,0,"6741e65b-31f4-ea11-b882-24ee9a37d45c","N.Y.C. Museum School - M414 - M070 - 02M414 - 333 WEST  17 STREET","defab455-31f4-ea11-b882-24ee9a37d45c",-74002222,40742512,"I.S. 70 - MANHATTAN","333 WEST  17 STREET"
1,1,0,"f917b7f4-32f4-ea11-b882-24ee9a37d45c","P.S. 396 - X396 - X026 - 10X396 - 1930 ANDREWS AVENUE","e917b7f4-32f4-ea11-b882-24ee9a37d45c",-73913016,40854335,"P.S. 396 - BRONX","1930 ANDREWS AVENUE"
3,2,1,"a8d810ab-31f4-ea11-b882-24ee9a37d45c","Success Academy Charter School - Hell's Kitchen - M170 - M625 - 84M170 - 439 WEST 49TH STREET","a9d810ab-31f4-ea11-b882-24ee9a37d45c",-73990318,40763655,"HS OF GRAPHIC COMMUNICATION ARTS-M","439 WEST 49TH STREET"
1,1,0,"300b210d-33f4-ea11-b882-24ee9a37d45c","Elementary School for Math, Science, and Technology - X382 - X079 - 10X382 - 125 EAST 181 STREET","2c0b210d-33f4-ea11-b882-24ee9a37d45c",-73903139,40855337,"P.S. 79 - BRONX","125 EAST 181 STREET"
2,1,1,"0f6e3d68-31f4-ea11-b882-24ee9a37d45c","Success Academy Charter School - Harlem 4 - M386 - M113 - 84M386 - 240 WEST 113 STREET","086e3d68-31f4-ea11-b882-24ee9a37d45c",-73955583,40801573,"P.S. 241 - MANHATTAN","240 WEST 113 STREET"
2,1,1,"2c005d7a-31f4-ea11-b882-24ee9a37d45c","Community Math & Science Prep - M328 - M164 - 06M328 - 401 WEST 164 STREET","2a005d7a-31f4-ea11-b882-24ee9a37d45c",-73937263,40836982,"I.S. 164 - MANHATTAN","401 WEST 164 STREET"
2,2,0,"2f416e00-31f4-ea11-b882-24ee9a37d45c","Brooklyn High School of the Arts - K656 - K655 - 15K656 - 345 DEAN STREET","30416e00-31f4-ea11-b882-24ee9a37d45c",-73980266,40683951,"BKLYN HS OF THE ARTS (OL S J HL)-K","345 DEAN STREET"
1,1,0,"f1ce496e-31f4-ea11-b882-24ee9a37d45c","KIPP STAR College Prep Charter School - M726 - M125 - 84M726 - 433 WEST 123 STREET","edce496e-31f4-ea11-b882-24ee9a37d45c",-73955722,40810793,"P.S. 125 - MANHATTAN","425 WEST 123 STREET"
1,1,0,"52507380-31f4-ea11-b882-24ee9a37d45c","P.S. 183 Robert L. Stevenson - M183 - M183 - 02M183 - 419 East  66 Street","53507380-31f4-ea11-b882-24ee9a37d45c",-73957731,40763804,"P.S. 183 - MANHATTAN","419 East  66 Street"
1,1,0,"f92ece86-32f4-ea11-b882-24ee9a37d45c","Success Academy Charter School - South Jamaica - Q374 - Q781 - 84Q374 - 120-27 141st Street","fa2ece86-32f4-ea11-b882-24ee9a37d45c",-73799756,40675626,"John Adams HS Annex - Queens","120-27 141st Street"
1,1,0,"8a03194f-30f4-ea11-b882-24ee9a37d45c","Success Academy Charter School - Bergen Beach - New York 4 - K781 - K078 - 84K781 - 1420 EAST  68 STREET","8b03194f-30f4-ea11-b882-24ee9a37d45c",-73912914,40620537,"I.S. 78 - BROOKLYN","1420 EAST  68 STREET"
1,1,0,"0e06003e-32f4-ea11-b882-24ee9a37d45c","Collaborative Arts Middle School - Q355 - Q231 - 29Q355 - 145-00 SPRINGFIELD BOULEVARD","0c06003e-32f4-ea11-b882-24ee9a37d45c",-73759396,40664809,"I.S. 231 (TANDEM Q251) - QUEENS","145-00 SPRINGFIELD BOULEVARD"
6,5,1,"b9b66262-32f4-ea11-b882-24ee9a37d45c","John Bowne High School - Q425 - Q425 - 25Q425 - 63-25 MAIN STREET","bab66262-32f4-ea11-b882-24ee9a37d45c",-73823841,40737448,"JOHN BOWNE HS - QUEENS","63-25 MAIN STREET"
1,0,1,"a732c3fb-eaf6-ea11-b883-24ee9a37d459","P.S. Q177 - Q177 - Q177 - 75Q177 - 56-37 188 STREET","8b0e6e25-32f4-ea11-b882-24ee9a37d45c",-73787419,40743400,"P.S. 177 - QUEENS","56-37 188 STREET"
1,1,0,"dae0838c-31f4-ea11-b882-24ee9a37d45c","M.S. 297 - M297 - M323 - 02M297 - 75 MORTON STREET","d8e0838c-31f4-ea11-b882-24ee9a37d45c",-74007192,40731006,"75 Morton Campus","75 MORTON STREET"
2,1,1,"515bc58c-30f4-ea11-b882-24ee9a37d45c","P.S. 215 Morris H. Weiss - K215 - K215 - 21K215 - 415 AVENUE S","505bc58c-30f4-ea11-b882-24ee9a37d45c",-73970171,40602722,"P.S. 215 - BROOKLYN","415 AVENUE S"
2,1,1,"89886843-31f4-ea11-b882-24ee9a37d45c","P.S. 005 Ellen Lurie - M005 - M005 - 06M005 - 3703 TENTH AVENUE","8a886843-31f4-ea11-b882-24ee9a37d45c",-73922277,40857633,"P.S. 5 - MANHATTAN","3703 TENTH AVENUE"
1,1,0,"2102926e-32f4-ea11-b882-24ee9a37d45c","Queens Collegiate: A College Board School - Q310 - Q470 - 28Q310 - 167-01 GOTHIC DRIVE","1f02926e-32f4-ea11-b882-24ee9a37d45c",-73798658,40714551,"JAMAICA HS - Q","167-01 GOTHIC DRIVE"
1,1,0,"b028a20c-31f4-ea11-b882-24ee9a37d45c","Aspirations Diploma Plus High School - K646 - K824 - 17K646 - 402 EASTERN PARKWAY","ae28a20c-31f4-ea11-b882-24ee9a37d45c",-73955188,40669561,"W.E.B. DUBOIS HS - BROOKLYN","402 EASTERN PARKWAY"
2,1,1,"c481c5a7-dcfe-eb11-b8b2-24ee9a37d45c","LITTLE BELL CHILDCARE CORP. - KCNJ - KCNJ -  - 629 51st Street","c581c5a7-dcfe-eb11-b8b2-24ee9a37d45c",-74007922,40642765,"LITTLE BELL CHILDCARE CORP.","629 51st Street"
1,1,0,"c38442ee-31f4-ea11-b882-24ee9a37d45c","The Jermaine L. Green STEM Institute of Queens - Q354 - Q030 - 28Q354 - 126-10 BEDELL STREET","c48442ee-31f4-ea11-b882-24ee9a37d45c",-73774668,40679843,"P.S. 30 - QUEENS","126-10 BEDELL STREET"
1,1,0,"37a10a44-32f4-ea11-b882-24ee9a37d45c","P.S. Q256 - Q256 - Q253 - 75Q256 - 1307 CENTRAL AVENUE","30a10a44-32f4-ea11-b882-24ee9a37d45c",-73748799,40607247,"P.S. 253 -QUEENS","1307 CENTRAL AVENUE"
1,0,1,"804d9466-dcfe-eb11-b8b2-24ee9a37d45c","Our Children the Leaders of Tomorrow 1 - KBWT - KBUI -  - 756 Myrtle Avenue","814d9466-dcfe-eb11-b8b2-24ee9a37d45c",-73951966,40694818,"Our Children the Leaders of Tommorrow 1","756 Myrtle Avenue"
1,1,0,"980e6e25-32f4-ea11-b882-24ee9a37d45c","P.S. 176 Cambria Heights - Q176 - Q176 - 29Q176 - 120-45 235 Street","990e6e25-32f4-ea11-b882-24ee9a37d45c",-73729226,40684987,"P.S. 176 - QUEENS","120-45 235 Street"
1,0,1,"4dfdc1bd-32f4-ea11-b882-24ee9a37d45c","P.S. 11 Thomas Dongan School - R011 - R011 - 31R011 - 51 Jefferson Street","4efdc1bd-32f4-ea11-b882-24ee9a37d45c",-74098252,40590887,"P.S. 11 - STATEN ISLAND","51 Jefferson Street"
1,1,0,"6c41e65b-31f4-ea11-b882-24ee9a37d45c","The Lexington Academy - M072 - M072 - 04M072 - 131 EAST 104 STREET","6d41e65b-31f4-ea11-b882-24ee9a37d45c",-73947450,40791444,"P.S. 72 - MANHATTAN","131 EAST 104 STREET"
1,1,0,"94a9d9c3-32f4-ea11-b882-24ee9a37d45c","P.S. 038 George Cromwell - R038 - R038 - 31R038 - 421 LINCOLN AVENUE","92a9d9c3-32f4-ea11-b882-24ee9a37d45c",-74099409,40574799,"P.S. 38 - STATEN ISLAND","421 LINCOLN AVENUE"
1,0,1,"62275a30-4afb-ea11-b883-24ee9a37d459","BCA Bay Ridge DCC - KBUJ - KBTX -  - 4202 EIGHTH AVENUE","63275a30-4afb-ea11-b883-24ee9a37d459",-73999155,40645521,"BCA Bay Ridge DCC","4202 EIGHTH AVENUE"
2,2,0,"100410ca-32f4-ea11-b882-24ee9a37d45c","P.S. 042 Eltingville - R042 - R042 - 31R042 - 380 GENESEE AVENUE","110410ca-32f4-ea11-b882-24ee9a37d45c",-74169038,40552213,"P.S. 42 - STATEN ISLAND","380 GENESEE AVENUE"
2,0,2,"e2e0a4fb-ebf6-ea11-b883-24ee9a37d459","P.S. X010 - X010 - X240 - 75X010 - 1501 JEROME AVENUE","baba3c50-33f4-ea11-b882-24ee9a37d45c",-73916084,40842503,"DOE NEW SETTLEMENT COMMUNITY CAMPUS - X","1501 JEROME AVENUE"
4,3,1,"e38521d0-32f4-ea11-b882-24ee9a37d45c","I.S. 072 Rocco Laurie - R072 - R072 - 31R072 - 33 FERNDALE AVENUE","e48521d0-32f4-ea11-b882-24ee9a37d45c",-74158618,40592132,"I.S. 72 - STATEN ISLAND","33 FERNDALE AVENUE"
1,1,0,"31005d7a-31f4-ea11-b882-24ee9a37d45c","P.S. 165 Robert E. Simon - M165 - M165 - 03M165 - 234 West 109 Street","2f005d7a-31f4-ea11-b882-24ee9a37d45c",-73965949,40802653,"P.S. 165 - MANHATTAN","234 West 109 Street"
1,1,0,"22e2abc9-30f4-ea11-b882-24ee9a37d45c","P.S. /I.S. 384 Frances E. Carter - K384 - K384 - 32K384 - 242 COOPER STREET","21e2abc9-30f4-ea11-b882-24ee9a37d45c",-73904695,40689883,"P.S. 384 - BROOKLYN","242 COOPER STREET"
1,0,1,"7d36d900-33f4-ea11-b882-24ee9a37d45c","E.S.M.T- I.S. 190 - X190 - X061 - 12X190 - 1550 CROTONA PARK EAST","7e36d900-33f4-ea11-b882-24ee9a37d45c",-73892784,40836156,"P.S. 61 - BRONX","1550 CROTONA PARK EAST"
1,1,0,"4d3cbf01-ebf6-ea11-b883-24ee9a37d459","P.S. R373 - R373 - R040 - 75R373 - 91 HENDERSON AVENUE","97a9d9c3-32f4-ea11-b882-24ee9a37d45c",-74095454,40641180,"P.S. 373 (OLD P40) - STATEN ISLAND","91 HENDERSON AVENUE"
2,0,2,"cbfab455-31f4-ea11-b882-24ee9a37d45c","The Children's Workshop School - M361 - M061 - 01M361 - 610 EAST  12 STREET","c8fab455-31f4-ea11-b882-24ee9a37d45c",-73978254,40727537,"P.S. 61 - MANHATTAN","610 EAST  12 STREET"
1,1,0,"ea09e2e1-30f4-ea11-b882-24ee9a37d45c","PROGRESS High School for Professional Careers - K474 - K450 - 14K474 - 850 GRAND STREET","e909e2e1-30f4-ea11-b882-24ee9a37d45c",-73938921,40711134,"GRAND STREET CAMPUS (OLD E.D.HS)- K","850 GRAND STREET"
1,1,0,"15f32ce2-31f4-ea11-b882-24ee9a37d45c","P.S. 018 Winchester - Q018 - Q018 - 26Q018 - 86-35 235 COURT","16f32ce2-31f4-ea11-b882-24ee9a37d45c",-73732290,40731853,"P.S. 18 - QUEENS","86-35 235 COURT"
1,1,0,"a7886843-31f4-ea11-b882-24ee9a37d45c","P.S. 015 Roberto Clemente - M015 - M015 - 01M015 - 333 EAST  4 STREET","a5886843-31f4-ea11-b882-24ee9a37d45c",-73978747,40722075,"P.S. 15 - MANHATTAN","333 EAST  4 STREET"
1,0,1,"41de261e-4afb-ea11-b883-24ee9a37d459","NEW LIFE DAYCARE CENTER- SITE 2 - KBSC - KBSC -  - 406-408 GROVE STREET","42de261e-4afb-ea11-b883-24ee9a37d459",-73912224,40701464,"New Life Child Development Center 2-3","406-408 GROVE STREET"
2,2,0,"ffbdf08c-32f4-ea11-b882-24ee9a37d45c","Baccalaureate School for Global Education - Q580 - Q798 - 30Q580 - 34-12 36 AVENUE","00bef08c-32f4-ea11-b882-24ee9a37d45c",-73926977,40754975,"BACCALAUREATE SCL FOR GLOBAL ED-Q","34-12 36 AVENUE"
6,2,4,"a40e6e25-32f4-ea11-b882-24ee9a37d45c","Scholars' Academy - Q323 - Q180 - 27Q323 - 320 BEACH 104TH STREET","a50e6e25-32f4-ea11-b882-24ee9a37d45c",-73825162,40584543,"I.S. 323 (OLD IS 180) - QUEENS","320 BEACH 104TH STREET"
2,2,0,"1fb7c337-32f4-ea11-b882-24ee9a37d45c","J.H.S. 226 Virgil I. Grissom - Q226 - Q226 - 27Q226 - 121-10 ROCKAWAY BOULEVARD","1eb7c337-32f4-ea11-b882-24ee9a37d45c",-73816730,40675021,"I.S. 226 - QUEENS","121-10 ROCKAWAY BOULEVARD"
1,1,0,"bc689025-33f4-ea11-b882-24ee9a37d45c","Linden Tree Elementary School - X567 - X127 - 11X567 - 1560 PURDY STREET","b9689025-33f4-ea11-b882-24ee9a37d45c",-73853203,40838759,"I.S. 127 - BRONX","1560 PURDY STREET"
2,2,0,"8c72c880-32f4-ea11-b882-24ee9a37d45c","Thomas A. Edison Career and Technical Education High School - Q620 - Q620 - 28Q620 - 165-65 84 AVENUE","49b4977a-32f4-ea11-b882-24ee9a37d45c",-73799692,40716071,"THOMAS A. EDISON VOC HS - Q","165-65 84 AVENUE"
1,1,0,"039c4c1f-32f4-ea11-b882-24ee9a37d45c","P.S. 163 Flushing Heights - Q163 - Q163 - 25Q163 - 159-01 59 AVENUE","049c4c1f-32f4-ea11-b882-24ee9a37d45c",-73808765,40741107,"P.S. 163 - QUEENS","159-01 59 AVENUE"
1,1,0,"bc315367-30f4-ea11-b882-24ee9a37d45c","P.S. 121 Nelson A. Rockefeller - K121 - K121 - 21K121 - 5301 20 AVENUE","bd315367-30f4-ea11-b882-24ee9a37d45c",-73978472,40622671,"P.S. 121 - BROOKLYN","5301 20 AVENUE"
1,0,1,"3cceb75a-4afb-ea11-b883-24ee9a37d459","Books and Rattles Inc. Site 1 - QALW - QALW -  - 75 02 51ST AVENUE","3dceb75a-4afb-ea11-b883-24ee9a37d459",-73888167,40736282,"BOOKS AND RATTLES, INC. SITE 1","75 02 51ST AVENUE"
1,1,0,"7f283fb1-30f4-ea11-b882-24ee9a37d45c","P.S. 290 Juan Morel Campos - K290 - K290 - 19K290 - 135 Schenck Avenue","7e283fb1-30f4-ea11-b882-24ee9a37d45c",-73889375,40678182,"P.S. 290 - BROOKLYN","135 Schenck Avenue"
2,2,0,"eb80b5c9-df1e-eb11-b885-24ee9a37d45c","Sunset School of Cultural Learning - K939 - K746 - 20K939 - 270 59th Street","e980b5c9-df1e-eb11-b885-24ee9a37d45c",-74020748,40642914,"P.S. @ 270 59TH STREET- BROOKLYN","270 59th Street"
1,0,1,"7836d900-33f4-ea11-b882-24ee9a37d45c","P.S. 059 The Community School of Technology - X059 - X059 - 10X059 - 2185 BATHGATE AVENUE","7936d900-33f4-ea11-b882-24ee9a37d45c",-73893639,40853141,"P.S. 59 - BRONX","2185 BATHGATE AVENUE"
3,2,1,"ba69c231-32f4-ea11-b882-24ee9a37d45c","J.H.S. 210 Elizabeth Blackwell - Q210 - Q210 - 27Q210 - 93-11 101 AVENUE","bb69c231-32f4-ea11-b882-24ee9a37d45c",-73847633,40684760,"I.S. 210 - QUEENS","93-11 101 AVENUE"
3,3,0,"b148b1f5-eaf6-ea11-b883-24ee9a37d459","P.S. 149 Sojourner Truth - M149 - M207 - 03M149 - 41 West 117 Street","8b8d8486-31f4-ea11-b882-24ee9a37d45c",-73948088,40802649,"P.S. 207 (TANDEM M149)","41 West 117 Street"
1,1,0,"b49c11e8-30f4-ea11-b882-24ee9a37d45c","The Brooklyn School for Math and Research - K168 - K480 - 32K168 - 400 IRVING AVENUE","b39c11e8-30f4-ea11-b882-24ee9a37d45c",-73911751,40696457,"BUSHWICK EDUCATIONAL CAMPUS - K","400 IRVING AVENUE"
2,2,0,"5de61462-31f4-ea11-b882-24ee9a37d45c","J.H.S. 104 Simon Baruch - M104 - M104 - 02M104 - 330 EAST  21 STREET","5ee61462-31f4-ea11-b882-24ee9a37d45c",-73981034,40735879,"I.S. 104 - MANHATTAN","330 EAST  21 STREET"
1,0,1,"38e61462-31f4-ea11-b882-24ee9a37d45c","P.S. 092 Mary McLeod Bethune - M092 - M092 - 05M092 - 222 WEST 134 STREET","36e61462-31f4-ea11-b882-24ee9a37d45c",-73945838,40814917,"P.S. 92 - MANHATTAN","222 WEST 134 STREET"
1,1,0,"56767649-31f4-ea11-b882-24ee9a37d45c","P.S. 042 Benjamin Altman - M042 - M042 - 02M042 - 71 HESTER STREET","51767649-31f4-ea11-b882-24ee9a37d45c",-73990826,40716126,"P.S. 42 - MANHATTAN","71 HESTER STREET"
2,0,2,"f6f57030-30f4-ea11-b882-24ee9a37d45c","P.S. 015 Patrick F. Daly - K015 - K015 - 15K015 - 71 SULLIVAN STREET","f5f57030-30f4-ea11-b882-24ee9a37d45c",-74011864,40677085,"P.S. 15 - BROOKLYN","71 SULLIVAN STREET"
1,1,0,"d6968d36-30f4-ea11-b882-24ee9a37d45c","Brooklyn Arbor Elementary School - K414 - K019 - 14K414 - 325 SOUTH  3 STREET","d7968d36-30f4-ea11-b882-24ee9a37d45c",-73954678,40710107,"P.S. 19 - BROOKLYN","325 SOUTH  3 STREET"
2,1,1,"bbbfa431-33f4-ea11-b882-24ee9a37d45c","The Laboratory School of Finance and Technology: X223 - X223 - X149 - 07X223 - 360 EAST 145 STREET","bcbfa431-33f4-ea11-b882-24ee9a37d45c",-73920851,40813612,"J.H.S. 149 - BRONX","360 EAST 145 STREET"
1,1,0,"e83159fa-30f4-ea11-b882-24ee9a37d45c","Clara Barton High School - K600 - K600 - 17K600 - 901 CLASSON AVENUE","e13159fa-30f4-ea11-b882-24ee9a37d45c",-73960689,40669805,"CLARA BARTON HS - K","901 CLASSON AVENUE"
1,0,1,"e7968d36-30f4-ea11-b882-24ee9a37d45c","P.S. 023 Carter G. Woodson - K023 - K023 - 14K023 - 545 WILLOUGHBY AVENUE","e5968d36-30f4-ea11-b882-24ee9a37d45c",-73947256,40694470,"P.S. 23 - BROOKLYN","545 WILLOUGHBY AVENUE"
2,2,0,"d22ff20c-32f4-ea11-b882-24ee9a37d45c","P.S. 117 J. Keld / Briarwood School - Q117 - Q117 - 28Q117 - 85-15 143 STREET","d32ff20c-32f4-ea11-b882-24ee9a37d45c",-73812968,40710428,"P.S. 117 - QUEENS","85-15 143 STREET"
1,0,1,"b1eb5090-85ef-eb11-b8b1-24ee9a37d45c","P.S. X010 - X010 - X067 - 75X010 - 2024 MOHEGAN AVENUE","e6d10307-33f4-ea11-b882-24ee9a37d45c",-73884192,40843781,"P.S. 67 - BRONX","2024 MOHEGAN AVENUE"
1,0,1,"1503cefa-32f4-ea11-b882-24ee9a37d45c","P.S. 042 Claremont - X042 - X042 - 09X042 - 1537 WASHINGTON AVENUE","1103cefa-32f4-ea11-b882-24ee9a37d45c",-73903243,40838636,"P.S. 42 - BRONX","1537 WASHINGTON AVENUE"
1,0,1,"d0ed94c3-31f4-ea11-b882-24ee9a37d45c","Leadership and Public Service High School - M425 - M894 - 02M425 - 90 TRINITY PLACE","d1ed94c3-31f4-ea11-b882-24ee9a37d45c",-74012465,40708971,"HS FOR LEADERSHIP & PUBLIC SER - M","90 TRINITY PLACE"
1,1,0,"b5b36d80-30f4-ea11-b882-24ee9a37d45c","P.S. 179 Kensington - K179 - K179 - 20K179 - 202 AVENUE C","13d1de79-30f4-ea11-b882-24ee9a37d45c",-73977260,40640127,"P.S. 179 - BROOKLYN","202 AVENUE C"
1,1,0,"db2ff20c-32f4-ea11-b882-24ee9a37d45c","P.S. 120 Queens - Q120 - Q120 - 25Q120 - 58-01 136 STREET","dc2ff20c-32f4-ea11-b882-24ee9a37d45c",-73828674,40745215,"P.S. 120 - QUEENS","58-01 136 STREET"
4,4,0,"8f0e6e25-32f4-ea11-b882-24ee9a37d45c","P.S. 173 Fresh Meadows - Q173 - Q173 - 26Q173 - 174-10 67 AVENUE","900e6e25-32f4-ea11-b882-24ee9a37d45c",-73795651,40734097,"P.S. 173 - QUEENS","174-10 67 AVENUE"
1,0,1,"de2ff20c-32f4-ea11-b882-24ee9a37d45c","P.S. 121 Queens - Q121 - Q121 - 28Q121 - 126-10 109 AVENUE","df2ff20c-32f4-ea11-b882-24ee9a37d45c",-73815330,40683585,"P.S. 121 - QUEENS","126-10 109 AVENUE"
3,2,1,"c8bfa431-33f4-ea11-b882-24ee9a37d45c","KIPP Academy Charter School - X704 - X151 - 84X704 - 250 EAST 156 STREET","c1bfa431-33f4-ea11-b882-24ee9a37d45c",-73921140,40822574,"I.S. 151 - BRONX","250 EAST 156 STREET"
2,0,2,"64f4a0ef-eaf6-ea11-b883-24ee9a37d459","P.S. K004 - K004 - K273 - 75K004 - 923 JEROME STREET","cb201dab-30f4-ea11-b882-24ee9a37d45c",-73879276,40658500,"P.S. 273 - BROOKLYN","923 JEROME STREET"
5,1,4,"862aa42b-33f4-ea11-b882-24ee9a37d45c","Bronx Park Middle School - X556 - X135 - 11X556 - 2441 WALLACE AVENUE","d4689025-33f4-ea11-b882-24ee9a37d45c",-73865028,40862098,"I.S. 135 - BRONX","2441 WALLACE AVENUE"
4,3,1,"85e03d56-33f4-ea11-b882-24ee9a37d45c","Bronx International High School - X403 - X400 - 09X403 - 1110 BOSTON ROAD","82e03d56-33f4-ea11-b882-24ee9a37d45c",-73903920,40827455,"MORRIS HS - X","1110 BOSTON ROAD"
1,1,0,"2baf0313-32f4-ea11-b882-24ee9a37d45c","P.S. 139 Rego Park - Q139 - Q139 - 28Q139 - 93-06 63 DRIVE","29af0313-32f4-ea11-b882-24ee9a37d45c",-73862561,40728012,"P.S. 139 - QUEENS","93-06 63 DRIVE"
1,1,0,"03b7c337-32f4-ea11-b882-24ee9a37d45c","J.H.S. 216 George J. Ryan - Q216 - Q216 - 26Q216 - 64-20 175 Street","04b7c337-32f4-ea11-b882-24ee9a37d45c",-73794501,40737188,"J.H.S. 216 - QUEENS","64-20 175 Street"
1,1,0,"0bcf496e-31f4-ea11-b882-24ee9a37d45c","M.S. 131 - M131 - M131 - 02M131 - 100 HESTER STREET","03cf496e-31f4-ea11-b882-24ee9a37d45c",-73993607,40716231,"I.S. 131 - MANHATTAN","100 HESTER STREET"
1,1,0,"cc0d3c5b-30f4-ea11-b882-24ee9a37d45c","P.S. 97 The Highlawn - K097 - K097 - 21K097 - 1855 Stillwell Avenue","cd0d3c5b-30f4-ea11-b882-24ee9a37d45c",-73985570,40601191,"P.S. 97 - BROOKLYN","1855 Stillwell Avenue"
2,2,0,"1a9ebaee-32f4-ea11-b882-24ee9a37d45c","P.S. 008 Isaac Varian - X008 - X008 - 10X008 - 3010 BRIGGS AVENUE","1b9ebaee-32f4-ea11-b882-24ee9a37d45c",-73883339,40872259,"P.S. 8 - BRONX","3010 BRIGGS AVENUE"
1,1,0,"782f77fa-31f4-ea11-b882-24ee9a37d45c","P.S. 069 Jackson Heights - Q069 - Q069 - 30Q069 - 77-02 37 AVENUE","682f77fa-31f4-ea11-b882-24ee9a37d45c",-73888457,40748804,"P.S. 69 - QUEENS","77-02 37 AVENUE"
1,1,0,"f6d10307-33f4-ea11-b882-24ee9a37d45c","P.S. 072 Dr. William Dorney - X072 - X072 - 08X072 - 2951 DEWEY AVENUE","f4d10307-33f4-ea11-b882-24ee9a37d45c",-73818172,40823237,"P.S. 72 - BRONX","2951 DEWEY AVENUE"
1,1,0,"8783ff9e-30f4-ea11-b882-24ee9a37d45c","Success Academy Charter School - Crown Heights - K741 - K246 - 84K741 - 72 VERONICA PLACE","8483ff9e-30f4-ea11-b882-24ee9a37d45c",-73953480,40648352,"I.S. 246 - BROOKLYN","72 VERONICA PLACE"
2,2,0,"df11f898-32f4-ea11-b882-24ee9a37d45c","P.S. 360 - Q360 - Q892 - 29Q360 - 199-10 112 AVENUE","e011f898-32f4-ea11-b882-24ee9a37d45c",-73756259,40702329,"P.S. 892 - QUEENS","199-10 112 AVENUE"
2,2,0,"337eed06-32f4-ea11-b882-24ee9a37d45c","P.S. 098 The Douglaston School - Q098 - Q098 - 26Q098 - 40-20 235 STREET","347eed06-32f4-ea11-b882-24ee9a37d45c",-73749998,40768906,"P.S. 98 - QUEENS","40-20 235 STREET"
1,0,1,"6934aa92-31f4-ea11-b882-24ee9a37d45c","Success Academy Charter School - Washington Heights - New York 1 - M265 - M387 - 84M265 - 701 Fort Washington Avenue","6a34aa92-31f4-ea11-b882-24ee9a37d45c",-73935231,40857650,"Success Academy - Washington Heights","701 Fort Washington Avenue"
1,0,1,"f61aad3c-30f4-ea11-b882-24ee9a37d45c","Success Academy Charter School - Bed-Stuy 1 - K367 - K033 - 84K367 - 70 Tompkins Avenue","eb1aad3c-30f4-ea11-b882-24ee9a37d45c",-73947557,40696698,"I.S. 33 - BROOKLYN","70 Tompkins Avenue"
1,1,0,"6f41e65b-31f4-ea11-b882-24ee9a37d45c","P.S. 075 Emily Dickinson - M075 - M075 - 03M075 - 735 WEST END AVENUE","6a41e65b-31f4-ea11-b882-24ee9a37d45c",-73973996,40795109,"P.S. 75 - MANHATTAN","735 WEST END AVENUE"
1,1,0,"c2fc24e8-31f4-ea11-b882-24ee9a37d45c","World Journalism Preparatory: A College Board School - Q285 - Q025 - 25Q285 - 34-65 192 STREET","befc24e8-31f4-ea11-b882-24ee9a37d45c",-73789365,40764884,"J.H.S. 25 - QUEENS","34-65 192 STREET"
2,0,2,"8036d900-33f4-ea11-b882-24ee9a37d45c","P.S. 061 Francisco Oller - X061 - X061 - 12X061 - 1550 CROTONA PARK EAST","7e36d900-33f4-ea11-b882-24ee9a37d45c",-73892784,40836156,"P.S. 61 - BRONX","1550 CROTONA PARK EAST"
2,2,0,"d78a0044-33f4-ea11-b882-24ee9a37d45c","Archimedes Academy for Math, Science and Technology Applications - X367 - X174 - 08X367 - 456 WHITE PLAINS ROAD","2a2ed53d-33f4-ea11-b882-24ee9a37d45c",-73856070,40815043,"I.S. 174 - BRONX","456 WHITE PLAINS ROAD"
1,1,0,"df8521d0-32f4-ea11-b882-24ee9a37d45c","P.S. 048 William G. Wilcox - R048 - R071 - 31R048 - 1050 Targee Street","db8521d0-32f4-ea11-b882-24ee9a37d45c",-74091239,40603492,"P.S./I.S. 48 - Staten Island","1050 Targee Street"
1,0,1,"0d6e3d68-31f4-ea11-b882-24ee9a37d45c","STEM Institute of Manhattan - M241 - M113 - 03M241 - 240 WEST 113 STREET","086e3d68-31f4-ea11-b882-24ee9a37d45c",-73955583,40801573,"P.S. 241 - MANHATTAN","240 WEST 113 STREET"
1,1,0,"a169c231-32f4-ea11-b882-24ee9a37d45c","I.S. 204 Oliver W. Holmes - Q204 - Q204 - 30Q204 - 36-41 28 STREET","9c69c231-32f4-ea11-b882-24ee9a37d45c",-73932628,40756471,"I.S. 204 - QUEENS","36-41 28 STREET"
2,2,0,"af48b1f5-eaf6-ea11-b883-24ee9a37d459","Democracy Prep Charter School - M350 - M197 - 84M350 - 2230 5 AVENUE","7b8d8486-31f4-ea11-b882-24ee9a37d45c",-73938347,40813532,"P.S. 197 - MANHATTAN","2230 5 AVENUE"
1,1,0,"79886843-31f4-ea11-b882-24ee9a37d45c","P.S. 001 Alfred E. Smith - M001 - M001 - 02M001 - 8 HENRY STREET","7a886843-31f4-ea11-b882-24ee9a37d45c",-73997478,40712550,"P.S. 1 - MANHATTAN","8 HENRY STREET"
1,0,1,"f2fb3df4-30f4-ea11-b882-24ee9a37d45c","Brooklyn Community High School for Excellence and Equity - K566 - K516 - 18K566 - 6565 FLATLANDS AVENUE","f3fb3df4-30f4-ea11-b882-24ee9a37d45c",-73916927,40634451,"SOUTH SHORE AF - BROOKLYN","6565 FLATLANDS AVENUE"
1,1,0,"2e9ebaee-32f4-ea11-b882-24ee9a37d45c","P.S. 291 - X291 - X015 - 10X291 - 2195 ANDREWS AVENUE","219ebaee-32f4-ea11-b882-24ee9a37d45c",-73909763,40859243,"P.S. 15 - BRONX","2195 ANDREWS AVENUE"
1,1,0,"982aa42b-33f4-ea11-b882-24ee9a37d45c","P.S./I.S. 224 - X224 - X139 - 07X224 - 345 BROOK AVENUE","942aa42b-33f4-ea11-b882-24ee9a37d45c",-73918774,40810314,"J.H.S. 222 - BRONX","345 BROOK AVENUE"
1,0,1,"107eed06-32f4-ea11-b882-24ee9a37d45c","P.S. Q086 - Q086 - Q086 - 28Q086 - 87-41 PARSONS BOULEVARD","117eed06-32f4-ea11-b882-24ee9a37d45c",-73803001,40709461,"P.S. 86 - QUEENS","87-41 PARSONS BOULEVARD"
1,1,0,"32a198c3-30f4-ea11-b882-24ee9a37d45c","P.S. 346 Abe Stark - K346 - K346 - 19K346 - 1400 PENNSYLVANIA AVENUE","30a198c3-30f4-ea11-b882-24ee9a37d45c",-73881997,40646640,"P.S. 346 - BROOKLYN","1400 PENNSYLVANIA AVENUE"
2,2,0,"96d91731-31f4-ea11-b882-24ee9a37d45c","Brooklyn Urban Garden Charter School - K758 - KBNU - 84K758 - 500 19 Street","97d91731-31f4-ea11-b882-24ee9a37d45c",-73982624,40656202,"STANLEY LAMM INSTITUE PRE-SCHOOL OF LONGISLAND HO","500 19 Street"
1,1,0,"d20d3c5b-30f4-ea11-b882-24ee9a37d45c","P.S. 100 The Coney Island School - K100 - K100 - 21K100 - 2951 WEST  3 STREET","ca0d3c5b-30f4-ea11-b882-24ee9a37d45c",-73970830,40577591,"P.S. 100 - BROOKLYN","2951 WEST  3 STREET"
1,1,0,"f6ae0313-32f4-ea11-b882-24ee9a37d45c","P.S. 123 - Q123 - Q123 - 27Q123 - 145-01 119 AVENUE","f7ae0313-32f4-ea11-b882-24ee9a37d45c",-73795571,40678913,"P.S. 123 - QUEENS","145-01 119 AVENUE"
2,0,2,"72283fb1-30f4-ea11-b882-24ee9a37d45c","Community Roots Charter School - K536 - K287 - 84K536 - 50 NAVY STREET","73283fb1-30f4-ea11-b882-24ee9a37d45c",-73981120,40697856,"P.S. 287 - BROOKLYN","50 NAVY STREET"
2,1,1,"602b3eee-30f4-ea11-b882-24ee9a37d45c","High School for Innovation in Advertising and Media - K617 - K500 - 18K617 - 1600 ROCKAWAY PARKWAY","5e2b3eee-30f4-ea11-b882-24ee9a37d45c",-73898601,40640543,"CANARSIE HS - K","1600 ROCKAWAY PARKWAY"
1,0,1,"69e4d766-4afb-ea11-b883-24ee9a37d459","Urban Concepts/Round the Clock - MBFX - MBFX -  - 300 W. 145 Street","6ae4d766-4afb-ea11-b883-24ee9a37d459",-73942071,40822892,"Urban Concepts of NY/Round the Clock Nursery Inc.","300 W. 145 Street"
1,0,1,"f08a0044-33f4-ea11-b882-24ee9a37d45c","P.S. 182 - X182 - X182 - 08X182 - 601 STICKBALL BOULEVARD","f18a0044-33f4-ea11-b882-24ee9a37d45c",-73856976,40818925,"P.S. 182 - BRONX","601 STICKBALL BOULEVARD"
1,1,0,"c9883319-32f4-ea11-b882-24ee9a37d45c","I.S. 141 The Steinway - Q141 - Q141 - 30Q141 - 37-11 21 AVENUE","ca883319-32f4-ea11-b882-24ee9a37d45c",-73904508,40775766,"I.S. 141 - QUEENS","37-11 21 AVENUE"
1,0,1,"4b6e70b7-31f4-ea11-b882-24ee9a37d45c","High School for Mathematics, Science and Engineering at City College - M692 - M812 - 05M692 - 240 CONVENT AVE","4c6e70b7-31f4-ea11-b882-24ee9a37d45c",-73950354,40820208,"HS FOR MATH, SCI & ENGINEERING-M","240 CONVENT AVE"
1,1,0,"9828a20c-31f4-ea11-b882-24ee9a37d45c","Brooklyn International High School - K439 - K805 - 13K439 - 49 FLATBUSH AVENUE EXTENSION","9428a20c-31f4-ea11-b882-24ee9a37d45c",-73984528,40697330,"WATER'S EDGE EDUCATIONAL CAMPUS - K","49 FLATBUSH AVENUE EXTENSION"
1,0,1,"69fdc1bd-32f4-ea11-b882-24ee9a37d45c","P.S. 022 Graniteville - R022 - R022 - 31R022 - 1860 Forest Avenue","6afdc1bd-32f4-ea11-b882-24ee9a37d45c",-74150544,40624847,"P.S. 22 - STATEN ISLAND","1860 Forest Avenue"
2,2,0,"e28442ee-31f4-ea11-b882-24ee9a37d45c","P.S. 040 Samuel Huntington - Q040 - Q040 - 28Q040 - 109-20 Union Hall Street","dd8442ee-31f4-ea11-b882-24ee9a37d45c",-73790975,40693559,"P.S. 40 (D28) - QUEENS","109-20 Union Hall Street"
2,2,0,"435b4cd6-32f4-ea11-b882-24ee9a37d45c","New Dorp High School - R440 - R435 - 31R440 - 465 NEW DORP LANE","fb8521d0-32f4-ea11-b882-24ee9a37d45c",-74105878,40570909,"NEW DORP HS (NEW) - S. I.","465 NEW DORP LANE"
2,2,0,"378dbfcf-30f4-ea11-b882-24ee9a37d45c","P.S. 770 New American Academy - K770 - K398 - 17K770 - 60 EAST  94 STREET","308dbfcf-30f4-ea11-b882-24ee9a37d45c",-73927979,40663388,"P.S. 398 (UDC) - BROOKLYN","60 EAST  94 STREET"
1,0,1,"a072c880-32f4-ea11-b882-24ee9a37d45c","Young Women's Leadership School, Queens - Q896 - Q680 - 28Q896 - 150-91 87 ROAD","9d72c880-32f4-ea11-b882-24ee9a37d45c",-73804166,40708409,"YOUNG WOMENS' LEADERSHIP SCHOOL - QUEENS","150-91 87 ROAD"
1,1,0,"640067b2-ebf6-ea11-b883-24ee9a37d459","Curious Young Learners Pre-K Center - Q336 - Q439 - 27Q336 - 101-49 WOODHAVEN BOULEVARD","d0b66262-32f4-ea11-b882-24ee9a37d45c",-73844901,40682949,"3K CENTER @ 101-49 WOODHAVEN BOULEVARD - QUEENS","101-49 WOODHAVEN BOULEVARD"
2,2,0,"7da9d9c3-32f4-ea11-b882-24ee9a37d45c","P.S. 030 Westerleigh - R030 - R030 - 31R030 - 200 Wardwell Avenue","73a9d9c3-32f4-ea11-b882-24ee9a37d45c",-74133080,40618097,"P.S. 30 - STATEN ISLAND","200 Wardwell Avenue"
3,2,1,"e077bb9f-33f4-ea11-b882-24ee9a37d45c","Mott Hall Bronx High School - X252 - X970 - 09X252 - 1595 BATHGATE AVENUE","e177bb9f-33f4-ea11-b882-24ee9a37d45c",-73901774,40839508,"BATHGATE HS - BRONX","1595 BATHGATE AVENUE"
2,1,1,"07e2abc9-30f4-ea11-b882-24ee9a37d45c","The Science And Medicine Middle School - K366 - K366 - 18K366 - 965 EAST 107TH STREET","08e2abc9-30f4-ea11-b882-24ee9a37d45c",-73891743,40647396,"SHIRLEY CHISHOLM CAMPUS - K","965 EAST 107TH STREET"
2,1,1,"71c280bd-31f4-ea11-b882-24ee9a37d45c","Eleanor Roosevelt High School - M416 - M855 - 02M416 - 411 EAST 76 STREET","72c280bd-31f4-ea11-b882-24ee9a37d45c",-73953276,40770288,"ELEANOR ROOSEVELT HS - MANHATTAN","411 EAST 76 STREET"
1,1,0,"a369c231-32f4-ea11-b882-24ee9a37d45c","Energy Tech High School - Q258 - Q204 - 30Q258 - 36-41 28 STREET","9c69c231-32f4-ea11-b882-24ee9a37d45c",-73932628,40756471,"I.S. 204 - QUEENS","36-41 28 STREET"
1,1,0,"1ea31781-33f4-ea11-b882-24ee9a37d45c","KIPP Academy Charter School - X704 - X790 - 84X704 - 730 CONCOURSE VILLAGE WEST","0ea31781-33f4-ea11-b882-24ee9a37d45c",-73922366,40821828,"MOTT HAVEN EDUCATIONAL CAMPUS - BRONX","730 CONCOURSE VILLAGE WEST"
1,1,0,"f2ae0313-32f4-ea11-b882-24ee9a37d45c","P.S. 122 Mamie Fay - Q122 - Q122 - 30Q122 - 21-21 DITMARS BOULEVARD","cb2ff20c-32f4-ea11-b882-24ee9a37d45c",-73915785,40780507,"P.S. 122 - QUEENS","21-21 DITMARS BOULEVARD"
2,1,1,"9f476368-32f4-ea11-b882-24ee9a37d45c","Flushing High School - Q460 - Q460 - 25Q460 - 35-01 UNION STREET","97476368-32f4-ea11-b882-24ee9a37d45c",-73826811,40764892,"FLUSHING HS - Q","35-01 UNION STREET"
1,1,0,"e6454b50-32f4-ea11-b882-24ee9a37d45c","Queens Explorers Elementary School - Q316 - Q316 - 27Q316 - 90-07 101ST AVENUE","e7454b50-32f4-ea11-b882-24ee9a37d45c",-73850123,40683112,"THE OZONE PARK EDUCATIONAL CAMPUS - QUEENS","90-07 101ST AVENUE"
1,0,1,"a5edf392-32f4-ea11-b882-24ee9a37d45c","Joseph F. Quinn Intermediate School 77 - Q077 - Q849 - 24Q077 - 976 Seneca Avenue","a4edf392-32f4-ea11-b882-24ee9a37d45c",-73902147,40699101,"I.S. 77 - QUEENS","976 Seneca Avenue"
2,1,1,"50fdc1bd-32f4-ea11-b882-24ee9a37d45c","P.S. 013 M. L. Lindemeyer - R013 - R013 - 31R013 - 191 VERMONT AVENUE","51fdc1bd-32f4-ea11-b882-24ee9a37d45c",-74068963,40613322,"P.S. 13 - STATEN ISLAND","191 VERMONT AVENUE"
1,0,1,"13e2abc9-30f4-ea11-b882-24ee9a37d45c","P.S. 376 - K376 - K376 - 32K376 - 194 HARMAN STREET","14e2abc9-30f4-ea11-b882-24ee9a37d45c",-73920187,40698050,"P.S. 376A - BROOKLYN","194 HARMAN STREET"
1,0,1,"026e3d68-31f4-ea11-b882-24ee9a37d45c","P.S. 110 Florence Nightingale - M110 - M110 - 01M110 - 285 DELANCY STREET","036e3d68-31f4-ea11-b882-24ee9a37d45c",-73979800,40716200,"P.S. 110 - MANHATTAN","285 DELANCY STREET"
1,0,1,"5dfdc1bd-32f4-ea11-b882-24ee9a37d45c","P.S. 018 John G. Whittier - R018 - R018 - 31R018 - 221 Broadway","5efdc1bd-32f4-ea11-b882-24ee9a37d45c",-74116817,40636521,"P.S. 18 - STATEN ISLAND","221 Broadway"
3,2,1,"47a10a44-32f4-ea11-b882-24ee9a37d45c","P.S./I.S. 295 - Q295 - Q263 - 29Q295 - 222-14 JAMAICA AVENUE","41a10a44-32f4-ea11-b882-24ee9a37d45c",-73731398,40720617,"P.S. /I.S 295 - QUEENS","222-14 JAMAICA AVENUE"
1,1,0,"1f6e3d68-31f4-ea11-b882-24ee9a37d45c","Tag Young Scholars - M012 - M117 - 04M012 - 240 EAST 109 STREET","1b6e3d68-31f4-ea11-b882-24ee9a37d45c",-73942285,40792556,"J.H.S. 117 - MANHATTAN","240 EAST 109 STREET"
1,1,0,"7c0e6e25-32f4-ea11-b882-24ee9a37d45c","I.S. 250 The Robert F. Kennedy Community Middle School - Q250 - Q168 - 25Q250 - 158-40 76 ROAD","099c4c1f-32f4-ea11-b882-24ee9a37d45c",-73809380,40724195,"J.H.S. 168 - QUEENS","158-40 76 ROAD"
2,1,1,"2ea6ba98-31f4-ea11-b882-24ee9a37d45c","High School for Health Careers and Sciences - M468 - M465 - 06M468 - 549 AUDUBON AVENUE","25a6ba98-31f4-ea11-b882-24ee9a37d45c",-73926060,40856532,"G. WASHINGTON HS EDUC. CAMPUS - M","549 AUDUBON AVENUE"
1,1,0,"db37fba4-31f4-ea11-b882-24ee9a37d45c","Cascades High School - M650 - M510 - 01M650 - 198 Forsyth Street","d737fba4-31f4-ea11-b882-24ee9a37d45c",-73990468,40722415,"FORSYTH HS (AUXSVC-OLD 91) - M","198 Forsyth Street"
1,1,0,"f8d10307-33f4-ea11-b882-24ee9a37d45c","The Vida Bogart School for All Children - X352 - X074 - 75X352 - 730 BRYANT AVENUE","f9d10307-33f4-ea11-b882-24ee9a37d45c",-73885284,40815827,"I.S. 201 - BRONX","730 BRYANT AVENUE"
1,1,0,"68e03d56-33f4-ea11-b882-24ee9a37d45c","P.S. 360 - X360 - X360 - 10X360 - 2880 KINGSBRIDGE TERRACE","69e03d56-33f4-ea11-b882-24ee9a37d45c",-73902214,40874717,"P.S. 360 - BRONX","2880 KINGSBRIDGE TERRACE"
1,1,0,"9b53dd74-33f4-ea11-b882-24ee9a37d45c","Bronx School of Law and Finance - X284 - X475 - 10X284 - 99 TERRACE VIEW AVENUE","9853dd74-33f4-ea11-b882-24ee9a37d45c",-73912686,40877379,"JOHN F. KENNEDY HS - X","99 TERRACE VIEW AVENUE"
2,1,1,"7e0e6e25-32f4-ea11-b882-24ee9a37d45c","Queens School of Inquiry, The - Q252 - Q168 - 25Q252 - 158-40 76 ROAD","099c4c1f-32f4-ea11-b882-24ee9a37d45c",-73809380,40724195,"J.H.S. 168 - QUEENS","158-40 76 ROAD"
1,1,0,"a69c11e8-30f4-ea11-b882-24ee9a37d45c","Science, Technology and Research Early College High School at Erasmus - K543 - K465 - 17K543 - 911 FLATBUSH AVENUE","9d9c11e8-30f4-ea11-b882-24ee9a37d45c",-73957173,40649602,"ERASMUS HALL CAMPUS - K","911 FLATBUSH AVENUE"
1,1,0,"6fc0eb6c-4afb-ea11-b883-24ee9a37d459","A To Z Center Too, Inc. - QANS - QANS -  - 220-24 JAMAICA AVENUE","70c0eb6c-4afb-ea11-b883-24ee9a37d459",-73733226,40718884,"A TO Z CENTER TOO, INC.","220-24 JAMAICA AVENUE"
1,1,0,"7d53dd74-33f4-ea11-b882-24ee9a37d45c","Bronx Compass High School - X561 - X450 - 08X561 - 1980 LAFAYETTE AVENUE","62ffcc6e-33f4-ea11-b882-24ee9a37d45c",-73855930,40821218,"Adlai E. Stevenson Educational Campus","1980 LAFAYETTE AVENUE"
1,0,1,"6ac0eb6c-4afb-ea11-b883-24ee9a37d459","MI NUEVO MUNDO EARLY CHILDHOOD - QAKM - QAPF -  - 31-05 51 STREET","6bc0eb6c-4afb-ea11-b883-24ee9a37d459",-73907850,40756924,"MI NUEVO MUNDO EARLY CHILDHOOD","31-05 51 STREET"
1,1,0,"18a198c3-30f4-ea11-b882-24ee9a37d45c","Leadership Preparatory Ocean Hill Charter School - K775 - K332 - 84K775 - 51 CHRISTOPHER AVENUE","19a198c3-30f4-ea11-b882-24ee9a37d45c",-73906018,40672216,"P.S. 332 - BROOKLYN","51 CHRISTOPHER AVENUE"
3,1,2,"290b210d-33f4-ea11-b882-24ee9a37d45c","P.S. 196 - X196 - X077 - 12X196 - 1250 WARD AVENUE","230b210d-33f4-ea11-b882-24ee9a37d45c",-73877305,40830811,"P.S. 195 - BRONX","1250 WARD AVENUE"
1,0,1,"d5e0838c-31f4-ea11-b882-24ee9a37d45c","Lower Manhattan Community Middle School - M896 - M282 - 02M896 - 26 BROADWAY","d1e0838c-31f4-ea11-b882-24ee9a37d45c",-74013303,40705688,"BROADWAY EDUCATION CAMPUS - M","26 BROADWAY"
1,1,0,"31eabc42-30f4-ea11-b882-24ee9a37d45c","Achievement First Brownsville Charter School - K626 - K055 - 84K626 - 2021 BERGEN STREET","32eabc42-30f4-ea11-b882-24ee9a37d45c",-73912685,40674456,"I.S. 55 - BROOKLYN","2021 BERGEN STREET"
1,1,0,"26767649-31f4-ea11-b882-24ee9a37d45c","P.S. 212 Midtown West - M212 - M017 - 02M212 - 328 WEST  48 STREET","aa886843-31f4-ea11-b882-24ee9a37d45c",-73988665,40761327,"I.S. 17 - MANHATTAN","328 WEST  48 STREET"
1,1,0,"24b4977a-32f4-ea11-b882-24ee9a37d45c","Middle College High School at LaGuardia Community College - Q520 - Q520 - 24Q520 - 45-35 VAN DAM STREET","22b4977a-32f4-ea11-b882-24ee9a37d45c",-73933316,40743253,"MIDDLE COLLEGE CAMPUS - QUEENS","45-35 VAN DAM STREET"
1,1,0,"362f7d06-31f4-ea11-b882-24ee9a37d45c","Brooklyn Studio Secondary School - K690 - K721 - 21K690 - 8310 21ST AVENUE","56416e00-31f4-ea11-b882-24ee9a37d45c",-73995084,40604980,"BROOKLYN STUDIO  (TANDEM K128) - K","8310 21ST AVENUE"
1,1,0,"8a41e65b-31f4-ea11-b882-24ee9a37d45c","P.S. 084 Lillian Weber - M084 - M084 - 03M084 - 32 West  92 Street","8b41e65b-31f4-ea11-b882-24ee9a37d45c",-73968419,40789479,"P.S. 84 - MANHATTAN","32 West  92 Street"
1,1,0,"8007e99e-31f4-ea11-b882-24ee9a37d45c","High School for Law, Advocacy and Community Justice - M492 - M490 - 03M492 - 122 AMSTERDAM AVENUE","7c07e99e-31f4-ea11-b882-24ee9a37d45c",-73985608,40774891,"MARTIN LUTHER KING, JR. HS - M","122 AMSTERDAM AVENUE"
1,1,0,"2eebaa73-30f4-ea11-b882-24ee9a37d45c","P.S. 160 William T. Sampson - K160 - K160 - 20K160 - 5105 Fort Hamilton Parkway","27ebaa73-30f4-ea11-b882-24ee9a37d45c",-73999045,40636932,"P.S. 160 - BROOKLYN","5105 Fort Hamilton Parkway"
1,1,0,"8207e99e-31f4-ea11-b882-24ee9a37d45c","High School of Arts and Technology - M494 - M490 - 03M494 - 122 AMSTERDAM AVENUE","7c07e99e-31f4-ea11-b882-24ee9a37d45c",-73985608,40774891,"MARTIN LUTHER KING, JR. HS - M","122 AMSTERDAM AVENUE"
1,0,1,"23ff3d8d-33f4-ea11-b882-24ee9a37d45c","Bronx Leadership Academy High School - X525 - X876 - 09X525 - 1710 Webster Avenue","24ff3d8d-33f4-ea11-b882-24ee9a37d45c",-73902969,40843250,"BRONX LEADERSHIP ACADEMY - BRONX","1710 Webster Avenue"
1,1,0,"555bc58c-30f4-ea11-b882-24ee9a37d45c","P.S. 216 Arturo Toscanini - K216 - K216 - 21K216 - 350 AVENUE X","565bc58c-30f4-ea11-b882-24ee9a37d45c",-73969647,40590000,"P.S. 216 - BROOKLYN","350 AVENUE X"
1,1,0,"e08a0044-33f4-ea11-b882-24ee9a37d45c","Bedford Park Elementary School - X077 - X177 - 10X077 - 3177 WEBSTER AVENUE","dc8a0044-33f4-ea11-b882-24ee9a37d45c",-73875375,40872559,"THE NORWOOD EAST CAMPUS - BRONX","3177 WEBSTER AVENUE"
3,3,0,"b68442ee-31f4-ea11-b882-24ee9a37d45c","P.S. 026 Rufus King - Q026 - Q026 - 26Q026 - 195-02 69 AVENUE","c5fc24e8-31f4-ea11-b882-24ee9a37d45c",-73777607,40735935,"P.S. 26 - QUEENS","195-02 69 AVENUE"
1,1,0,"8436d900-33f4-ea11-b882-24ee9a37d45c","P.S. 062 Inocensio Casanova - X062 - X062 - 08X062 - 660 FOX STREET","8336d900-33f4-ea11-b882-24ee9a37d45c",-73900161,40813736,"P.S. 62 - BRONX","660 FOX STREET"
2,2,0,"560d6d19-33f4-ea11-b882-24ee9a37d45c","North Bronx School of Empowerment - X287 - X113 - 11X287 - 3710 BARNES AVENUE","520d6d19-33f4-ea11-b882-24ee9a37d45c",-73860126,40880649,"I.S. 113 - BRONX","3710 BARNES AVENUE"
1,1,0,"8803194f-30f4-ea11-b882-24ee9a37d45c","Brooklyn Environmental Exploration School (BEES) - K664 - K073 - 23K664 - 251 MAC DOUGAL STREET","8503194f-30f4-ea11-b882-24ee9a37d45c",-73910719,40680679,"P.S. 73 - BROOKLYN","251 MAC DOUGAL STREET"
1,0,1,"02cf496e-31f4-ea11-b882-24ee9a37d45c","Pace High School - M298 - M131 - 02M298 - 100 HESTER STREET","03cf496e-31f4-ea11-b882-24ee9a37d45c",-73993607,40716231,"I.S. 131 - MANHATTAN","100 HESTER STREET"
1,1,0,"171bad3c-30f4-ea11-b882-24ee9a37d45c","P.S. 044 Marcus Garvey - K044 - K044 - 13K044 - 432 MONROE STREET","031bad3c-30f4-ea11-b882-24ee9a37d45c",-73940859,40686213,"P.S. 44 - BROOKLYN","432 MONROE STREET"
1,1,0,"f6c1392a-30f4-ea11-b882-24ee9a37d45c","Norma Adams Clemons Academy - K006 - K006 - 17K006 - 43 SNYDER AVENUE","f5c1392a-30f4-ea11-b882-24ee9a37d45c",-73956279,40648973,"P.S. 6 - BROOKLYN","43 SNYDER AVENUE"
12,12,0,"87e2635c-32f4-ea11-b882-24ee9a37d45c","Benjamin N. Cardozo High School - Q415 - Q415 - 26Q415 - 57-00 223RD STREET","86e2635c-32f4-ea11-b882-24ee9a37d45c",-73757271,40752343,"BENJAMIN N. CARDOZO HS - Q","57-00 223RD STREET"
1,1,0,"e8f57030-30f4-ea11-b882-24ee9a37d45c","P.S. 013 Roberto Clemente - K013 - K013 - 19K013 - 557 PENNSYLVANIA AVENUE","e7f57030-30f4-ea11-b882-24ee9a37d45c",-73893328,40664067,"P.S. 13 - BROOKLYN","557 PENNSYLVANIA AVENUE"
2,0,2,"6901ce37-33f4-ea11-b882-24ee9a37d45c","P.S. 152 Evergreen - X152 - X152 - 08X152 - 1007 EVERGREEN AVENUE","6a01ce37-33f4-ea11-b882-24ee9a37d45c",-73880479,40823941,"P.S. 152 - BRONX","1007 EVERGREEN AVENUE"
1,0,1,"622b3eee-30f4-ea11-b882-24ee9a37d45c","Urban Action Academy - K642 - K500 - 18K642 - 1600 ROCKAWAY PARKWAY","5e2b3eee-30f4-ea11-b882-24ee9a37d45c",-73898601,40640543,"CANARSIE HS - K","1600 ROCKAWAY PARKWAY"
1,1,0,"3b88e6db-30f4-ea11-b882-24ee9a37d45c","Performing Arts and Technology High School - K507 - K435 - 19K507 - 400 PENNSYLVANIA AVENUE","3688e6db-30f4-ea11-b882-24ee9a37d45c",-73895122,40666868,"THOMAS JEFFERSON HS - K","400 PENNSYLVANIA AVENUE"
1,1,0,"72f4a0ef-eaf6-ea11-b883-24ee9a37d459","P.S. K369 - Coy L. Cox School - K369 - K369 - 75K369 - 383 STATE STREET","03e2abc9-30f4-ea11-b882-24ee9a37d45c",-73983312,40687432,"P.S. 369 (COY COX SCHOOL)-K","383 STATE STREET"
1,1,0,"bbbf14dd-ebf6-ea11-b883-24ee9a37d459","P.S. R373 - R373 - R861 - 75R373 - 280 REGIS DRIVE","8a11b2e2-32f4-ea11-b882-24ee9a37d45c",-74164427,40620310,"ELIZABETH A. CONNELLY CAMPUS - S.I.","280 REGIS DRIVE"
2,2,0,"b1eb6056-32f4-ea11-b882-24ee9a37d45c","August Martin High School - Q400 - Q400 - 27Q400 - 156-10 BAISLEY BOULEVARD","a9eb6056-32f4-ea11-b882-24ee9a37d45c",-73782684,40673949,"AUGUST MARTIN HS - QUEENS","156-10 BAISLEY BOULEVARD"
1,1,0,"7d8946f4-31f4-ea11-b882-24ee9a37d45c","P.S. 055 Maure - Q055 - Q055 - 28Q055 - 131-10 97 Avenue","7b8946f4-31f4-ea11-b882-24ee9a37d45c",-73816156,40693610,"P.S. 55 - QUEENS","131-10 97 Avenue"
1,1,0,"51953aac-ebf6-ea11-b883-24ee9a37d459","The Riverview School - Q277 - Q404 - 75Q277 - 1-50 51ST AVENUE","65e2635c-32f4-ea11-b882-24ee9a37d45c",-73959183,40742964,"HUNTERS POINT CAMPUS - QUEENS","1-50 51ST AVENUE"
1,0,1,"ea883319-32f4-ea11-b882-24ee9a37d45c","P.S./M.S. 147 Ronald McNair - Q147 - Q147 - 29Q147 - 218-01 116 Avenue","e6883319-32f4-ea11-b882-24ee9a37d45c",-73740140,40698028,"P.S. 147 - QUEENS","218-01 116 Avenue"
2,2,0,"a2886843-31f4-ea11-b882-24ee9a37d45c","Central Park East High School - M555 - M013 - 04M555 - 1573 MADISON AVENUE","98886843-31f4-ea11-b882-24ee9a37d45c",-73948488,40793649,"I.S. 13 - MANHATTAN","1573 MADISON AVENUE"
1,1,0,"80bc9674-32f4-ea11-b882-24ee9a37d45c","Institute for Health Professions at Cambria Heights - Q243 - Q490 - 29Q243 - 207- 01 116TH  AVENUE","7ebc9674-32f4-ea11-b882-24ee9a37d45c",-73746330,40698786,"CAMPUS MAGNET HS (JACKSON) - Q","207- 01 116TH  AVENUE"
1,1,0,"30c15a75-ebf6-ea11-b883-24ee9a37d459","Adult and Continuing Education - K755 - M827 - 79K755 - 500 8 AVENUE","576e70b7-31f4-ea11-b882-24ee9a37d45c",-73992405,40753038,"AUX. SERV-MAN. LEARNING CENTER - M","500 8 AVENUE"
1,1,0,"7b283fb1-30f4-ea11-b882-24ee9a37d45c","P.S. 289 George V. Brower - K289 - K289 - 17K289 - 900 ST MARKS AVENUE","77283fb1-30f4-ea11-b882-24ee9a37d45c",-73942401,40674244,"P.S. 289 - BROOKLYN","900 ST MARKS AVENUE"
1,1,0,"96e657bd-30f4-ea11-b882-24ee9a37d45c","P.S. 316 Elijah Stroud - K316 - K316 - 17K316 - 750 CLASSON AVENUE","94e657bd-30f4-ea11-b882-24ee9a37d45c",-73961418,40674685,"P.S. 316 - BROOKLYN","750 CLASSON AVENUE"
2,2,0,"348dbfcf-30f4-ea11-b882-24ee9a37d45c","P.S. 398 Walter Weaver - K398 - K398 - 17K398 - 60 EAST  94 STREET","308dbfcf-30f4-ea11-b882-24ee9a37d45c",-73927979,40663388,"P.S. 398 (UDC) - BROOKLYN","60 EAST  94 STREET"
1,1,0,"acb66262-32f4-ea11-b882-24ee9a37d45c","Queens Preparatory Academy - Q248 - Q420 - 29Q248 - 143-10 SPRINGFIELD BOULEVARD","abb66262-32f4-ea11-b882-24ee9a37d45c",-73757744,40669030,"SPRINGFIELD GARDENS HS - Q","143-10 SPRINGFIELD BOULEVARD"
1,1,0,"286e3d68-31f4-ea11-b882-24ee9a37d45c","P.S. 333 Manhattan School for Children - M333 - M118 - 03M333 - 154 WEST  93 STREET","246e3d68-31f4-ea11-b882-24ee9a37d45c",-73971011,40791395,"I.S. 118 - MANHATTAN","154 WEST  93 STREET"
1,1,0,"e60d3c5b-30f4-ea11-b882-24ee9a37d45c","P.S. 107 John W. Kimball - K107 - K107 - 15K107 - 1301 8 AVENUE","e70d3c5b-30f4-ea11-b882-24ee9a37d45c",-73981181,40662945,"P.S. 107 - BROOKLYN","1301 8 AVENUE"
1,1,0,"68507380-31f4-ea11-b882-24ee9a37d45c","P.S. 452 - M452 - M191 - 03M452 - 210 WEST  61 STREET","69507380-31f4-ea11-b882-24ee9a37d45c",-73987515,40771603,"P.S. 191 - MANHATTAN","210 WEST  61 STREET"
1,1,0,"6936d900-33f4-ea11-b882-24ee9a37d45c","P.S. 055 Benjamin Franklin - X055 - X055 - 09X055 - 450 SAINT PAUL'S PLACE","6236d900-33f4-ea11-b882-24ee9a37d45c",-73904970,40835934,"P.S. 55 - BRONX","450 SAINT PAUL'S PLACE"
1,1,0,"e377bb9f-33f4-ea11-b882-24ee9a37d45c","Urban Assembly School for Applied Math and Science, The - X241 - X970 - 09X241 - 1595 BATHGATE AVENUE","e177bb9f-33f4-ea11-b882-24ee9a37d45c",-73901774,40839508,"BATHGATE HS - BRONX","1595 BATHGATE AVENUE"
2,1,1,"2e0410ca-32f4-ea11-b882-24ee9a37d45c","I.S. 051 Edwin Markham - R051 - R051 - 31R051 - 80 WILLOWBROOK ROAD","2f0410ca-32f4-ea11-b882-24ee9a37d45c",-74145522,40623077,"I.S. 51 - STATEN ISLAND","80 WILLOWBROOK ROAD"
2,1,1,"24474313-33f4-ea11-b882-24ee9a37d45c","The Family School - X443 - X090 - 09X443 - 1116 SHERIDAN AVENUE","1c474313-33f4-ea11-b882-24ee9a37d45c",-73917526,40831873,"P.S. 90 - BRONX","1116 SHERIDAN AVENUE"
1,1,0,"0bc73b4a-32f4-ea11-b882-24ee9a37d45c","The Gordon Parks School - Q270 - Q270 - 29Q270 - 233-15 MERRICK BOULEVARD","52a10a44-32f4-ea11-b882-24ee9a37d45c",-73736232,40675070,"P.S. 270 - QUEENS","233-15 MERRICK BOULEVARD"
1,1,0,"9fa9d9c3-32f4-ea11-b882-24ee9a37d45c","Marsh Avenue School for Expeditionary Learning - R063 - R043 - 31R063 - 100 ESSEX DRIVE","a0a9d9c3-32f4-ea11-b882-24ee9a37d45c",-74159343,40581958,"JEROME PARKER CAMPUS - S.I.","100 ESSEX DRIVE"
2,2,0,"240b210d-33f4-ea11-b882-24ee9a37d45c","P.S. 076 The Bennington School - X076 - X076 - 11X076 - 900 ADEE AVENUE","250b210d-33f4-ea11-b882-24ee9a37d45c",-73860928,40869059,"P.S. 76 - BRONX","900 ADEE AVENUE"
1,1,0,"d0ba3c50-33f4-ea11-b882-24ee9a37d45c","Young Voices Academy of the Bronx - X357 - X292 - 11X357 - 800 LYDIG AVENUE","d1ba3c50-33f4-ea11-b882-24ee9a37d45c",-73863733,40854423,"THE DOMINIC CASTORE EDUCATIONAL CAMPUS - BRONX","800 LYDIG AVENUE"
1,1,0,"d3689025-33f4-ea11-b882-24ee9a37d45c","Pelham Academy of Academics and Community Engagement - X468 - X135 - 11X468 - 2441 WALLACE AVENUE","d4689025-33f4-ea11-b882-24ee9a37d45c",-73865028,40862098,"I.S. 135 - BRONX","2441 WALLACE AVENUE"
1,1,0,"cfc88e4f-31f4-ea11-b882-24ee9a37d45c","47 The American Sign Language and English Secondary School - M047 - M047 - 02M047 - 223 EAST 23 STREET","d0c88e4f-31f4-ea11-b882-24ee9a37d45c",-73981329,40738374,"J.H.S. 47 (SCH FOR THE DEAF) - M","223 EAST 23 STREET"
1,1,0,"c4315367-30f4-ea11-b882-24ee9a37d45c","P.S. 124 Silas B. Dutcher - K124 - K124 - 15K124 - 515 4 AVENUE","c5315367-30f4-ea11-b882-24ee9a37d45c",-73990620,40667464,"P.S. 124 - BROOKLYN","515 4 AVENUE"
1,1,0,"c9315367-30f4-ea11-b882-24ee9a37d45c","Northside Charter High School - K693 - K126 - 84K693 - 424 LEONARD STREET","c3315367-30f4-ea11-b882-24ee9a37d45c",-73947932,40719818,"J.H.S. 126 - BROOKLYN","424 LEONARD STREET"
1,1,0,"10b7c337-32f4-ea11-b882-24ee9a37d45c","P.S. 221 The North Hills School - Q221 - Q221 - 26Q221 - 57-40 MARATHON PARKWAY","11b7c337-32f4-ea11-b882-24ee9a37d45c",-73731518,40758808,"P.S. 221 - QUEENS","57-40 MARATHON PARKWAY"
1,0,1,"4a45378b-4afb-ea11-b883-24ee9a37d459","Highbridge Advisory Council - XAIN - XAIN -  - 1181 NELSON AVENUE","4b45378b-4afb-ea11-b883-24ee9a37d459",-73926063,40837338,"HIGHBRIDGE ADVISORY COUNCIL","1181 NELSON AVENUE"
1,1,0,"57ebaa73-30f4-ea11-b882-24ee9a37d45c","Ralph A. Fabrizio School - K170 - K170 - 20K170 - 619 72ND STREET","58ebaa73-30f4-ea11-b882-24ee9a37d45c",-74018719,40630373,"P.S. 170 - BROOKLYN","619 72ND STREET"
1,0,1,"b3baaffd-8467-ec11-b8cf-24ee9a37d45c","MILES OF GIGGLES INC - 1 - XCEH - XCHK -  - 382 East  199 Street","b4baaffd-8467-ec11-b8cf-24ee9a37d45c",-73884903,40867356,"382 EAST  199 STREET","382 East  199 Street"
2,2,0,"0ab7c337-32f4-ea11-b882-24ee9a37d45c","P.S. 219 Paul Klapper - Q219 - Q219 - 25Q219 - 144-39 GRAVETT ROAD","0bb7c337-32f4-ea11-b882-24ee9a37d45c",-73823841,40737448,"P.S. 219 - QUEENS","144-39 GRAVETT ROAD"
3,1,2,"051bad3c-30f4-ea11-b882-24ee9a37d45c","P.S. 038 The Pacific - K038 - K038 - 15K038 - 450 PACIFIC STREET","061bad3c-30f4-ea11-b882-24ee9a37d45c",-73982826,40684945,"P.S. 38 - BROOKLYN","450 PACIFIC STREET"
1,0,1,"95977d2b-32f4-ea11-b882-24ee9a37d45c","Goldie Maple Academy - Q333 - Q198 - 27Q333 - 3-65 BEACH 56 STREET","85977d2b-32f4-ea11-b882-24ee9a37d45c",-73786649,40594008,"I.S. 198 - QUEENS","3-65 BEACH 56 STREET"
3,1,2,"f3968d36-30f4-ea11-b882-24ee9a37d45c","P.S. 026 Jesse Owens - K026 - K026 - 16K026 - 1014 LAFAYETTE AVENUE","f2968d36-30f4-ea11-b882-24ee9a37d45c",-73931700,40692100,"P.S. 26 - BROOKLYN","1014 LAFAYETTE AVENUE"
1,0,1,"b079df48-30f4-ea11-b882-24ee9a37d45c","Whitelaw Reid Academy of Arts and Business - K057 - K057 - 16K057 - 125 STUYVESANT AVENUE","ae79df48-30f4-ea11-b882-24ee9a37d45c",-73932254,40691467,"J.H.S. 57 - BROOKLYN","125 STUYVESANT AVENUE"
1,1,0,"7b53dd74-33f4-ea11-b882-24ee9a37d45c","Gotham Collaborative High School - X452 - X450 - 08X452 - 1980 LAFAYETTE AVENUE","62ffcc6e-33f4-ea11-b882-24ee9a37d45c",-73855930,40821218,"Adlai E. Stevenson Educational Campus","1980 LAFAYETTE AVENUE"
5,5,0,"c3c88e4f-31f4-ea11-b882-24ee9a37d45c","The Anderson School - M334 - M044 - 03M334 - 100 WEST  77 STREET","bfc88e4f-31f4-ea11-b882-24ee9a37d45c",-73977602,40780536,"I.S. 44 - MANHATTAN","100 WEST  77 STREET"
2,2,0,"da1f145d-51e6-eb11-b8b1-24ee9a37d45c","Success Academy Charter School - Rosedale - New York 5 - Q337 - Q390 - 84Q337 - 109-55 128 Street","db1f145d-51e6-eb11-b8b1-24ee9a37d45c",-73813926,40683802,"SAINT TERESA OF AVILA SCHOOL - QUEENS","109-55 128 Street"
1,1,0,"46b4977a-32f4-ea11-b882-24ee9a37d45c","Aviation Career & Technical Education High School - Q610 - Q610 - 24Q610 - 45-30 36 STREET","44b4977a-32f4-ea11-b882-24ee9a37d45c",-73929577,40743309,"AVIATION HS - Q","45-30 36 STREET"
2,2,0,"d611f898-32f4-ea11-b882-24ee9a37d45c","Renaissance Charter School - Q705 - Q885 - 84Q705 - 35-59 81ST STREET","d511f898-32f4-ea11-b882-24ee9a37d45c",-73884817,40749934,"RENAISSANCE CHARTER SCHOOL - Q","35-59 81ST STREET"
1,0,1,"f3ed94c3-31f4-ea11-b882-24ee9a37d45c","Paula Hedbavny School - M278 - M918 - 06M278 - 421 W 219th St","f4ed94c3-31f4-ea11-b882-24ee9a37d45c",-73912339,40871673,"P.S./IS 278 - MANHATTAN","421 W 219th St"
1,0,1,"68dc32dc-31f4-ea11-b882-24ee9a37d45c","Success Academy Charter School - Hudson Yards - M358 - MBMO - 84M358 - 500 West 41 Street","dd430bd6-31f4-ea11-b882-24ee9a37d45c",-73996499,40758759,"Hudson Yards","500 West 41 Street"
1,0,1,"d479df48-30f4-ea11-b882-24ee9a37d45c","Community Roots Charter School - K536 - K067 - 84K536 - 51 SAINT EDWARDS STREET","d179df48-30f4-ea11-b882-24ee9a37d45c",-73977674,40695339,"P.S. 67 - BROOKLYN","51 SAINT EDWARDS STREET"
4,1,3,"dd3159fa-30f4-ea11-b882-24ee9a37d45c","Bridges: A School for Exploration and Equity - K915 - K580 - 13K915 - 105 TECH PLACE","d33159fa-30f4-ea11-b882-24ee9a37d45c",-73986105,40695444,"GEORGE WESTINGHOUSE VOC HS - K","105 TECH PLACE"
3,3,0,"38005d7a-31f4-ea11-b882-24ee9a37d45c","J.H.S. 167 Robert F. Wagner - M167 - M167 - 02M167 - 220 EAST  76 STREET","39005d7a-31f4-ea11-b882-24ee9a37d45c",-73957827,40771541,"I.S. 167 - MANHATTAN","220 EAST  76 STREET"
1,1,0,"7907e99e-31f4-ea11-b882-24ee9a37d45c","Art and Design High School - M630 - M488 - 02M630 - 231-249 EAST 56 STREET","6d07e99e-31f4-ea11-b882-24ee9a37d45c",-73967204,40759248,"MIDTOWN EAST CAMPUS - MANHATTAN","231-249 EAST 56 STREET"
1,1,0,"a153dd74-33f4-ea11-b882-24ee9a37d45c","New Visions Charter High School for Advanced Math and Science - X539 - X475 - 84X539 - 99 TERRACE VIEW AVENUE","9853dd74-33f4-ea11-b882-24ee9a37d45c",-73912686,40877379,"JOHN F. KENNEDY HS - X","99 TERRACE VIEW AVENUE"
1,0,1,"6eceb75a-4afb-ea11-b883-24ee9a37d459","Rainbow LIC - Borden Avenue - QBPW - QBPW -  - 1-55 BORDEN AVENUE","6fceb75a-4afb-ea11-b883-24ee9a37d459",-73959041,40742519,"Rainbow LIC - Borden Avenue","1-55 BORDEN AVENUE"
1,0,1,"cc2ff20c-32f4-ea11-b882-24ee9a37d45c","The James J. Ambrose School - Q115 - Q115 - 26Q115 - 80-51 261 STREET","cd2ff20c-32f4-ea11-b882-24ee9a37d45c",-73709404,40744201,"The James J. Ambrose School","80-51 261 STREET"
1,0,1,"b269c231-32f4-ea11-b882-24ee9a37d45c","P.S./I.S. 208 - Q208 - Q208 - 29Q208 - 74-30 COMMONWEALTH BLVD","ab69c231-32f4-ea11-b882-24ee9a37d45c",-73727632,40744276,"P.S./I.S. 208 - QUEENS","74-30 COMMONWEALTH BLVD"
1,0,1,"fa09e2e1-30f4-ea11-b882-24ee9a37d45c","Research and Service High School - K669 - K455 - 16K669 - 1700 FULTON STREET","f209e2e1-30f4-ea11-b882-24ee9a37d45c",-73931604,40678478,"BOYS & GIRLS HS - K","1700 FULTON STREET"
1,1,0,"68f4a0ef-eaf6-ea11-b883-24ee9a37d459","P.S. K811 Connie Lekas School - K811 - K286 - 75K811 - 2525 HARING STREET","6e283fb1-30f4-ea11-b882-24ee9a37d45c",-73938610,40591132,"P.S. 811 (OLD P286) - BROOKLYN","2525 HARING STREET"
4,4,0,"6707e99e-31f4-ea11-b882-24ee9a37d45c","Talent Unlimited High School - M519 - M480 - 02M519 - 317 EAST  67 STREET","6007e99e-31f4-ea11-b882-24ee9a37d45c",-73959777,40765638,"JULIA RICHMAN ED. COMPLEX - M","317 EAST  67 STREET"
2,2,0,"237eed06-32f4-ea11-b882-24ee9a37d45c","I.S. 093 Ridgewood - Q093 - Q093 - 24Q093 - 66-56 FOREST AVENUE","0f7eed06-32f4-ea11-b882-24ee9a37d45c",-73903057,40705609,"I.S. 93 - QUEENS","66-56 FOREST AVENUE"
1,1,0,"e8d10307-33f4-ea11-b882-24ee9a37d45c","P.S. 068 Bronx - X068 - X068 - 11X068 - 4011 MONTICELLO AVENUE","e9d10307-33f4-ea11-b882-24ee9a37d45c",-73838880,40891603,"P.S. 68 - BRONX","4011 MONTICELLO AVENUE"
1,1,0,"12c73b4a-32f4-ea11-b882-24ee9a37d45c","David N. Dinkins School - Q048 - Q276 - 28Q048 - 108-29 155 STREET","0ec73b4a-32f4-ea11-b882-24ee9a37d45c",-73796358,40693736,"THE WILLIAM WORDSWORTH EDUCATIONAL COMPLEX","108-29 155 STREET"
