"TotalCases","StudentCases","EmployeeCases","nycsr_locationsiteid","nycsr_sitename","nycsr_building.nycsr_buildingid","nycsr_building.nycsr_longitude","nycsr_building.nycsr_latitude","nycsr_building.nycsr_buildingname","nycsr_building.nycsr_address"
1,1,0,"d3893969-4cfc-ec11-b8db-24ee9a37d45c","Summer - CHAPTER 683 -  - P.S. R373 - R373 - R071 - 75R373 - 1050 Targee Street","db8521d0-32f4-ea11-b882-24ee9a37d45c",-74091239,40603492,"P.S./I.S. 48 - Staten Island","1050 Targee Street"
2,0,2,"2079385d-4cfc-ec11-b8db-24ee9a37d45c","Summer - CHAPTER 683 -  - P.S. M721 - Manhattan Occupational Training Center - M721 - M641 - 75M721 - 16 Clarkson Street","4d0c1bb1-31f4-ea11-b882-24ee9a37d45c",-74006155,40729052,"CITY-AS-SCHOOL(OLD 95) - MANHATTAN","16 Clarkson Street"
1,0,1,"840e6e25-32f4-ea11-b882-24ee9a37d45c","P.S. 169 Bay Terrace - Q169 - Q169 - 25Q169 - 18-25 212 STREET","820e6e25-32f4-ea11-b882-24ee9a37d45c",-73778430,40782331,"P.S. 169 - QUEENS","18-25 212 STREET"
1,0,1,"3879385d-4cfc-ec11-b8db-24ee9a37d45c","Summer - CHAPTER 683 -  - P.S. Q993 - Q993 - Q130 - 75Q993 - 200-01 42 AVENUE","04af0313-32f4-ea11-b882-24ee9a37d45c",-73784009,40760219,"P.S. 130 - QUEENS","200-01 42 AVENUE"
2,0,2,"37843a63-4cfc-ec11-b8db-24ee9a37d45c","Summer - CHAPTER 683 -  - P.S. Q224 - Q224 - Q809 - 75Q224 - 221-21 Corbett Road","febdf08c-32f4-ea11-b882-24ee9a37d45c",-73763295,40770666,"P.S. 224 ANNEX - QUEENS","221-21 Corbett Road"
2,2,0,"32a198c3-30f4-ea11-b882-24ee9a37d45c","P.S. 346 Abe Stark - K346 - K346 - 19K346 - 1400 PENNSYLVANIA AVENUE","30a198c3-30f4-ea11-b882-24ee9a37d45c",-73881997,40646640,"P.S. 346 - BROOKLYN","1400 PENNSYLVANIA AVENUE"
1,0,1,"e9893969-4cfc-ec11-b8db-24ee9a37d45c","Summer - CHAPTER 683 -  - P.S. X010 - X010 - X067 - 75X010 - 2024 MOHEGAN AVENUE","e6d10307-33f4-ea11-b882-24ee9a37d45c",-73884192,40843781,"P.S. 67 - BRONX","2024 MOHEGAN AVENUE"
1,0,1,"6a0067b2-ebf6-ea11-b883-24ee9a37d459"," - K925 - Q456 - 79K925 - 105-25 HORACE HARDING EXPY N","91476368-32f4-ea11-b882-24ee9a37d45c",-73853412,40737673,"HS FOR ARTS AND BUS. (OL NUTN X)-Q","105-25 HORACE HARDING EXPY N"
1,0,1,"ed893969-4cfc-ec11-b8db-24ee9a37d45c","Summer - CHAPTER 683 -  - The Vida Bogart School for All Children - X352 - X092 - 75X352 - 700 EAST 179 STREET","27474313-33f4-ea11-b882-24ee9a37d45c",-73889602,40846205,"P.S. 92 - BRONX","700 EAST 179 STREET"
1,0,1,"e73b3857-4cfc-ec11-b8db-24ee9a37d45c","Summer - CHAPTER 683 -  - P.S. 138 - M138 - M030 - 75M138 - 144-176 EAST 128 STREET","38767649-31f4-ea11-b882-24ee9a37d45c",-73935461,40805653,"P.S. 30 - MANHATTAN","144-176 EAST 128 STREET"
2,1,1,"dd3b3857-4cfc-ec11-b8db-24ee9a37d45c","Summer - CHAPTER 683 -  - P.S. K721 - Brooklyn Occupational Training Center - K721 - K722 - 75K721 - 64 AVENUE X","392f7d06-31f4-ea11-b882-24ee9a37d45c",-73981925,40588070,"P.S. 721 OTC - BROOKLYN","64 AVENUE X"
2,2,0,"5e8d0640-0cfe-ec11-b8db-24ee9a37d45c","Summer - EXTENDED SCHOOL YEAR -  - I.S. R002 George L. Egbert - R002 - R002 - 31R002 - 333 Midland Avenue","2b7c21b7-32f4-ea11-b882-24ee9a37d45c",-74099685,40576728,"I.S. 2 - STATEN ISLAND","333 Midland Avenue"
1,1,0,"8f783f51-4cfc-ec11-b8db-24ee9a37d45c","Summer - CHAPTER 683 -  - P.S. K811 Connie Lekas School - K811 - K286 - 75K811 - 2525 HARING STREET","6e283fb1-30f4-ea11-b882-24ee9a37d45c",-73938610,40591132,"P.S. 811 (OLD P286) - BROOKLYN","2525 HARING STREET"
1,0,1,"83783f51-4cfc-ec11-b8db-24ee9a37d45c","Summer - CHAPTER 683 -  - P.S. K231 - K231 - K180 - 75K231 - 5601 16 AVENUE","b8b36d80-30f4-ea11-b882-24ee9a37d45c",-73989250,40626454,"P.S. 180 - BROOKLYN","5601 16 AVENUE"
7,7,0,"99d93933-4cfc-ec11-b8db-24ee9a37d45c","Summer - ES_MS SUMMER RISING - K-5; 6-8 - Bronx Delta School - X392 - X192 - 08X392 - 650 HOLLYWOOD AVENUE","078b0044-33f4-ea11-b882-24ee9a37d45c",-73818083,40826794,"I.S. 192 - BRONX","650 HOLLYWOOD AVENUE"
2,1,1,"f97a396f-4cfc-ec11-b8db-24ee9a37d45c","Summer - CHAPTER 683 -  - P.S. X176 - X176 - X181 - 75X176 - 800 BAYCHESTER AVENUE","e78a0044-33f4-ea11-b882-24ee9a37d45c",-73831669,40874035,"I.S. 181 - BRONX","800 BAYCHESTER AVENUE"
5,2,3,"88783f51-4cfc-ec11-b8db-24ee9a37d45c","Summer - CHAPTER 683 -  - P.S. K771 - K771 - K225 - 75K771 - 1075 OCEAN VIEW AVENUE","e521d292-30f4-ea11-b882-24ee9a37d45c",-73955856,40580260,"P.S. 225 - BROOKLYN","1075 OCEAN VIEW AVENUE"
3,1,2,"2a843a63-4cfc-ec11-b8db-24ee9a37d45c","Summer - CHAPTER 683 -  - The Riverview School - Q277 - Q404 - 75Q277 - 1-50 51ST AVENUE","65e2635c-32f4-ea11-b882-24ee9a37d45c",-73959183,40742964,"HUNTERS POINT CAMPUS - QUEENS","1-50 51ST AVENUE"
2,1,1,"3fde5eb7-30f4-ea11-b882-24ee9a37d45c","P.S. 298 Dr. Betty Shabazz - K298 - K298 - 23K298 - 85 WATKINS STREET","3dde5eb7-30f4-ea11-b882-24ee9a37d45c",-73907718,40671015,"P.S. 298 - BROOKLYN","85 WATKINS STREET"
3,3,0,"14eb3215-4cfc-ec11-b8db-24ee9a37d45c","Summer - ES_MS SUMMER RISING - K-5; 6-8 - P.S. 096 Joseph Lanzetta - M096 - M096 - 04M096 - 216 EAST 120 STREET","43e61462-31f4-ea11-b882-24ee9a37d45c",-73937179,40799690,"P.S. 96 - MANHATTAN","216 EAST 120 STREET"
4,1,3,"1eeb3215-4cfc-ec11-b8db-24ee9a37d45c","Summer - ES_MS SUMMER RISING - K-5; 6-8 - P.S. 146 Ann M. Short - M146 - M146 - 04M146 - 421 EAST 106 STREET","4f9f4974-31f4-ea11-b882-24ee9a37d45c",-73938727,40789535,"P.S. 146 - MANHATTAN","421 EAST 106 STREET"
1,0,1,"a609301b-4cfc-ec11-b8db-24ee9a37d45c","Summer - ES SUMMER RISING - K-5 - P. S. 62 - Chester Park School - Q062 - Q062 - 27Q062 - 97-25 108 STREET","642f77fa-31f4-ea11-b882-24ee9a37d45c",-73835567,40688359,"P.S. 62 - QUEENS","97-25 108 STREET"
2,1,1,"f13b3857-4cfc-ec11-b8db-24ee9a37d45c","Summer - CHAPTER 683 -  - P.S. 138 - M138 - M114 - 75M138 - 331 EAST 91ST STREET","126e3d68-31f4-ea11-b882-24ee9a37d45c",-73947379,40780452,"EAST SIDE MIDDLE SCHOOL - MANHATTAN","331 EAST 91ST STREET"
2,0,2,"79783f51-4cfc-ec11-b8db-24ee9a37d45c","Summer - CHAPTER 683 -  - P.S. K771 - K771 - K066 - 75K771 - 845 EAST 96 STREET","cc79df48-30f4-ea11-b882-24ee9a37d45c",-73907064,40648749,"P.S. 66 - BROOKLYN","845 EAST 96 STREET"
3,0,3,"a7eb4327-4cfc-ec11-b8db-24ee9a37d45c","Summer - ES SUMMER RISING - K-5 - The Woodside Community School - Q361 - Q339 - 30Q361 - 39-07 57th Street","82eb6056-32f4-ea11-b882-24ee9a37d45c",-73906430,40747701,"P.S. 339 - Queens","39-07 57th Street"
1,0,1,"ef3b3857-4cfc-ec11-b8db-24ee9a37d45c","Summer - CHAPTER 683 -  - P.S. M079 - Horan School - M079 - M079 - 75M079 - 55 East 120 Street","7741e65b-31f4-ea11-b882-24ee9a37d45c",-73942009,40802547,"P.S. 79 (MULT. HANDICAP) - M","55 East 120 Street"
1,0,1,"f0e0a4fb-ebf6-ea11-b883-24ee9a37d459","Pathways to Graduation - Q950 - X401 - 79Q950 - 1010 REV. J. A. POLITE AVENUE","8ce03d56-33f4-ea11-b882-24ee9a37d45c",-73898265,40823124,"BRONX REGIONAL HS (OLD 133) - X","1010 REV. J. A. POLITE AVENUE"
1,0,1,"2e79385d-4cfc-ec11-b8db-24ee9a37d45c","Summer - CHAPTER 683 -  - P.S. Q811 - Q811 - Q037 - 75Q811 - 179-37 137 Avenue","d58442ee-31f4-ea11-b882-24ee9a37d45c",-73758778,40676201,"P.S. 37 - QUEENS","179-37 137 Avenue"
5,5,0,"a0284621-4cfc-ec11-b8db-24ee9a37d45c","Summer - ES SUMMER RISING - K-5 - P.S. 139 Rego Park - Q139 - Q139 - 28Q139 - 93-06 63 DRIVE","29af0313-32f4-ea11-b882-24ee9a37d45c",-73862561,40728012,"P.S. 139 - QUEENS","93-06 63 DRIVE"
1,1,0,"5d5b4cd6-32f4-ea11-b882-24ee9a37d45c","Curtis High School - R450 - R451 - 31R450 - 105 Hamilton Avenue","5e5b4cd6-32f4-ea11-b882-24ee9a37d45c",-74082149,40645436,"CURTIS AF - STATEN ISLAND","105 Hamilton Avenue"
1,1,0,"ef27b299-33f4-ea11-b882-24ee9a37d45c","The School of Science and Applied Learning - X300 - X941 - 12X300 - 2055 MAPES AVENUE","f027b299-33f4-ea11-b882-24ee9a37d45c",-73886721,40846128,"P.S. 234 TRANSPORTABLE - X","2055 MAPES AVENUE"
2,2,0,"9bd93933-4cfc-ec11-b8db-24ee9a37d45c","Summer - ES SUMMER RISING - K-5 - The School of Science and Applied Learning - X300 - X234 - 12X300 - 2050 PROSPECT AVENUE","d4ab074a-33f4-ea11-b882-24ee9a37d45c",-73886721,40846128,"P.S. 234 (PAIRED W I129) - BRONX","2050 PROSPECT AVENUE"
1,1,0,"e59aeff9-49fb-ea11-b883-24ee9a37d459","UNIVERSITY SETTLEMENT EARLY CHILDHOOD CENTER - MAUB - MAUB -  - 184 ELDRIDGE STREET","e69aeff9-49fb-ea11-b883-24ee9a37d459",-73990519,40720543,"UNIVERSITY SETTLEMENT EARLY CHILDHOOD CENTER","184 ELDRIDGE STREET"
1,0,1,"c617ab87-ebf6-ea11-b883-24ee9a37d459","P.S. Q233 - Q233 - Q025 - 75Q233 - 34-65 192 STREET","befc24e8-31f4-ea11-b882-24ee9a37d45c",-73789365,40764884,"J.H.S. 25 - QUEENS","34-65 192 STREET"
2,0,2,"1e79385d-4cfc-ec11-b8db-24ee9a37d45c","Summer - CHAPTER 683 -  - P.S. M226 - M226 - M480 - 75M226 - 317 EAST 67 STREET","6007e99e-31f4-ea11-b882-24ee9a37d45c",-73959777,40765638,"JULIA RICHMAN ED. COMPLEX - M","317 EAST 67 STREET"
3,3,0,"16b7c337-32f4-ea11-b882-24ee9a37d45c","P.S. 223 Lyndon B. Johnson - Q223 - Q223 - 27Q223 - 125-20 SUTPHIN BOULEVARD","09b7c337-32f4-ea11-b882-24ee9a37d45c",-73789530,40673898,"P.S. 223 - QUEENS","125-20 SUTPHIN BOULEVARD"
1,0,1,"03e0ede7-49fb-ea11-b883-24ee9a37d459","Nuestros Ninos CDS - KBVC - KBVC -  - 384 South 4th Street","04e0ede7-49fb-ea11-b883-24ee9a37d459",-73952544,40707885,"Nuestros Ninos CDS","384 South 4th Street"
6,1,5,"e2893969-4cfc-ec11-b8db-24ee9a37d45c","Summer - CHAPTER 683 -  - P.S. X012 Lewis and Clark School - X012 - X012 - 75X012 - 2555 TRATMAN AVENUE","279ebaee-32f4-ea11-b882-24ee9a37d45c",-73844685,40840625,"P.S. 12 - BRONX","2555 TRATMAN AVENUE"
5,3,2,"bbbfa431-33f4-ea11-b882-24ee9a37d45c","The Laboratory School of Finance and Technology: X223 - X223 - X149 - 07X223 - 360 EAST 145 STREET","bcbfa431-33f4-ea11-b882-24ee9a37d45c",-73920851,40813612,"J.H.S. 149 - BRONX","360 EAST 145 STREET"
7,3,4,"e524210f-4cfc-ec11-b8db-24ee9a37d45c","Summer - ECC SITE - PK - District 20 Pre-K Center - K768 - K678 - 20K768 - 1423 62ND STREET","46416e00-31f4-ea11-b882-24ee9a37d45c",-73996423,40625978,"PRE-K CENTER @62ND STREET - BROOKLYN","1423 62ND STREET"
3,3,0,"c8edf392-32f4-ea11-b882-24ee9a37d45c","P.S. 007 Louis F. Simeone - Q007 - Q877 - 24Q007 - 76-05 51 AVENUE","c9edf392-32f4-ea11-b882-24ee9a37d45c",-73887011,40737222,"51ST AVENUE ACADEMY - QUEENS","76-05 51 AVENUE"
6,6,0,"2a1d2b3f-4cfc-ec11-b8db-24ee9a37d45c","Summer - HS SUMMER RISING - 9-12 - Bard High School Early College - M696 - M097 - 01M696 - 525 EAST HOUSTON STREET","46e61462-31f4-ea11-b882-24ee9a37d45c",-73976093,40718276,"BARD COLLEGE HS (OLD M097) - M","525 EAST HOUSTON STREET"
1,0,1,"6ce23039-4cfc-ec11-b8db-24ee9a37d45c","Summer - ES_MS SUMMER RISING - K-5; 6-8 - The Brooklyn New School, P.S. 146 - K146 - K142 - 15K146 - 610 HENRY STREET","cfd27c6d-30f4-ea11-b882-24ee9a37d45c",-74002022,40679462,"J.H.S. 142 - BROOKLYN","610 HENRY STREET"
2,1,1,"d43b3857-4cfc-ec11-b8db-24ee9a37d45c","Summer - CHAPTER 683 -  - P.S. K053 - K053 - K422 - 75K053 - 1065 Elton Street","da92e6d5-30f4-ea11-b882-24ee9a37d45c",-73874064,40657266,"SPRING CREEK EDUCATIONAL CAMPUS - BROOKLYN","1065 Elton Street"
1,0,1,"9f09301b-4cfc-ec11-b8db-24ee9a37d45c","Summer - ES SUMMER RISING - K-5 - P.S. 035 Nathaniel Woodhull - Q035 - Q035 - 29Q035 - 191-02 90 Avenue","bb8442ee-31f4-ea11-b882-24ee9a37d45c",-73768894,40713438,"P.S. 35 - QUEENS","191-02 90 Avenue"
1,1,0,"2c522709-4cfc-ec11-b8db-24ee9a37d45c","Summer - MS SUMMER RISING - 6-8 - J.H.S. 234 Arthur W. Cunningham - K234 - K234 - 22K234 - 1875 EAST 17 STREET","56a5db98-30f4-ea11-b882-24ee9a37d45c",-73955217,40604447,"I.S. 234 - BROOKLYN","1875 EAST 17 STREET"
1,1,0,"29a198c3-30f4-ea11-b882-24ee9a37d45c","P.S. 889 - K889 - K338 - 22K889 - 21 HINCKLEY PLACE","27a198c3-30f4-ea11-b882-24ee9a37d45c",-73971010,40644861,"P.S. 338 - Brooklyn","21 HINCKLEY PLACE"
8,7,1,"dcfa079f-32f4-ea11-b882-24ee9a37d45c","P.S. 193 Alfred J. Kennedy - Q193 - Q967 - 25Q193 - 152-20 11thave","ddfa079f-32f4-ea11-b882-24ee9a37d45c",-73809700,40792500,"P.S. 193 TRANSPORTABLE - Q","152-20 11thave"
1,0,1,"98783f51-4cfc-ec11-b8db-24ee9a37d45c","Summer - CHAPTER 683 -  - P.S. 371 - Lillian L. Rashkis - K371 - K371 - 75K371 - 355 37 STREET","0de2abc9-30f4-ea11-b882-24ee9a37d45c",-74005168,40654306,"P.S. 371 (OLD 615) - BROOKLYN","355 37 STREET"
1,0,1,"9b09301b-4cfc-ec11-b8db-24ee9a37d45c","Summer - ES SUMMER RISING - K-5 - P.S. 020 John Bowne - Q020 - Q020 - 25Q020 - 142-30 BARCLAY AVENUE","14f32ce2-31f4-ea11-b882-24ee9a37d45c",-73824388,40758347,"P.S. 20 - QUEENS","142-30 BARCLAY AVENUE"
1,1,0,"9deb4327-4cfc-ec11-b8db-24ee9a37d45c","Summer - ES_MS SUMMER RISING - K-5; 6-8 - P.S./I.S. 268 - Q268 - Q268 - 29Q268 - 92-07 175 STREET","4ea10a44-32f4-ea11-b882-24ee9a37d45c",-73785210,40707648,"P.S. 268 - QUEENS","92-07 175 STREET"
2,1,1,"12eb3215-4cfc-ec11-b8db-24ee9a37d45c","Summer - MS SUMMER RISING - 6-8 - M.S. 319 - Maria Teresa - M319 - M090 - 06M319 - 21 JUMEL PLACE","2ce61462-31f4-ea11-b882-24ee9a37d45c",-73935815,40839139,"I.S. 90 - MANHATTAN","21 JUMEL PLACE"
1,0,1,"1323f4ed-49fb-ea11-b883-24ee9a37d459","Weeksville Pre-K - KCHP - KCHP -  - 1640 Pacific","1423f4ed-49fb-ea11-b883-24ee9a37d459",0,0,"Weeksville Pre-K","1640 Pacific"
3,2,1,"28843a63-4cfc-ec11-b8db-24ee9a37d45c","Summer - CHAPTER 683 -  - P.S. Q255 - Q255 - Q397 - 75Q255 - 32-52 37th Street","a4eb6056-32f4-ea11-b882-24ee9a37d45c",-73920948,40759308,"PRE-K CENTER @37TH STREET - QUEENS","32-52 37th Street"
2,2,0,"1bb7c337-32f4-ea11-b882-24ee9a37d45c","Waterside Children's Studio School - Q317 - Q225 - 27Q317 - 190 BEACH 110 STREET","19b7c337-32f4-ea11-b882-24ee9a37d45c",-73831090,40580907,"P.S. 225 - QUEENS","190 BEACH 110 STREET"
2,1,1,"98284621-4cfc-ec11-b8db-24ee9a37d45c","Summer - ES_MS SUMMER RISING - K-5; 6-8 - P.S./I.S. 113 Anthony J. Pranzo - Q113 - Q113 - 24Q113 - 78-23 87TH STREET","c62ff20c-32f4-ea11-b882-24ee9a37d45c",-73861493,40705476,"P.S./I.S. 113 - QUEENS","78-23 87TH STREET"
1,0,1,"f17a396f-4cfc-ec11-b8db-24ee9a37d45c","Summer - CHAPTER 683 -  - P.S. X596 - X596 - X153 - 75X596 - 650 BAYCHESTER AVENUE","6801ce37-33f4-ea11-b882-24ee9a37d45c",-73831669,40874035,"P.S. 153 - BRONX","650 BAYCHESTER AVENUE"
4,4,0,"b5284621-4cfc-ec11-b8db-24ee9a37d45c","Summer - ES_MS SUMMER RISING - K-5; 6-8 - P.S./I.S. 208 - Q208 - Q208 - 29Q208 - 74-30 COMMONWEALTH BLVD","ab69c231-32f4-ea11-b882-24ee9a37d45c",-73727632,40744276,"P.S./I.S. 208 - QUEENS","74-30 COMMONWEALTH BLVD"
3,2,1,"f87a396f-4cfc-ec11-b8db-24ee9a37d45c","Summer - CHAPTER 683 -  - P.S. X596 - X596 - X178 - 75X596 - 850 BAYCHESTER AVENUE","e38a0044-33f4-ea11-b882-24ee9a37d45c",-73831669,40874035,"P.S. 178 - BRONX","850 BAYCHESTER AVENUE"
2,1,1,"f61c2845-4cfc-ec11-b8db-24ee9a37d45c","Summer - HS SUMMER RISING - 9-12 - Francis Lewis High School - Q430 - Q430 - 26Q430 - 58-20 UTOPIA PARKWAY","bcb66262-32f4-ea11-b882-24ee9a37d45c",-73795049,40740875,"FRANCIS LEWIS HS - Q","58-20 UTOPIA PARKWAY"
4,1,3,"d0893969-4cfc-ec11-b8db-24ee9a37d45c","Summer - CHAPTER 683 -  - P.S. R373 - R373 - R040 - 75R373 - 91 HENDERSON AVENUE","97a9d9c3-32f4-ea11-b882-24ee9a37d45c",-74095454,40641180,"P.S. 373 (OLD P40) - STATEN ISLAND","91 HENDERSON AVENUE"
1,1,0,"3f79385d-4cfc-ec11-b8db-24ee9a37d45c","Summer - CHAPTER 683 -  - P.S. Q255 - Q255 - Q168 - 75Q255 - 158-40 76 ROAD","099c4c1f-32f4-ea11-b882-24ee9a37d45c",-73809380,40724195,"J.H.S. 168 - QUEENS","158-40 76 ROAD"
1,0,1,"f0893969-4cfc-ec11-b8db-24ee9a37d45c","Summer - CHAPTER 683 -  - P.S. X188 - X188 - X120 - 75X188 - 890 CAULDWELL AVENUE","1478931f-33f4-ea11-b882-24ee9a37d45c",-73906739,40822291,"I.S. 301 - BRONX","890 CAULDWELL AVENUE"
1,1,0,"03eb3215-4cfc-ec11-b8db-24ee9a37d45c","Summer - ES_MS SUMMER RISING - K-5; 6-8 - P.S. 163 Bath Beach - K163 - K807 - 20K163 - 109 BAY 14TH STREET","9b28a20c-31f4-ea11-b882-24ee9a37d45c",-74007469,40606739,"P.S./ I.S. 163 - BROOKLYN","109 BAY 14TH STREET"
3,0,3,"84783f51-4cfc-ec11-b8db-24ee9a37d45c","Summer - CHAPTER 683 -  - Sid Miller Academy - K396 - K181 - 75K396 - 1023 NEW YORK AVENUE","bdb36d80-30f4-ea11-b882-24ee9a37d45c",-73945883,40648217,"P.S. 181 - BROOKLYN","1023 NEW YORK AVENUE"
2,1,1,"3e1d2b3f-4cfc-ec11-b8db-24ee9a37d45c","Summer - MS SUMMER RISING - 6-8 - Community Health Academy of the Heights - M346 - M814 - 06M346 - 504 WEST 158TH STREET","4f6e70b7-31f4-ea11-b882-24ee9a37d45c",-73942074,40833695,"THE COMMUNITY HEALTH ACADEMY OF THE HEIGHTS - M","504 WEST 158TH STREET"
1,0,1,"3d843a63-4cfc-ec11-b8db-24ee9a37d45c","Summer - CHAPTER 683 -  - P.S. Q255 - Q255 - Q908 - 75Q255 - 98-07 38th Avenue","ec11f898-32f4-ea11-b882-24ee9a37d45c",-73867826,40750254,"P.S. 908 - QUEENS","98-07 38th Avenue"
1,0,1,"d33b3857-4cfc-ec11-b8db-24ee9a37d45c","Summer - CHAPTER 683 -  - Sid Miller Academy - K396 - K396 - 75K396 - 110 CHESTER STREET","2d8dbfcf-30f4-ea11-b882-24ee9a37d45c",-73911788,40668232,"P.S. 396 (TANDEM K327-D23)-K","110 CHESTER STREET"
1,0,1,"1ca6ba98-31f4-ea11-b882-24ee9a37d45c","International High School at Union Square - M438 - M460 - 02M438 - 40 IRVING PLACE","16a6ba98-31f4-ea11-b882-24ee9a37d45c",-73987064,40735361,"WASHINGTON IRVING HS - MANHATTAN","40 IRVING PLACE"
5,4,1,"15eb3215-4cfc-ec11-b8db-24ee9a37d45c","Summer - ES SUMMER RISING - K-5 - P.S. 110 Florence Nightingale - M110 - M110 - 01M110 - 285 DELANCY STREET","036e3d68-31f4-ea11-b882-24ee9a37d45c",-73979800,40716200,"P.S. 110 - MANHATTAN","285 DELANCY STREET"
3,2,1,"35522709-4cfc-ec11-b8db-24ee9a37d45c","Summer - ES SUMMER RISING - K-5 - The Fresh Creek School - K325 - K260 - 19K325 - 875 WILLIAMS AVENUE","64b50aa5-30f4-ea11-b882-24ee9a37d45c",-73893294,40653368,"P.S. 260 - BROOKLYN","875 WILLIAMS AVENUE"
1,1,0,"2679385d-4cfc-ec11-b8db-24ee9a37d45c","Summer - CHAPTER 683 -  - P.S. M226 - M226 - MAMX - 75M226 - 1 PACE PLAZA","9a3eb8c9-31f4-ea11-b882-24ee9a37d45c",-74004808,40711211,"ONE PACE PLAZA","1 PACE PLAZA"
1,1,0,"3a843a63-4cfc-ec11-b8db-24ee9a37d45c","Summer - CHAPTER 683 -  - P.S. Q233 - Q233 - Q835 - 75Q233 - 109-36 204th Street","1fbef08c-32f4-ea11-b882-24ee9a37d45c",-73754747,40707535,"P.S. 233 MINISCHOOL1 (OLD P134)-Q","109-36 204th Street"
1,0,1,"341d2b3f-4cfc-ec11-b8db-24ee9a37d45c","Summer - HS SUMMER RISING - 9-12 - Stuyvesant High School - M475 - M477 - 02M475 - 345 CHAMBERS STREET","5c07e99e-31f4-ea11-b882-24ee9a37d45c",-74013921,40718025,"STUYVESANT HS (NEW) - MANHATTAN","345 CHAMBERS STREET"
5,2,3,"d0201a03-4cfc-ec11-b8db-24ee9a37d45c","Summer - ES SUMMER RISING - K-5 - P.S. 106 Edward Everett Hale - K106 - K106 - 32K106 - 1328 PUTNAM AVENUE","d50d3c5b-30f4-ea11-b882-24ee9a37d45c",-73913378,40693318,"P.S. 106 - BROOKLYN","1328 PUTNAM AVENUE"
4,3,1,"1b522709-4cfc-ec11-b8db-24ee9a37d45c","Summer - ES SUMMER RISING - K-5 - P.S. 188 Michael E. Berdy - K188 - K188 - 21K188 - 3314 Neptune Avenue","cdb36d80-30f4-ea11-b882-24ee9a37d45c",-74000489,40576733,"P.S. 188 - BROOKLYN","3314 Neptune Avenue"
4,0,4,"32275a30-4afb-ea11-b883-24ee9a37d459","PSYCHOTHERAPEUTIC EVALUATION PROGRAM PEP INC, DBA Parsons Preschool - QBFO - QAZN -  - 231-10 HILLSIDE AVENUE","33275a30-4afb-ea11-b883-24ee9a37d459",-73738338,40732809,"INTERDISPLINARY CENTER FOR CHILD DEVELOPMENT","231-10 HILLSIDE AVENUE"
2,0,2,"2b843a63-4cfc-ec11-b8db-24ee9a37d45c","Summer - CHAPTER 683 -  - P.S. Q256 - Q256 - Q410 - 75Q256 - 100-00 BEACH CHANNEL DRIVE","71e2635c-32f4-ea11-b882-24ee9a37d45c",-73825317,40586012,"Beach Channel Educational Campus","100-00 BEACH CHANNEL DRIVE"
1,0,1,"84d93933-4cfc-ec11-b8db-24ee9a37d45c","Summer - ES SUMMER RISING - K-5 - Archer Elementary School - X531 - X102 - 12X531 - 1827 ARCHER STREET","290d6d19-33f4-ea11-b882-24ee9a37d45c",-73866038,40838151,"P.S. 102 - BRONX","1827 ARCHER STREET"
2,2,0,"90eb4327-4cfc-ec11-b8db-24ee9a37d45c","Summer - ES SUMMER RISING - K-5 - P.S. 212 - Q212 - Q212 - 30Q212 - 34-25 82 STREET","b969c231-32f4-ea11-b882-24ee9a37d45c",-73884458,40753035,"P.S. 212 - QUEENS","34-25 82 STREET"
1,0,1,"22843a63-4cfc-ec11-b8db-24ee9a37d45c","Summer - CHAPTER 683 -  - P.S. 009 - Q009 - Q268 - 75Q009 - 92-07 175 STREET","4ea10a44-32f4-ea11-b882-24ee9a37d45c",-73785210,40707648,"P.S. 268 - QUEENS","92-07 175 STREET"
1,1,0,"3a68ee1e-31f4-ea11-b882-24ee9a37d45c","P.S. 007 Abraham Lincoln - K007 - K991 - 19K007 - 858 Jamaica Avenue","3b68ee1e-31f4-ea11-b882-24ee9a37d45c",-73872983,40689213,"P.S. 7 TRANSPORTABLE - K","858 Jamaica Avenue"
2,2,0,"cd201a03-4cfc-ec11-b8db-24ee9a37d45c","Summer - ES SUMMER RISING - K-5 - P.S. 094 The Henry Longfellow - K094 - K094 - 15K094 - 5010 6 AVENUE","8fd92255-30f4-ea11-b882-24ee9a37d45c",-74008795,40643730,"P.S. 94 - BROOKLYN","5010 6 AVENUE"
1,0,1,"93cab8ee-48fb-ea11-b883-24ee9a37d459","ALEX GFDC, INC. - APT 9E - KDHF - KBYC -  - 177 SAND STREET","94cab8ee-48fb-ea11-b883-24ee9a37d459",-73983778,40700704,"177 SAND STREET","177 SAND STREET"
1,1,0,"11e85c61-30f4-ea11-b882-24ee9a37d45c","P.S. 108 Sal Abbracciamento - K108 - K108 - 19K108 - 200 LINWOOD STREET","12e85c61-30f4-ea11-b882-24ee9a37d45c",-73884348,40681295,"P.S. 108 - BROOKLYN","200 LINWOOD STREET"
1,1,0,"21b4977a-32f4-ea11-b882-24ee9a37d45c","International High School at LaGuardia Community College - Q530 - Q520 - 24Q530 - 45-35 VAN DAM STREET","22b4977a-32f4-ea11-b882-24ee9a37d45c",-73933316,40743253,"MIDDLE COLLEGE CAMPUS - QUEENS","45-35 VAN DAM STREET"
5,4,1,"14d73d2d-4cfc-ec11-b8db-24ee9a37d45c","Summer - ES_MS SUMMER RISING - K-5; 6-8 - Staten Island School of Civic Leadership - R861 - R861 - 31R861 - 280 REGIS DRIVE","8a11b2e2-32f4-ea11-b882-24ee9a37d45c",-74164427,40620310,"ELIZABETH A. CONNELLY CAMPUS - S.I.","280 REGIS DRIVE"
1,1,0,"1aeb3215-4cfc-ec11-b8db-24ee9a37d45c","Summer - ES SUMMER RISING - K-5 - P.S. 130 Hernando De Soto - M130 - M130 - 02M130 - 143 BAXTER STREET","09cf496e-31f4-ea11-b882-24ee9a37d45c",-73998326,40718660,"P.S. 130 - MANHATTAN","143 BAXTER STREET"
8,7,1,"0beb3215-4cfc-ec11-b8db-24ee9a37d45c","Summer - ES SUMMER RISING - K-5 - P.S. 048 P.O. Michael J. Buczek - M048 - M048 - 06M048 - 4360-78 BROADWAY","d9c88e4f-31f4-ea11-b882-24ee9a37d45c",-73933629,40853193,"P.S. 48 - MANHATTAN","4360-78 BROADWAY"
1,1,0,"b2c0204b-4cfc-ec11-b8db-24ee9a37d45c","Summer - HS SUMMER RISING - 9-12 - Bronx Leadership Academy High School - X525 - X876 - 09X525 - 1710 Webster Avenue","24ff3d8d-33f4-ea11-b882-24ee9a37d45c",-73902969,40843250,"BRONX LEADERSHIP ACADEMY - BRONX","1710 Webster Avenue"
6,1,5,"f67a396f-4cfc-ec11-b8db-24ee9a37d45c","Summer - CHAPTER 683 -  - P.S. 168 - X168 - X177 - 75X168 - 3177 WEBSTER AVENUE","dc8a0044-33f4-ea11-b882-24ee9a37d45c",-73875375,40872559,"THE NORWOOD EAST CAMPUS - BRONX","3177 WEBSTER AVENUE"
1,1,0,"311d2b3f-4cfc-ec11-b8db-24ee9a37d45c","Summer - HS SUMMER RISING - 9-12 - Gramercy Arts High School - M374 - M460 - 02M374 - 40 IRVING PLACE","16a6ba98-31f4-ea11-b882-24ee9a37d45c",-73987064,40735361,"WASHINGTON IRVING HS - MANHATTAN","40 IRVING PLACE"
1,1,0,"36522709-4cfc-ec11-b8db-24ee9a37d45c","Summer - ES_MS SUMMER RISING - K-5; 6-8 - P.S./I.S. 323 - K323 - K263 - 23K323 - 210 CHESTER STREET","6eb50aa5-30f4-ea11-b882-24ee9a37d45c",-73911279,40666187,"P.S./I.S. 323 - BROOKLYN","210 CHESTER STREET"
3,0,3,"1b79385d-4cfc-ec11-b8db-24ee9a37d45c","Summer - CHAPTER 683 -  - P.S. M094 - M094 - M338 - 75M094 - 525 WEST 44TH STREET","dfe0838c-31f4-ea11-b882-24ee9a37d45c",-73995825,40761487,"P.S. 51 ELIAS HOWE - MANHATTAN","525 WEST 44TH STREET"
9,7,2,"9a284621-4cfc-ec11-b8db-24ee9a37d45c","Summer - ES SUMMER RISING - K-5 - The James J. Ambrose School - Q115 - Q115 - 26Q115 - 80-51 261 STREET","cd2ff20c-32f4-ea11-b882-24ee9a37d45c",-73709404,40744201,"The James J. Ambrose School","80-51 261 STREET"
6,6,0,"b2eb4327-4cfc-ec11-b8db-24ee9a37d45c","Summer - ES SUMMER RISING - K-5 - P.S. 036 J. C. Drumgoole - R036 - R036 - 31R036 - 255 IONIA AVENUE","8ba9d9c3-32f4-ea11-b882-24ee9a37d45c",-74182548,40543433,"P.S. 36 - STATEN ISLAND","255 IONIA AVENUE"
1,0,1,"8211b2e2-32f4-ea11-b882-24ee9a37d45c","P.S. 036 J. C. Drumgoole - R036 - R844 - 31R036 - 200 Jefferson Blvd","8311b2e2-32f4-ea11-b882-24ee9a37d45c",-74182548,40543433,"P.S. 36 ANNEX - STATEN ISLAND","200 Jefferson Blvd"
3,3,0,"9441e65b-31f4-ea11-b882-24ee9a37d45c","Frederick Douglass Academy II Secondary School - M860 - M088 - 03M860 - 215 WEST 114 STREET","8841e65b-31f4-ea11-b882-24ee9a37d45c",-73954152,40802610,"I.S. 88 - MANHATTAN","215 WEST 114 STREET"
1,1,0,"ff487593-33f4-ea11-b882-24ee9a37d45c","The Dr. Emmett W. Bassett School - X119 - X915 - 08X119 - 1075 Pugsley Avenue","00497593-33f4-ea11-b882-24ee9a37d45c",-73857392,40828474,"P.S. 119 TRANSPORTABLE - X","1075 Pugsley Avenue"
3,3,0,"d1201a03-4cfc-ec11-b8db-24ee9a37d45c","Summer - ES SUMMER RISING - K-5 - P.S. 110 The Monitor - K110 - K110 - 14K110 - 124 MONITOR STREET","e50d3c5b-30f4-ea11-b882-24ee9a37d45c",-73941926,40723743,"P.S. 110 - BROOKLYN","124 MONITOR STREET"
1,1,0,"5ff92a2a-4afb-ea11-b883-24ee9a37d459","ECDO CHILD START CENTER - MAXC - MAXC -  - 249 WEST 144TH STREET","60f92a2a-4afb-ea11-b883-24ee9a37d459",-73941219,40821900,"ECDO CHILD START CENTER","249 WEST 144TH STREET"
1,0,1,"f77a396f-4cfc-ec11-b8db-24ee9a37d45c","Summer - CHAPTER 683 -  - The Bronx School for Continuous Learners - X469 - X177 - 75X469 - 3177 WEBSTER AVENUE","dc8a0044-33f4-ea11-b882-24ee9a37d45c",-73875375,40872559,"THE NORWOOD EAST CAMPUS - BRONX","3177 WEBSTER AVENUE"
3,2,1,"a0eb4327-4cfc-ec11-b8db-24ee9a37d45c","Summer - ES SUMMER RISING - K-5 - David N. Dinkins School - Q048 - Q276 - 28Q048 - 108-29 155 STREET","0ec73b4a-32f4-ea11-b882-24ee9a37d45c",-73796358,40693736,"THE WILLIAM WORDSWORTH EDUCATIONAL COMPLEX","108-29 155 STREET"
2,1,1,"1feb3215-4cfc-ec11-b8db-24ee9a37d45c","Summer - ES SUMMER RISING - K-5 - P.S. 152 Dyckman Valley - M152 - M152 - 06M152 - 93 NAGLE AVENUE","5b9f4974-31f4-ea11-b882-24ee9a37d45c",-73927578,40859804,"P.S. 152 - MANHATTAN","93 NAGLE AVENUE"
1,1,0,"409587f5-ebf6-ea11-b883-24ee9a37d459","Adult and Continuing Education - K755 - X153 - 79K755 - 650 BAYCHESTER AVENUE","6801ce37-33f4-ea11-b882-24ee9a37d45c",-73831669,40874035,"P.S. 153 - BRONX","650 BAYCHESTER AVENUE"
3,2,1,"83d93933-4cfc-ec11-b8db-24ee9a37d45c","Summer - ES SUMMER RISING - K-5 - P.S. 100 Isaac Clason - X100 - X100 - 08X100 - 800 TAYLOR AVENUE","50474313-33f4-ea11-b882-24ee9a37d45c",-73862760,40822552,"P.S. 100 - BRONX","800 TAYLOR AVENUE"
2,1,1,"8fc9a854-4afb-ea11-b883-24ee9a37d459","All My Children Day Care 1 - QARQ - QBEU -  - 83-10 188TH STREET","90c9a854-4afb-ea11-b883-24ee9a37d459",-73778937,40724742,"All My Children Day Care 1","83-10 188TH STREET"
1,1,0,"92284621-4cfc-ec11-b8db-24ee9a37d45c","Summer - ES SUMMER RISING - K-5 - P.S. 097 Forest Park - Q097 - Q097 - 27Q097 - 85-52 85 STREET","317eed06-32f4-ea11-b882-24ee9a37d45c",-73860031,40694232,"P.S. 97 - QUEENS","85-52 85 STREET"
1,0,1,"3b0d6d19-33f4-ea11-b882-24ee9a37d45c","P.S. 106 Parkchester - X106 - X106 - 11X106 - 1514 OLMSTEAD AVENUE","3c0d6d19-33f4-ea11-b882-24ee9a37d45c",-73854823,40836974,"P.S. 106 - BRONX","1514 OLMSTEAD AVENUE"
5,4,1,"c495e8fc-4bfc-ec11-b8db-24ee9a37d45c","Summer - ES SUMMER RISING - K-5 - Red Hook Neighborhood School - K676 - K027 - 15K676 - 27 HUNTINGTON STREET","f8968d36-30f4-ea11-b882-24ee9a37d45c",-74005151,40677914,"P.S. 27 - BROOKLYN","27 HUNTINGTON STREET"
3,0,3,"f63b3857-4cfc-ec11-b8db-24ee9a37d45c","Summer - CHAPTER 683 -  - P.S. M094 - M094 - M188 - 75M094 - 442 EAST HOUSTON STREET","4b507380-31f4-ea11-b882-24ee9a37d45c",-73977380,40719888,"P.S. 188 - MANHATTAN","442 EAST HOUSTON STREET"
1,1,0,"f9207b48-4afb-ea11-b883-24ee9a37d459","Brooklyn Chinese-American Association at 60 Street - KCRV - KCRV -  - 757 60 Street","fa207b48-4afb-ea11-b883-24ee9a37d459",-74010124,40636144,"Brooklyn Chinese-American Association at 60 Street","757 60 Street"
2,1,1,"04eb3215-4cfc-ec11-b8db-24ee9a37d45c","Summer - ES_MS SUMMER RISING - K-5; 6-8 - P.S. 089 Cypress Hills - K089 - K814 - 19K089 - 265 WARWICK STREET","a928a20c-31f4-ea11-b882-24ee9a37d45c",-73886712,40677707,"CYPRESS HILLS COMMUNITY SCHOOL - BROOKLYN","265 WARWICK STREET"
1,0,1,"252ed53d-33f4-ea11-b882-24ee9a37d45c","P.S. 011 Highbridge - X011 - X172 - 09X011 - 1399 Ogden Ave","262ed53d-33f4-ea11-b882-24ee9a37d45c",-73924626,40842407,"P.S. 11 ANNEX (P172 ECC) - BRONX","1399 Ogden Ave"
1,0,1,"29d73d2d-4cfc-ec11-b8db-24ee9a37d45c","Summer - ES SUMMER RISING - K-5 - P.S. 070 Max Schoenfeld - X070 - X070 - 09X070 - 1691 WEEKS AVENUE","efd10307-33f4-ea11-b882-24ee9a37d45c",-73908070,40844236,"P.S. 70 - BRONX","1691 WEEKS AVENUE"
1,1,0,"076e3d68-31f4-ea11-b882-24ee9a37d45c","The Opportunity Charter School - M279 - M113 - 84M279 - 240 WEST 113 STREET","086e3d68-31f4-ea11-b882-24ee9a37d45c",-73955583,40801573,"P.S. 241 - MANHATTAN","240 WEST 113 STREET"
3,3,0,"9d09301b-4cfc-ec11-b8db-24ee9a37d45c","Summer - ES SUMMER RISING - K-5 - P.S. 024 Andrew Jackson - Q024 - Q024 - 25Q024 - 45-57 UNION STREET","b6fc24e8-31f4-ea11-b882-24ee9a37d45c",-73818100,40751972,"P.S. 24 - QUEENS","45-57 UNION STREET"
1,1,0,"8cc9a854-4afb-ea11-b883-24ee9a37d459","LUCILLE ROSE DAY CARE CENTER - QARC - QARC -  - 148 BEACH 59 STREET","8dc9a854-4afb-ea11-b883-24ee9a37d459",-73787463,40590667,"LUCILLE ROSE DAY CARE CENTER","148 BEACH 59 STREET"
1,0,1,"db893969-4cfc-ec11-b8db-24ee9a37d45c","Summer - CHAPTER 683 -  - The Richard H. Hungerford School - R721 - R843 - 75R721 - 110 Shafter Avenue","7d11b2e2-32f4-ea11-b882-24ee9a37d45c",-74148370,40554498,"GREAT KILLS HIGH SCHOOL","110 Shafter Avenue"
1,0,1,"7c783f51-4cfc-ec11-b8db-24ee9a37d45c","Summer - CHAPTER 683 -  - P.S. K753 - School for Career Development - K753 - K085 - 75K753 - 510 CLERMONT AVENUE","6cd92255-30f4-ea11-b882-24ee9a37d45c",-73969248,40682576,"P.S. 753 (OLD P85/STERLING HS) - K","510 CLERMONT AVENUE"
1,0,1,"f47a396f-4cfc-ec11-b8db-24ee9a37d45c","Summer - CHAPTER 683 -  - P.S. X017 - X017 - X161 - 75X017 - 628 TINTON AVENUE","ff2dd53d-33f4-ea11-b882-24ee9a37d45c",-73905233,40814168,"P.S. 161 - BRONX","628 TINTON AVENUE"
1,1,0,"e93b3857-4cfc-ec11-b8db-24ee9a37d45c","Summer - CHAPTER 683 -  - P.S. M721 - Manhattan Occupational Training Center - M721 - M047 - 75M721 - 223 EAST 23 STREET","d0c88e4f-31f4-ea11-b882-24ee9a37d45c",-73981329,40738374,"J.H.S. 47 (SCH FOR THE DEAF) - M","223 EAST 23 STREET"
1,1,0,"c5a00518-4afb-ea11-b883-24ee9a37d459","St. Marks - KBFD - KBRJ -  - 2017 BEVERLY ROAD","c6a00518-4afb-ea11-b883-24ee9a37d459",-73959522,40645167,"SAINT MARK'S HEAD START","2017 BEVERLY ROAD"
1,1,0,"d53b3857-4cfc-ec11-b8db-24ee9a37d45c","Summer - CHAPTER 683 -  - P.S. K053 - K053 - K437 - 75K053 - 713 CATON AVENUE","4488e6db-30f4-ea11-b882-24ee9a37d45c",-73973363,40647598,"P.S./I.S. 437 - BROOKLYN","713 CATON AVENUE"
1,1,0,"a509301b-4cfc-ec11-b8db-24ee9a37d45c","Summer - MS SUMMER RISING - 6-8 - I.S. 061 Leonardo Da Vinci - Q061 - Q061 - 24Q061 - 98-50 50 AVENUE","5f2f77fa-31f4-ea11-b882-24ee9a37d45c",-73862886,40741898,"I.S. 61 - QUEENS","98-50 50 AVENUE"
6,3,3,"1deb3215-4cfc-ec11-b8db-24ee9a37d45c","Summer - ES SUMMER RISING - K-5 - P.S. 145, The Bloomingdale School - M145 - M145 - 03M145 - 150 West 105 Street","4a9f4974-31f4-ea11-b882-24ee9a37d45c",-73965611,40799098,"P.S. 145 - MANHATTAN","150 West 105 Street"
4,4,0,"de3b3857-4cfc-ec11-b8db-24ee9a37d45c","Summer - CHAPTER 683 -  - P.S. 372 -The Children's School - K372 - K834 - 75K372 - 512 CARROLL STREET","fcd7cf12-31f4-ea11-b882-24ee9a37d45c",-73985500,40676198,"P.S. 372 (OUR LADY OF PEACE)-K","512 CARROLL STREET"
3,1,2,"051d2845-4cfc-ec11-b8db-24ee9a37d45c","Summer - HS SUMMER RISING - 9-12 - Aviation Career & Technical Education High School - Q610 - Q610 - 24Q610 - 45-30 36 STREET","44b4977a-32f4-ea11-b882-24ee9a37d45c",-73929577,40743309,"AVIATION HS - Q","45-30 36 STREET"
1,0,1,"079275c3-49fb-ea11-b883-24ee9a37d459","JENNY PENA-PORTORREAL-3C - XBQF - XAVA -  - 909 SHERIDAN AVENUE","089275c3-49fb-ea11-b883-24ee9a37d459",-73920828,40827559,"909 SHERIDAN AVENUE","909 SHERIDAN AVENUE"
1,0,1,"da893969-4cfc-ec11-b8db-24ee9a37d45c","Summer - CHAPTER 683 -  - The David Marquis School of the Arts - R037 - R840 - 75R037 - 15 Fairfield Street","81be7adc-32f4-ea11-b882-24ee9a37d45c",-74151368,40564100,"P.S. 37 ( OLD I24X)-STATEN ISLAND","15 Fairfield Street"
1,1,0,"41f92a2a-4afb-ea11-b883-24ee9a37d459","RENA DAY CARE CENTER - MAQR - MAQR -  - 639 EDGECOMBE AVENUE","42f92a2a-4afb-ea11-b883-24ee9a37d459",-73936843,40837789,"RENA DAY CARE CENTER","639 EDGECOMBE AVENUE"
1,1,0,"018bc007-ebf6-ea11-b883-24ee9a37d459","Bronx Charter School for Better Learning - X718 - X937 - 84X718 - 3740 BAYCHESTER AVENUE","20497593-33f4-ea11-b882-24ee9a37d45c",-73839288,40884371,"BX CHARTER SCH FOR BETTER LRNG - X","3740 BAYCHESTER AVENUE"
8,5,3,"1e0410ca-32f4-ea11-b882-24ee9a37d45c","P.S. 045 John Tyler - R045 - R045 - 31R045 - 58 LAWRENCE AVENUE","1f0410ca-32f4-ea11-b882-24ee9a37d45c",-74107537,40628419,"P.S. 45 - STATEN ISLAND","58 LAWRENCE AVENUE"
1,1,0,"a6284621-4cfc-ec11-b8db-24ee9a37d45c","Summer - ES_MS SUMMER RISING - K-5; 6-8 - P.S. 153 Maspeth Elem - Q153 - Q153 - 24Q153 - 60-02 60 LANE","e19b4c1f-32f4-ea11-b882-24ee9a37d45c",-73904463,40716296,"P.S. 153 - QUEENS","60-02 60 LANE"
1,1,0,"9f53dd74-33f4-ea11-b882-24ee9a37d45c","Marble Hill High School for International Studies - X477 - X475 - 10X477 - 99 TERRACE VIEW AVENUE","9853dd74-33f4-ea11-b882-24ee9a37d45c",-73912686,40877379,"JOHN F. KENNEDY HS - X","99 TERRACE VIEW AVENUE"
1,1,0,"9fce1825-49fb-ea11-b883-24ee9a37d459","STEP ONE GROUP FAMILY DAY CARE INC - FL2 - MBPH - MBPH -  - 380 AUDOBON AVENUE","a0ce1825-49fb-ea11-b883-24ee9a37d459",-73931196,40850687,"380 AUDUBON AVENUE","380 AUDOBON AVENUE"
2,0,2,"80d93933-4cfc-ec11-b8db-24ee9a37d45c","Summer - ES_MS SUMMER RISING - K-5; 6-8 - P.S. 095 Sheila Mencher - X095 - X095 - 10X095 - 3961 HILLMAN AVENUE","34474313-33f4-ea11-b882-24ee9a37d45c",-73891664,40883049,"P.S. 95 - BRONX","3961 HILLMAN AVENUE"
1,1,0,"7e783f51-4cfc-ec11-b8db-24ee9a37d45c","Summer - CHAPTER 683 -  - P.S. 372 -The Children's School - K372 - K113 - 75K372 - 300 ADELPHI STREET","1fe85c61-30f4-ea11-b882-24ee9a37d45c",-73971474,40688769,"I.S. 113 - BROOKLYN","300 ADELPHI STREET"
1,0,1,"369ebaee-32f4-ea11-b882-24ee9a37d45c","P.S. 018 John Peter Zenger - X018 - X018 - 07X018 - 502 MORRIS AVENUE","379ebaee-32f4-ea11-b882-24ee9a37d45c",-73922697,40816369,"P.S. 18 - BRONX","502 MORRIS AVENUE"
4,4,0,"2c1d2b3f-4cfc-ec11-b8db-24ee9a37d45c","Summer - MS SUMMER RISING - 6-8 - M.S. 131 - M131 - M131 - 02M131 - 100 HESTER STREET","03cf496e-31f4-ea11-b882-24ee9a37d45c",-73993607,40716231,"I.S. 131 - MANHATTAN","100 HESTER STREET"
1,1,0,"99eb4327-4cfc-ec11-b8db-24ee9a37d45c","Summer - ES_MS SUMMER RISING - K-5; 6-8 - P.S. 128 The Lorraine Tuzzo, Juniper Valley Elementary School - Q128 - Q247 - 24Q128 - 69-10 65th Drive","2ca10a44-32f4-ea11-b882-24ee9a37d45c",-73885974,40715005,"PS/IS 128","69-10 65th Drive"
1,1,0,"10eb3215-4cfc-ec11-b8db-24ee9a37d45c","Summer - ES_MS SUMMER RISING - K-5; 6-8 - P.S. 076 A. Philip Randolph - M076 - M076 - 03M076 - 220 WEST 121 STREET","7241e65b-31f4-ea11-b882-24ee9a37d45c",-73951451,40806534,"P.S. 76 - MANHATTAN","220 WEST 121 STREET"
2,1,1,"1bff3d8d-33f4-ea11-b882-24ee9a37d45c","P.S. 070 Max Schoenfeld - X070 - X870 - 09X070 - 1691 WEEKS AVENUE","1cff3d8d-33f4-ea11-b882-24ee9a37d45c",-73908070,40844236,"P.S. 70 MINISCHOOL - BRONX","1691 WEEKS AVENUE"
2,1,1,"598d0640-0cfe-ec11-b8db-24ee9a37d45c","Summer - EXTENDED SCHOOL YEAR -  - P.S. 128 The Lorraine Tuzzo, Juniper Valley Elementary School - Q128 - Q247 - 24Q128 - 69-10 65th Drive","2ca10a44-32f4-ea11-b882-24ee9a37d45c",-73885974,40715005,"PS/IS 128","69-10 65th Drive"
1,0,1,"011d2845-4cfc-ec11-b8db-24ee9a37d45c","Summer - MS_HS SUMMER RISING - 6-8; 9-12 - Middle College High School at LaGuardia Community College - Q520 - Q520 - 24Q520 - 45-35 VAN DAM STREET","22b4977a-32f4-ea11-b882-24ee9a37d45c",-73933316,40743253,"MIDDLE COLLEGE CAMPUS - QUEENS","45-35 VAN DAM STREET"
2,1,1,"24522709-4cfc-ec11-b8db-24ee9a37d45c","Summer - ES SUMMER RISING - K-5 - P.S. 214 Michael Friedsam - K214 - K214 - 19K214 - 2944 PITKIN AVENUE","4b5bc58c-30f4-ea11-b882-24ee9a37d45c",-73862961,40675881,"P.S. 214 - BROOKLYN","2944 PITKIN AVENUE"
1,0,1,"2d767649-31f4-ea11-b882-24ee9a37d45c","P.S. 020 Anna Silver - M020 - M020 - 01M020 - 166 ESSEX STREET","2e767649-31f4-ea11-b882-24ee9a37d45c",-73986312,40721305,"P.S. 20 - MANHATTAN","166 ESSEX STREET"
2,2,0,"3f8dbfcf-30f4-ea11-b882-24ee9a37d45c","International High School at Lafayette - K337 - K400 - 21K337 - 2630 BENSON AVENUE","3a8dbfcf-30f4-ea11-b882-24ee9a37d45c",-73986313,40593028,"Lafayette Educational Campus","2630 BENSON AVENUE"
1,1,0,"de24210f-4cfc-ec11-b8db-24ee9a37d45c","Summer - ES SUMMER RISING - K-5 - P.S. 377 Alejandrina B. De Gautier - K377 - K377 - 32K377 - 200 WOODBINE STREET","11e2abc9-30f4-ea11-b882-24ee9a37d45c",-73915159,40693542,"P.S. 377 - BROOKLYN","200 WOODBINE STREET"
2,1,1,"ed207b48-4afb-ea11-b883-24ee9a37d459","Birch Family Services, Inc - MBBI - MADU -  - 554 FORT WASHINGTON AVENUE","ee207b48-4afb-ea11-b883-24ee9a37d459",-73936827,40853755,"HERBERT G. BIRCH ANNEX","554 FORT WASHINGTON AVENUE"
1,0,1,"aeeb4327-4cfc-ec11-b8db-24ee9a37d45c","Summer - ES SUMMER RISING - K-5 - P.S. 21 Margaret Emery-Elm Park - R021 - R021 - 31R021 - 168 Hooker Place","67fdc1bd-32f4-ea11-b882-24ee9a37d45c",-74144599,40631165,"P.S. 21 - STATEN ISLAND","168 Hooker Place"
2,2,0,"c8201a03-4cfc-ec11-b8db-24ee9a37d45c","Summer - ES_MS SUMMER RISING - K-5; 6-8 - East New York Middle School of Excellence - K678 - K072 - 19K678 - 605 SHEPHERD AVENUE","7e03194f-30f4-ea11-b882-24ee9a37d45c",-73879131,40669358,"P.S. 72 - BROOKLYN","605 SHEPHERD AVENUE"
1,1,0,"1e68ee1e-31f4-ea11-b882-24ee9a37d45c","P.S. 179 Kensington - K179 - K921 - 20K179 - 202 Avenue C","1f68ee1e-31f4-ea11-b882-24ee9a37d45c",-73977260,40640127,"P.S. 179 TRANSPORTABLE - K","202 Avenue C"
3,2,1,"e48a0044-33f4-ea11-b882-24ee9a37d45c","P.S. 178 - Dr. Selman Waksman - X178 - X178 - 11X178 - 850 BAYCHESTER AVENUE","e38a0044-33f4-ea11-b882-24ee9a37d45c",-73831669,40874035,"P.S. 178 - BRONX","850 BAYCHESTER AVENUE"
2,2,0,"d5201a03-4cfc-ec11-b8db-24ee9a37d45c","Summer - ES SUMMER RISING - K-5 - P.S. 115 Daniel Mucatel School - K115 - K115 - 18K115 - 1500 EAST 92 STREET","2fe85c61-30f4-ea11-b882-24ee9a37d45c",-73897896,40634861,"P.S. 115 - BROOKLYN","1500 EAST 92 STREET"
5,4,1,"2dd73d2d-4cfc-ec11-b8db-24ee9a37d45c","Summer - ES_MS SUMMER RISING - K-5; 6-8 - P.S. 083 Donald Hertz - X083 - X083 - 11X083 - 950 RHINELANDER AVENUE","4c0b210d-33f4-ea11-b882-24ee9a37d45c",-73858769,40849176,"P.S. 83 - BRONX","950 RHINELANDER AVENUE"
1,0,1,"31522709-4cfc-ec11-b8db-24ee9a37d45c","Summer - ES SUMMER RISING - K-5 - P.S. 249 The Caton - K249 - K249 - 17K249 - 18 MARLBOROUGH ROAD","9183ff9e-30f4-ea11-b882-24ee9a37d45c",-73966456,40649509,"P.S. 249 - BROOKLYN","18 MARLBOROUGH ROAD"
2,2,0,"10e2abc9-30f4-ea11-b882-24ee9a37d45c","Achievement First North Brooklyn Prep Charter School - K784 - K377 - 84K784 - 200 WOODBINE STREET","11e2abc9-30f4-ea11-b882-24ee9a37d45c",-73915159,40693542,"P.S. 377 - BROOKLYN","200 WOODBINE STREET"
1,0,1,"85c0b89e-8d3d-eb11-b88a-24ee9a37d45c","Garden of Angels family group day care - MBYC - MBYC -  - 567 West 173 Street","86c0b89e-8d3d-eb11-b88a-24ee9a37d45c",-73936725,40843814,"567 WEST 173RD STREET","567 West 173 Street"
3,3,0,"a9284621-4cfc-ec11-b8db-24ee9a37d45c","Summer - ES SUMMER RISING - K-5 - P.S. 165 Edith K. Bergtraum - Q165 - Q165 - 25Q165 - 70-35 150 Street","0b9c4c1f-32f4-ea11-b882-24ee9a37d45c",-73816966,40729746,"P.S. 165 - QUEENS","70-35 150 Street"
2,2,0,"1ceb3215-4cfc-ec11-b8db-24ee9a37d45c","Summer - ES_MS SUMMER RISING - K-5; 6-8 - P.S. 140 Nathan Straus - M140 - M140 - 01M140 - 123 RIDGE STREET","3a9f4974-31f4-ea11-b882-24ee9a37d45c",-73983769,40719148,"P.S. 140 - MANHATTAN","123 RIDGE STREET"
1,1,0,"9e284621-4cfc-ec11-b8db-24ee9a37d45c","Summer - ES SUMMER RISING - K-5 - P.S. 129 Patricia Larkin - Q129 - Q129 - 25Q129 - 128-02 7 Avenue","09af0313-32f4-ea11-b882-24ee9a37d45c",-73839505,40789926,"P.S. 129 - QUEENS","128-02 7 Avenue"
1,1,0,"af284621-4cfc-ec11-b8db-24ee9a37d45c","Summer - MS SUMMER RISING - 6-8 - J.H.S. 185 Edward Bleeker - Q185 - Q185 - 25Q185 - 147-26 25 DRIVE","ae0e6e25-32f4-ea11-b882-24ee9a37d45c",-73818607,40774906,"J.H.S. 185 - QUEENS","147-26 25 DRIVE"
1,1,0,"1bd73d2d-4cfc-ec11-b8db-24ee9a37d45c","Summer - ES_MS SUMMER RISING - K-5; 6-8 - P.S. X015 Institute for Environmental Learning - X015 - X015 - 10X015 - 2195 ANDREWS AVENUE","219ebaee-32f4-ea11-b882-24ee9a37d45c",-73909763,40859243,"P.S. 15 - BRONX","2195 ANDREWS AVENUE"
1,1,0,"bf201a03-4cfc-ec11-b8db-24ee9a37d45c","Summer - ES_MS SUMMER RISING - K-5; 6-8 - P.S. 044 Marcus Garvey - K044 - K044 - 13K044 - 432 MONROE STREET","031bad3c-30f4-ea11-b882-24ee9a37d45c",-73940859,40686213,"P.S. 44 - BROOKLYN","432 MONROE STREET"
1,1,0,"17843a63-4cfc-ec11-b8db-24ee9a37d45c","Summer - CHAPTER 683 -  - P.S. Q993 - Q993 - Q191 - 75Q993 - 85-15 258 STREET","7b977d2b-32f4-ea11-b882-24ee9a37d45c",-73708617,40734266,"P.S. 191 - QUEENS","85-15 258 STREET"
4,3,1,"18eb3215-4cfc-ec11-b8db-24ee9a37d45c","Summer - ES_MS SUMMER RISING - K-5; 6-8 - P.S. 123 Mahalia Jackson - M123 - M123 - 05M123 - 301 WEST 140 STREET","e3ce496e-31f4-ea11-b882-24ee9a37d45c",-73944551,40820216,"P.S. 123 - MANHATTAN","301 WEST 140 STREET"
1,1,0,"8f09301b-4cfc-ec11-b8db-24ee9a37d45c","Summer - ES_MS SUMMER RISING - K-5; 6-8 - The Riverside School for Makers and Artists - M191 - M342 - 03M191 - 300 WEST 61ST STREET","eae0838c-31f4-ea11-b882-24ee9a37d45c",-73990902,40772200,"P.S./I.S. 342 (RIVERSIDE CENTER) - MANHATATN","300 WEST 61ST STREET"
1,1,0,"9f284621-4cfc-ec11-b8db-24ee9a37d45c","Summer - MS SUMMER RISING - 6-8 - M.S. 137 America's School of Heroes - Q137 - Q137 - 27Q137 - 109-15 98 STREET","22af0313-32f4-ea11-b882-24ee9a37d45c",-73839377,40678112,"M.S. 137 - QUEENS","109-15 98 STREET"
1,0,1,"5bf68b86-49fb-ea11-b883-24ee9a37d459","BETZAIDA HAMBURGO - APTE - XBMQ - XBMQ -  - 1525 NELSON AVENUE","5cf68b86-49fb-ea11-b883-24ee9a37d459",-73920456,40845418,"1525 NELSON AVENUE","1525 NELSON AVENUE"
2,2,0,"9a09301b-4cfc-ec11-b8db-24ee9a37d45c","Summer - ES SUMMER RISING - K-5 - P.S. 019 Marino Jeantet - Q019 - Q019 - 24Q019 - 98-02 ROOSEVELT AVENUE","19f32ce2-31f4-ea11-b882-24ee9a37d45c",-73866557,40748600,"P.S. 19 - QUEENS","98-02 ROOSEVELT AVENUE"
2,2,0,"05eb3215-4cfc-ec11-b8db-24ee9a37d45c","Summer - ES SUMMER RISING - K-5 - P.S. 002 Meyer London - M002 - M002 - 02M002 - 122 Henry Street","77886843-31f4-ea11-b882-24ee9a37d45c",-73991523,40712907,"P.S. 2 - MANHATTAN","122 Henry Street"
1,0,1,"6ee23039-4cfc-ec11-b8db-24ee9a37d45c","Summer - MS SUMMER RISING - 6-8 - J.H.S. 223 The Montauk - K223 - K223 - 20K223 - 4200 16 AVENUE","735bc58c-30f4-ea11-b882-24ee9a37d45c",-73982424,40635100,"I.S. 223 - BROOKLYN","4200 16 AVENUE"
1,0,1,"cc92e6d5-30f4-ea11-b882-24ee9a37d45c","Brooklyn Lab School - K639 - K420 - 19K639 - 999 JAMAICA AVENUE","c692e6d5-30f4-ea11-b882-24ee9a37d45c",-73869305,40693002,"FRANKLIN K. LANE HS - K","999 JAMAICA AVENUE"
4,3,1,"66c4fc0b-4afb-ea11-b883-24ee9a37d459","Center of Excellence Springfield Gardens Preschool - QATE - QAXU -  - 127-08 MERRICK BOULEVARD","67c4fc0b-4afb-ea11-b883-24ee9a37d459",-73765117,40680891,"QUEENS VILLAGE DAY SCHOOL","127-08 MERRICK BOULEVARD"
2,1,1,"b2284621-4cfc-ec11-b8db-24ee9a37d45c","Summer - ES_MS SUMMER RISING - K-5; 6-8 - P.S./M.S. 200 - The Magnet School of Global Studies and Leadership - Q200 - Q200 - 25Q200 - 70-10 164 STREET","9469c231-32f4-ea11-b882-24ee9a37d45c",-73805759,40731070,"P.S. 200 - QUEENS","70-10 164 STREET"
4,2,2,"0eeb3215-4cfc-ec11-b8db-24ee9a37d45c","Summer - ES_MS SUMMER RISING - K-5; 6-8 - The Lexington Academy - M072 - M072 - 04M072 - 131 EAST 104 STREET","6d41e65b-31f4-ea11-b882-24ee9a37d45c",-73947450,40791444,"P.S. 72 - MANHATTAN","131 EAST 104 STREET"
1,1,0,"1e843a63-4cfc-ec11-b8db-24ee9a37d45c","Summer - CHAPTER 683 -  - P.S. Q256 - Q256 - Q253 - 75Q256 - 1307 CENTRAL AVENUE","30a10a44-32f4-ea11-b882-24ee9a37d45c",-73748799,40607247,"P.S. 253 -QUEENS","1307 CENTRAL AVENUE"
1,0,1,"96783f51-4cfc-ec11-b8db-24ee9a37d45c","Summer - CHAPTER 683 -  - P.S. K369 - Coy L. Cox School - K369 - K369 - 75K369 - 383 STATE STREET","03e2abc9-30f4-ea11-b882-24ee9a37d45c",-73983312,40687432,"P.S. 369 (COY COX SCHOOL)-K","383 STATE STREET"
1,0,1,"019275c3-49fb-ea11-b883-24ee9a37d459","ELSA BENEDITH - APT6E - XBOR - XBOR -  - 1260 WEBSTER AVENUE","029275c3-49fb-ea11-b883-24ee9a37d459",-73908434,40832888,"1260 WEBSTER AVENUE","1260 WEBSTER AVENUE"
1,1,0,"17497593-33f4-ea11-b882-24ee9a37d45c","PS/MS 20 P.O.George J. Werdann, III - X020 - X931 - 10X020 - 3020 WEBSTER AVENUE","18497593-33f4-ea11-b882-24ee9a37d45c",-73878731,40869482,"P.S. 20 TEMP. C.R. BLDG. - X","3020 WEBSTER AVENUE"
2,2,0,"a109301b-4cfc-ec11-b8db-24ee9a37d45c","Summer - ES SUMMER RISING - K-5 - P.S. 040 Samuel Huntington - Q040 - Q040 - 28Q040 - 109-20 Union Hall Street","dd8442ee-31f4-ea11-b882-24ee9a37d45c",-73790975,40693559,"P.S. 40 (D28) - QUEENS","109-20 Union Hall Street"
1,1,0,"0dd73d2d-4cfc-ec11-b8db-24ee9a37d45c","Summer - ES SUMMER RISING - K-5 - P.S. 055 Henry M. Boehm - R055 - R055 - 31R055 - 54 OSBORNE STREET","3b0410ca-32f4-ea11-b882-24ee9a37d45c",-74163037,40536625,"P.S. 55 - STATEN ISLAND","54 OSBORNE STREET"
1,0,1,"fd1c2845-4cfc-ec11-b8db-24ee9a37d45c","Summer - HS SUMMER RISING - 9-12 - Richmond Hill High School - Q475 - Q475 - 27Q475 - 89-30 114 Street","3002926e-32f4-ea11-b882-24ee9a37d45c",-73833815,40695171,"RICHMOND HILL HS - Q","89-30 114 Street"
1,1,0,"e324210f-4cfc-ec11-b8db-24ee9a37d45c","Summer - ES SUMMER RISING - K-5 - P.S. 130 The Parkside - K130 - K437 - 15K130 - 713 CATON AVENUE","4488e6db-30f4-ea11-b882-24ee9a37d45c",-73973363,40647598,"P.S./I.S. 437 - BROOKLYN","713 CATON AVENUE"
1,0,1,"8bda0c46-0cfe-ec11-b8db-24ee9a37d45c","Summer - DREAM -  - Dream Program - M359 - Q620 - 93M359 - 165-65 84 AVENUE","49b4977a-32f4-ea11-b882-24ee9a37d45c",-73799692,40716071,"THOMAS A. EDISON VOC HS - Q","165-65 84 AVENUE"
1,0,1,"9509301b-4cfc-ec11-b8db-24ee9a37d45c","Summer - ES_MS SUMMER RISING - K-5; 6-8 - I.S. 5 - The Walter Crowley Intermediate School - Q005 - Q005 - 24Q005 - 50-40 JACOBUS STREET","9adc32dc-31f4-ea11-b882-24ee9a37d45c",-73888133,40737405,"I.S. 5 - QUEENS","50-40 JACOBUS STREET"
2,2,0,"a709301b-4cfc-ec11-b8db-24ee9a37d45c","Summer - MS SUMMER RISING - 6-8 - J.H.S. 067 Louis Pasteur - Q067 - Q067 - 26Q067 - 51-60 MARATHON PARKWAY","732f77fa-31f4-ea11-b882-24ee9a37d45c",-73734832,40762241,"J.H.S. 67 - QUEENS","51-60 MARATHON PARKWAY"
1,0,1,"bb48b1f5-eaf6-ea11-b883-24ee9a37d459","School for Cooperative Technical Education - M645 - M646 - 79M645 - 321 East 96 Street","5e0c1bb1-31f4-ea11-b882-24ee9a37d45c",-73945647,40784112,"SCL COOP TECH ED (MNH VOC HS) - M","321 East 96 Street"
6,6,0,"cf201a03-4cfc-ec11-b8db-24ee9a37d45c","Summer - ES SUMMER RISING - K-5 - P.S. 105 The Blythebourne - K105 - K105 - 20K105 - 1031 59 STREET","e00d3c5b-30f4-ea11-b882-24ee9a37d45c",-74003635,40633320,"P.S. 105 - BROOKLYN","1031 59 STREET"
2,2,0,"1a522709-4cfc-ec11-b8db-24ee9a37d45c","Summer - ES SUMMER RISING - K-5 - P.S. 186 Dr. Irving A Gladstone - K186 - K186 - 20K186 - 7601 19 AVENUE","d2b36d80-30f4-ea11-b882-24ee9a37d45c",-73994258,40610917,"P.S. 186 - BROOKLYN","7601 19 AVENUE"
2,2,0,"eb893969-4cfc-ec11-b8db-24ee9a37d45c","Summer - CHAPTER 683 -  - P.S. X811 - X811 - X084 - 75X811 - 1434 Longfellow Avenue","490b210d-33f4-ea11-b882-24ee9a37d45c",-73886798,40830552,"P.S. 811 (OLD I84) - BRONX","1434 Longfellow Avenue"
1,0,1,"41de261e-4afb-ea11-b883-24ee9a37d459","NEW LIFE DAYCARE CENTER- SITE 2 - KBSC - KBSC -  - 406-408 GROVE STREET","42de261e-4afb-ea11-b883-24ee9a37d459",-73912224,40701464,"New Life Child Development Center 2-3","406-408 GROVE STREET"
2,0,2,"98d93933-4cfc-ec11-b8db-24ee9a37d45c","Summer - MS SUMMER RISING - 6-8 - M.S. 180 Dr. Daniel Hale Williams - X180 - X180 - 11X180 - 700 BAYCHESTER AVENUE","ea8a0044-33f4-ea11-b882-24ee9a37d45c",-73831669,40874035,"I.S. 180 - BRONX","700 BAYCHESTER AVENUE"
3,2,1,"1604d718-31f4-ea11-b882-24ee9a37d45c","P.S. 189 The Bilingual Center - K189 - K889 - 17K189 - 1100 EAST NEW YORK AVENUE","1704d718-31f4-ea11-b882-24ee9a37d45c",-73925435,40665228,"P.S. 189 MINISCHOOL - BROOKLYN","1100 EAST NEW YORK AVENUE"
1,1,0,"92d93933-4cfc-ec11-b8db-24ee9a37d45c","Summer - ES SUMMER RISING - K-5 - P.S. 146 Edward Collins - X146 - X146 - 08X146 - 968 CAULDWELL AVENUE","a5bfa431-33f4-ea11-b882-24ee9a37d45c",-73905734,40824717,"P.S. 146 - BRONX","968 CAULDWELL AVENUE"
1,0,1,"22eb3215-4cfc-ec11-b8db-24ee9a37d45c","Summer - ES_MS SUMMER RISING - K-5; 6-8 - P.S. 155 William Paca - M155 - M155 - 04M155 - 319 EAST 117 STREET","15005d7a-31f4-ea11-b882-24ee9a37d45c",-73935895,40797507,"P.S. 155 - MANHATTAN","319 EAST 117 STREET"
2,2,0,"a1284621-4cfc-ec11-b8db-24ee9a37d45c","Summer - MS SUMMER RISING - 6-8 - I.S. 141 The Steinway - Q141 - Q141 - 30Q141 - 37-11 21 AVENUE","ca883319-32f4-ea11-b882-24ee9a37d45c",-73904508,40775766,"I.S. 141 - QUEENS","37-11 21 AVENUE"
2,2,0,"bf95e8fc-4bfc-ec11-b8db-24ee9a37d45c","Summer - ES SUMMER RISING - K-5 - P.S. 018 Edward Bush - K018 - K018 - 14K018 - 101 MAUJER STREET","d4968d36-30f4-ea11-b882-24ee9a37d45c",-73946695,40710880,"P.S. 18 - BROOKLYN","101 MAUJER STREET"
1,0,1,"fd11a0be-ebf6-ea11-b883-24ee9a37d459","P.S.187 - Q187 - Q811 -  - 61-25 MARATHON PARKWAY","08bef08c-32f4-ea11-b882-24ee9a37d45c",-73728412,40756481,"P.S. 811 (OLD 187) - QUEENS","61-25 MARATHON PARKWAY"
1,0,1,"e5893969-4cfc-ec11-b8db-24ee9a37d45c","Summer - CHAPTER 683 -  - P.S. X188 - X188 - X034 - 75X188 - 770 GROTE STREET","fa02cefa-32f4-ea11-b882-24ee9a37d45c",-73883877,40850168,"P.S. 34 - BRONX","770 GROTE STREET"
1,1,0,"f4aeb707-ecf6-ea11-b883-24ee9a37d459","Passages Academy - X695 - X824 - 79X695 - 108 WEST 174 STREET","75593c87-33f4-ea11-b882-24ee9a37d45c",-73918314,40846755,"Bronx Hope- BRONX","108 WEST 174 STREET"
1,1,0,"88d93933-4cfc-ec11-b8db-24ee9a37d45c","Summer - MS SUMMER RISING - 6-8 - Academy For Personal Leadership And Excellence - X363 - X115 - 10X363 - 120 EAST 184 STREET","5b0d6d19-33f4-ea11-b882-24ee9a37d45c",-73900490,40859496,"I.S. 399 (OLD X HS/X115) - BRONX","120 EAST 184 STREET"
1,0,1,"43f68b86-49fb-ea11-b883-24ee9a37d459","CELIA FERNANDEZ DE SURIEL - APTB6 - XBFR - XBFR -  - 2415 DAVIDSON AVE","44f68b86-49fb-ea11-b883-24ee9a37d459",-73903126,40862049,"2415 DAVIDSON AVENUE","2415 DAVIDSON AVE"
1,1,0,"f91c2845-4cfc-ec11-b8db-24ee9a37d45c","Summer - MS_HS SUMMER RISING - 6-8; 9-12 - William Cullen Bryant High School - Q445 - Q445 - 30Q445 - 48-10 31 AVENUE","d8b66262-32f4-ea11-b882-24ee9a37d45c",-73911165,40757072,"WILLIAM C. BRYANT HS - Q","48-10 31 AVENUE"
1,1,0,"11025a42-4afb-ea11-b883-24ee9a37d459","EAST HARLEM BILINGUAL HEAD START - MAWG - MAWG -  - 440 EAST 116TH STREET","12025a42-4afb-ea11-b883-24ee9a37d459",-73933961,40795006,"EAST HARLEM COUNCIL FOR HUMAN SERVICES SITE 1","440 EAST 116TH STREET"
1,0,1,"ca893969-4cfc-ec11-b8db-24ee9a37d45c","Summer - CHAPTER 683 -  - P.S. Q023 @ Queens Children Center - Q023 - QAPM - 75Q023 - 74-03 COMMONWEALTH BOULEVARD","419215a5-32f4-ea11-b882-24ee9a37d45c",-73723644,40747914,"Queens Children's Center","74-03 COMMONWEALTH BOULEVARD"
2,1,1,"2f45378b-4afb-ea11-b883-24ee9a37d459","Habitot Es - XAHA - XAJQ -  - 3480 Third Avenue","3045378b-4afb-ea11-b883-24ee9a37d459",-73906235,40830177,"Third Avenue ECC","3480 Third Avenue"
1,1,0,"020ae2e1-30f4-ea11-b882-24ee9a37d45c","Boys and Girls High School - K455 - K456 - 16K455 - 1700 FULTON STREET","030ae2e1-30f4-ea11-b882-24ee9a37d45c",-73931604,40678478,"BOYS & GIRLS AF - BROOKLYN","1700 FULTON STREET"
2,1,1,"9109301b-4cfc-ec11-b8db-24ee9a37d45c","Summer - ES_MS SUMMER RISING - K-5; 6-8 - Washington Heights Expeditionary Learning School - M348 - M528 - 06M348 - 180 WADSWORTH AVENUE","ed37fba4-31f4-ea11-b882-24ee9a37d45c",-73934676,40850683,"I.S. 528 - MANHATTAN","180 WADSWORTH AVENUE"
1,0,1,"ee37fba4-31f4-ea11-b882-24ee9a37d45c","I.S. 528 Bea Fuller Rodgers School - M528 - M528 - 06M528 - 180 WADSWORTH AVENUE","ed37fba4-31f4-ea11-b882-24ee9a37d45c",-73934676,40850683,"I.S. 528 - MANHATTAN","180 WADSWORTH AVENUE"
1,1,0,"c2201a03-4cfc-ec11-b8db-24ee9a37d45c","Summer - ES SUMMER RISING - K-5 - P.S. 048 Mapleton - K048 - K048 - 20K048 - 6015 18 AVENUE","16eabc42-30f4-ea11-b882-24ee9a37d45c",-73987165,40621481,"P.S. 48 - BROOKLYN","6015 18 AVENUE"
3,2,1,"21522709-4cfc-ec11-b8db-24ee9a37d45c","Summer - ES SUMMER RISING - K-5 - P.S. 205 Clarion - K205 - K205 - 20K205 - 6701 20 AVENUE","11ba8b86-30f4-ea11-b882-24ee9a37d45c",-73986792,40614737,"P.S. 205 - BROOKLYN","6701 20 AVENUE"
1,0,1,"98c0204b-4cfc-ec11-b8db-24ee9a37d45c","Summer - MS SUMMER RISING - 6-8 - Kappa - X215 - X148 - 09X215 - 3630 THIRD AVENUE","b0bfa431-33f4-ea11-b882-24ee9a37d45c",-73903951,40833493,"I.S. 219 (OLD 148) - BRONX","3630 THIRD AVENUE"
1,1,0,"a909301b-4cfc-ec11-b8db-24ee9a37d45c","Summer - ES SUMMER RISING - K-5 - P.S. 076 William Hallet - Q076 - Q076 - 30Q076 - 36-36 10 Street","d2e8ce00-32f4-ea11-b882-24ee9a37d45c",-73941630,40760862,"P.S. 76 - QUEENS","36-36 10 Street"
1,0,1,"be95e8fc-4bfc-ec11-b8db-24ee9a37d45c","Summer - ES_MS SUMMER RISING - K-5; 6-8 - Conselyea Preparatory School - K577 - K017 - 14K577 - 208 NORTH 5 STREET","cc968d36-30f4-ea11-b882-24ee9a37d45c",-73957300,40715268,"P.S. 17 - BROOKLYN","208 NORTH 5 STREET"
1,0,1,"94783f51-4cfc-ec11-b8db-24ee9a37d45c","Summer - CHAPTER 683 -  - P.S. K369 - Coy L. Cox School - K369 - K317 - 75K369 - 610 BALTIC STREET","99e657bd-30f4-ea11-b882-24ee9a37d45c",-73980455,40679916,"P.S. 133 WILLIAM A. BUTLER - BROOKLYN","610 BALTIC STREET"
1,1,0,"361d2b3f-4cfc-ec11-b8db-24ee9a37d45c","Summer - HS SUMMER RISING - 9-12 - Fiorello H. LaGuardia High School of Music & Art and Performing Arts - M485 - M485 - 03M485 - 100 Amsterdam Avenue","7207e99e-31f4-ea11-b882-24ee9a37d45c",-73985976,40774202,"FIORELLO LAGUARDIA HS - MANHATTAN","100 Amsterdam Avenue"
1,1,0,"2ad73d2d-4cfc-ec11-b8db-24ee9a37d45c","Summer - ES SUMMER RISING - K-5 - P.S. 072 Dr. William Dorney - X072 - X072 - 08X072 - 2951 DEWEY AVENUE","f4d10307-33f4-ea11-b882-24ee9a37d45c",-73818172,40823237,"P.S. 72 - BRONX","2951 DEWEY AVENUE"
1,0,1,"172fe80a-6ed5-ec11-b8d7-24ee9a37d45c","ESTHER FAMILY DAY CARE - 207 - XCHU - XCHU -  - 945 Underhill Avenue","182fe80a-6ed5-ec11-b8d7-24ee9a37d45c",-73860866,40824627,"945 UNDERHILL AVENUE","945 Underhill Avenue"
1,1,0,"8b783f51-4cfc-ec11-b8db-24ee9a37d45c","Summer - CHAPTER 683 -  - P.S. K231 - K231 - K238 - 75K231 - 1633 EAST 8 STREET","65a5db98-30f4-ea11-b882-24ee9a37d45c",-73964586,40608801,"P.S. 238 - BROOKLYN","1633 EAST 8 STREET"
4,4,0,"a4c0204b-4cfc-ec11-b8db-24ee9a37d45c","Summer - HS SUMMER RISING - 9-12 - Pan American International High School at Monroe - X388 - X420 - 12X388 - 1300 BOYNTON AVENUE","519d7c62-33f4-ea11-b882-24ee9a37d45c",-73878191,40832508,"JAMES MONROE EDUCATIONAL CAMPUS - X","1300 BOYNTON AVENUE"
1,0,1,"dd92e6d5-30f4-ea11-b882-24ee9a37d45c","Spring Creek Community School - K422 - K422 - 19K422 - 1065 Elton Street","da92e6d5-30f4-ea11-b882-24ee9a37d45c",-73874064,40657266,"SPRING CREEK EDUCATIONAL CAMPUS - BROOKLYN","1065 Elton Street"
1,0,1,"ed54a20f-8f3d-eb11-b88a-24ee9a37d45c","Alma C. Rodriguez Morales - QCDD - QCDD -  - 31-18 96 Street","ee54a20f-8f3d-eb11-b88a-24ee9a37d45c",-73872797,40760069,"Alma C. Rodriguez Morales","31-18 96 Street"
1,0,1,"05025a42-4afb-ea11-b883-24ee9a37d459","Imagine@ VetsKids - MANG - MASW -  - 423 EAST 23RD STREET","06025a42-4afb-ea11-b883-24ee9a37d459",-73977734,40736478,"Imagine@ VetsKids","423 EAST 23RD STREET"
1,1,0,"cb201a03-4cfc-ec11-b8db-24ee9a37d45c","Summer - ES_MS SUMMER RISING - K-5; 6-8 - P.S. 084 Jose De Diego - K084 - K084 - 14K084 - 250 Berry Street","6ed92255-30f4-ea11-b882-24ee9a37d45c",-73963808,40715089,"P.S. 84 - BROOKLYN","250 Berry Street"
1,1,0,"88c1797b-ebf6-ea11-b883-24ee9a37d459","Restart Academy - M973 - MAKG -  - 411 WEST 114 STREET","8a3eb8c9-31f4-ea11-b882-24ee9a37d45c",-73960923,40805305,"CARES","411 WEST 114 STREET"
1,1,0,"0a2ed53d-33f4-ea11-b882-24ee9a37d45c","Grant Avenue Elementary School - X449 - X166 - 09X449 - 250 EAST 164 STREET","0b2ed53d-33f4-ea11-b882-24ee9a37d45c",-73917705,40828009,"I.S. 166 - BRONX","250 EAST 164 STREET"
1,0,1,"23eb3215-4cfc-ec11-b8db-24ee9a37d45c","Summer - ES_MS SUMMER RISING - K-5; 6-8 - P.S. 161 Pedro Albizu Campos - M161 - M161 - 05M161 - 499 WEST 133 STREET","22005d7a-31f4-ea11-b882-24ee9a37d45c",-73952476,40817719,"P.S. 161 - MANHATTAN","499 WEST 133 STREET"
4,3,1,"16522709-4cfc-ec11-b8db-24ee9a37d45c","Summer - ES_MS SUMMER RISING - K-5; 6-8 - P.S. 178 Saint Clair Mckelway - K178 - K178 - 23K178 - 2163 DEAN STREET","0cd1de79-30f4-ea11-b882-24ee9a37d45c",-73915337,40675380,"P.S. 178 - BROOKLYN","2163 DEAN STREET"
1,1,0,"6fe9a5af-4afb-ea11-b883-24ee9a37d459","Kingsbridge Heights Community Center - XALV - XASJ -  - 295 WEST 231 STREET","70e9a5af-4afb-ea11-b883-24ee9a37d459",-73908163,40880706,"Kingsbridge Innovative Design Charter School","295 WEST 231 STREET"
1,0,1,"f23b3857-4cfc-ec11-b8db-24ee9a37d45c","Summer - CHAPTER 683 -  - P.S. M169 - Robert F. Kennedy - M169 - M146 - 75M169 - 421 EAST 106 STREET","4f9f4974-31f4-ea11-b882-24ee9a37d45c",-73938727,40789535,"P.S. 146 - MANHATTAN","421 EAST 106 STREET"
1,1,0,"2fd73d2d-4cfc-ec11-b8db-24ee9a37d45c","Summer - ES_MS SUMMER RISING - K-5; 6-8 - P.S. 086 Kingsbridge Heights - X086 - X086 - 10X086 - 2756 RESERVOIR AVENUE","19474313-33f4-ea11-b882-24ee9a37d45c",-73897066,40869061,"P.S. 86 - BRONX","2756 RESERVOIR AVENUE"
5,3,2,"c4201a03-4cfc-ec11-b8db-24ee9a37d45c","Summer - MS SUMMER RISING - 6-8 - M.S. 061 Dr. Gladstone H. Atwell - K061 - K061 - 17K061 - 400 EMPIRE BOULEVARD","bd79df48-30f4-ea11-b882-24ee9a37d45c",-73949198,40663605,"I.S. 61 - BROOKLYN","400 EMPIRE BOULEVARD"
3,1,2,"19eb3215-4cfc-ec11-b8db-24ee9a37d45c","Summer - ES SUMMER RISING - K-5 - P.S. 128 Audubon - M128 - M128 - 06M128 - 560 WEST 169 STREET","f9ce496e-31f4-ea11-b882-24ee9a37d45c",-73938701,40841032,"P.S. 128 - MANHATTAN","560 WEST 169 STREET"
5,5,0,"9ceb4327-4cfc-ec11-b8db-24ee9a37d45c","Summer - ES_MS SUMMER RISING - K-5; 6-8 - P.S./I.S. 266 - Q266 - Q266 - 26Q266 - 74-10 COMMONWEALTH BOULEVARD","4aa10a44-32f4-ea11-b882-24ee9a37d45c",-73728415,40746128,"P.S./I.S. 266 - QUEENS","74-10 COMMONWEALTH BOULEVARD"
1,1,0,"56275a30-4afb-ea11-b883-24ee9a37d459","BROOKLYN CHINESE AMERICAN ASSOCIATION - KBMM - KBMM -  - 812 54TH STREET","57275a30-4afb-ea11-b883-24ee9a37d459",-74005822,40638466,"BROOKLYN CHINESE AMERICAN ASSOCIATION","812 54TH STREET"
1,0,1,"69e4d766-4afb-ea11-b883-24ee9a37d459","Urban Concepts/Round the Clock - MBFX - MBFX -  - 300 W. 145 Street","6ae4d766-4afb-ea11-b883-24ee9a37d459",-73942071,40822892,"Urban Concepts of NY/Round the Clock Nursery Inc.","300 W. 145 Street"
1,0,1,"10d73d2d-4cfc-ec11-b8db-24ee9a37d45c","Summer - ES SUMMER RISING - K-5 - Space Shuttle Columbia School - R058 - R058 - 31R058 - 77 MARSH AVENUE","2a0410ca-32f4-ea11-b882-24ee9a37d45c",-74160867,40582791,"P.S. 58 - STATEN ISLAND","77 MARSH AVENUE"
1,0,1,"33522709-4cfc-ec11-b8db-24ee9a37d45c","Summer - ES SUMMER RISING - K-5 - P.S. 257 John F. Hylan - K257 - K257 - 14K257 - 60 COOK STREET","ad83ff9e-30f4-ea11-b882-24ee9a37d45c",-73941345,40702759,"P.S. 257 - BROOKLYN","60 COOK STREET"
1,1,0,"818d8486-31f4-ea11-b882-24ee9a37d45c","P.S. 77 Lower Lab School - M077 - M198 - 02M077 - 1700 3 AVENUE","7f8d8486-31f4-ea11-b882-24ee9a37d45c",-73950420,40785018,"P.S. 198 - MANHATTAN","1700 3 AVENUE"
2,2,0,"ac284621-4cfc-ec11-b8db-24ee9a37d45c","Summer - MS SUMMER RISING - 6-8 - Irwin Altman Middle School 172 - Q172 - Q172 - 26Q172 - 81-14 257 Street","8d0e6e25-32f4-ea11-b882-24ee9a37d45c",-73713245,40741409,"J.H.S. 172 - QUEENS","81-14 257 Street"
1,0,1,"a0c0204b-4cfc-ec11-b8db-24ee9a37d45c","Summer - MS_HS SUMMER RISING - 6-8; 9-12 - In-Tech Academy (M.S. / High School 368) - X368 - X368 - 10X368 - 2975 TIBBETT AVENUE","74e03d56-33f4-ea11-b882-24ee9a37d45c",-73913694,40877935,"M.S./H.S. 368 - BRONX","2975 TIBBETT AVENUE"
1,0,1,"8ec0204b-4cfc-ec11-b8db-24ee9a37d45c","Summer - HS SUMMER RISING - 9-12 - Cambria Heights Academy - Q326 - Q799 - 29Q326 - 188-04 91st Avenue","03bef08c-32f4-ea11-b882-24ee9a37d45c",-73771196,40711857,"CAMBRIA HEIGHTS ACADEMY - QUEENS","188-04 91st Avenue"
