"TotalCases","StudentCases","EmployeeCases","nycsr_locationsiteid","nycsr_sitename","nycsr_building.nycsr_buildingid","nycsr_building.nycsr_longitude","nycsr_building.nycsr_latitude","nycsr_building.nycsr_buildingname","nycsr_building.nycsr_address"
8,5,3,"46b4977a-32f4-ea11-b882-24ee9a37d45c","Aviation Career & Technical Education High School - Q610 - Q610 - 24Q610 - 45-30 36 STREET","44b4977a-32f4-ea11-b882-24ee9a37d45c",-73929577,40743309,"AVIATION HS - Q","45-30 36 STREET"
1,1,0,"1c005d7a-31f4-ea11-b882-24ee9a37d45c","Yorkville East Middle School - M177 - M158 - 02M177 - 1458 YORK AVENUE","1d005d7a-31f4-ea11-b882-24ee9a37d45c",-73950745,40770215,"P.S. 158 - MANHATTAN","1458 YORK AVENUE"
5,5,0,"6c977d2b-32f4-ea11-b882-24ee9a37d45c","P.S. 188 Kingsbury - Q188 - Q188 - 26Q188 - 218-12 HARTLAND AVENUE","6d977d2b-32f4-ea11-b882-24ee9a37d45c",-73753985,40736063,"P.S. 188 - QUEENS","218-12 HARTLAND AVENUE"
6,4,2,"8c886843-31f4-ea11-b882-24ee9a37d45c","P.S. 006 Lillie D. Blake - M006 - M006 - 02M006 - 45 EAST 81 STREET","8d886843-31f4-ea11-b882-24ee9a37d45c",-73960427,40777737,"P.S. 6 - MANHATTAN","45 EAST 81 STREET"
1,1,0,"cf2ff20c-32f4-ea11-b882-24ee9a37d45c","P.S./I.S. 116 William C. Hughley - Q116 - Q116 - 29Q116 - 107-25 WREN PLACE","d02ff20c-32f4-ea11-b882-24ee9a37d45c",-73781839,40700840,"P.S. 116 - QUEENS","107-25 WREN PLACE"
4,3,1,"c98442ee-31f4-ea11-b882-24ee9a37d45c","P.S. 032 State Street - Q032 - Q032 - 25Q032 - 171-11 35 AVENUE","ca8442ee-31f4-ea11-b882-24ee9a37d45c",-73794323,40765459,"P.S. 32 - QUEENS","171-11 35 AVENUE"
3,0,3,"7ef4a0ef-eaf6-ea11-b883-24ee9a37d459","P.S. K721 - Brooklyn Occupational Training Center - K721 - K722 - 75K721 - 64 AVENUE X","392f7d06-31f4-ea11-b882-24ee9a37d45c",-73981925,40588070,"P.S. 721 OTC - BROOKLYN","64 AVENUE X"
3,2,1,"3c9f4974-31f4-ea11-b882-24ee9a37d45c","P.S. 142 Amalia Castro - M142 - M142 - 01M142 - 100 ATTORNEY STREET","379f4974-31f4-ea11-b882-24ee9a37d45c",-73984116,40718121,"P.S. 142 - MANHATTAN","100 ATTORNEY STREET"
3,0,3,"dde0a4fb-ebf6-ea11-b883-24ee9a37d459","P.S. X010 - X010 - X234 - 75X010 - 2050 PROSPECT AVENUE","d4ab074a-33f4-ea11-b882-24ee9a37d45c",-73886721,40846128,"P.S. 234 (PAIRED W I129) - BRONX","2050 PROSPECT AVENUE"
2,0,2,"e9e13320-ebf6-ea11-b883-24ee9a37d459","P.S. 36 - K036 - K192 - 75K036 - 4715 18 AVENUE","e5b36d80-30f4-ea11-b882-24ee9a37d45c",-73979540,40628800,"P.S. 192 - BROOKLYN","4715 18 AVENUE"
1,0,1,"8f53dd74-33f4-ea11-b882-24ee9a37d45c","Eagle Academy for Young Men - X231 - X465 - 09X231 - 4143 Third Avenue","8b53dd74-33f4-ea11-b882-24ee9a37d45c",-73897479,40845366,"Eagle Academy For Young Men - Bronx","4143 Third Avenue"
5,0,5,"167eed06-32f4-ea11-b882-24ee9a37d45c","P.S. 088 Seneca - Q088 - Q088 - 24Q088 - 60-85 CATALPA AVENUE","177eed06-32f4-ea11-b882-24ee9a37d45c",-73896437,40704105,"P.S. 88 - QUEENS","60-85 CATALPA AVENUE"
1,1,0,"4be61462-31f4-ea11-b882-24ee9a37d45c","M.S. 224 Manhattan East School for Arts & Academics - M224 - M099 - 04M224 - 410 EAST 100 STREET","3de61462-31f4-ea11-b882-24ee9a37d45c",-73942154,40785107,"I.S. 99 - MANHATTAN","410 EAST 100 STREET"
6,4,2,"10b7c337-32f4-ea11-b882-24ee9a37d45c","P.S. 221 The North Hills School - Q221 - Q221 - 26Q221 - 57-40 MARATHON PARKWAY","11b7c337-32f4-ea11-b882-24ee9a37d45c",-73731518,40758808,"P.S. 221 - QUEENS","57-40 MARATHON PARKWAY"
1,0,1,"dca2f813-ebf6-ea11-b883-24ee9a37d459","The Joan Snow Pre-K Center - K853 - K063 - 22K853 - 1340 EAST 29TH STREET","c879df48-30f4-ea11-b882-24ee9a37d45c",-73946330,40618450,"PRE-K CENTER @1340 EAST 29TH STREET - BROOKLYN","1340 EAST 29TH STREET"
2,1,1,"35ebaa73-30f4-ea11-b882-24ee9a37d45c","P.S. 164 Caesar Rodney - K164 - K164 - 20K164 - 4211 14 AVENUE","36ebaa73-30f4-ea11-b882-24ee9a37d45c",-73985739,40637101,"P.S. 164 - BROOKLYN","4211 14 AVENUE"
1,0,1,"d685f462-ebf6-ea11-b883-24ee9a37d459","P.S. M811 - Mickey Mantle School - M811 - M200 - 75M811 - 2589 7 AVENUE","848d8486-31f4-ea11-b882-24ee9a37d45c",-73935746,40823988,"P.S. 200 (TANDEM M010) - MANHATTAN","2589 7 AVENUE"
2,1,1,"54ebaa73-30f4-ea11-b882-24ee9a37d45c","P.S. 169 Sunset Park - K169 - K169 - 15K169 - 4305 7 AVENUE","55ebaa73-30f4-ea11-b882-24ee9a37d45c",-74001700,40645825,"P.S. 169 - BROOKLYN","4305 7 AVENUE"
4,2,2,"4e767649-31f4-ea11-b882-24ee9a37d45c","P.S. 040 Augustus Saint-Gaudens - M040 - M040 - 02M040 - 320 EAST 20TH STREET","46767649-31f4-ea11-b882-24ee9a37d45c",-73981536,40735328,"P.S. 40 - MANHATTAN","320 EAST 20TH STREET"
1,1,0,"9f53dd74-33f4-ea11-b882-24ee9a37d45c","Marble Hill High School for International Studies - X477 - X475 - 10X477 - 99 TERRACE VIEW AVENUE","9853dd74-33f4-ea11-b882-24ee9a37d45c",-73912686,40877379,"JOHN F. KENNEDY HS - X","99 TERRACE VIEW AVENUE"
1,0,1,"24a198c3-30f4-ea11-b882-24ee9a37d45c","The Brooklyn Green School - K898 - K335 - 16K898 - 130 Rochester Avenue","1ea198c3-30f4-ea11-b882-24ee9a37d45c",-73928673,40674491,"P.S. 335 - BROOKLYN","130 Rochester Avenue"
2,2,0,"45767649-31f4-ea11-b882-24ee9a37d45c","M.S. 255 Salk School of Science - M255 - M040 - 02M255 - 320 EAST 20TH STREET","46767649-31f4-ea11-b882-24ee9a37d45c",-73981536,40735328,"P.S. 40 - MANHATTAN","320 EAST 20TH STREET"
5,5,0,"02fc3df4-30f4-ea11-b882-24ee9a37d45c","Leon M. Goldstein High School for the Sciences - K535 - K535 - 22K535 - 1830 SHORE BOULEVARD","01fc3df4-30f4-ea11-b882-24ee9a37d45c",-73934449,40578356,"LEON GOLDSTEIN HS - BROOKLYN","1830 SHORE BOULEVARD"
4,2,2,"d1d27c6d-30f4-ea11-b882-24ee9a37d45c","The Brooklyn New School, P.S. 146 - K146 - K142 - 15K146 - 610 HENRY STREET","cfd27c6d-30f4-ea11-b882-24ee9a37d45c",-74002022,40679462,"J.H.S. 142 - BROOKLYN","610 HENRY STREET"
4,3,1,"8c0e6e25-32f4-ea11-b882-24ee9a37d45c","Irwin Altman Middle School 172 - Q172 - Q172 - 26Q172 - 81-14 257 Street","8d0e6e25-32f4-ea11-b882-24ee9a37d45c",-73713245,40741409,"J.H.S. 172 - QUEENS","81-14 257 Street"
4,1,3,"cd315367-30f4-ea11-b882-24ee9a37d45c","P.S. 127 Mckinley Park - K127 - K127 - 20K127 - 7805 7 Avenue","ce315367-30f4-ea11-b882-24ee9a37d45c",-74018429,40623687,"P.S. 127 - BROOKLYN","7805 7 Avenue"
1,0,1,"ede13320-ebf6-ea11-b883-24ee9a37d459","P.S. 36 - K036 - K213 - 75K036 - 580 HEGEMAN AVENUE","435bc58c-30f4-ea11-b882-24ee9a37d45c",-73889968,40659845,"P.S. 213 - BROOKLYN","580 HEGEMAN AVENUE"
2,0,2,"2806003e-32f4-ea11-b882-24ee9a37d45c","P.S. 239 - Q239 - Q239 - 24Q239 - 17-15 WEIRFIELD STREET","2606003e-32f4-ea11-b882-24ee9a37d45c",-73903838,40699431,"P.S. 239 - QUEENS","17-15 WEIRFIELD STREET"
1,0,1,"14a198c3-30f4-ea11-b882-24ee9a37d45c","P.S. K231 - K231 - K331 - 75K231 - 7002 4TH AVENUE","15a198c3-30f4-ea11-b882-24ee9a37d45c",-74023950,40633598,"P.S./I.S.30 MARY WHITE OVINGTON - BROOKLYN","7002 4TH AVENUE"
3,1,2,"da9b4c1f-32f4-ea11-b882-24ee9a37d45c","P.S. 151 Mary D. Carter - Q151 - Q151 - 30Q151 - 50-05 31 AVENUE","db9b4c1f-32f4-ea11-b882-24ee9a37d45c",-73908146,40758027,"P.S. 151 - QUEENS","50-05 31 AVENUE"
1,0,1,"b7b36d80-30f4-ea11-b882-24ee9a37d45c","P.S. K231 - K231 - K180 - 75K231 - 5601 16 AVENUE","b8b36d80-30f4-ea11-b882-24ee9a37d45c",-73989250,40626454,"P.S. 180 - BROOKLYN","5601 16 AVENUE"
8,2,6,"a732c3fb-eaf6-ea11-b883-24ee9a37d459","P.S. Q177 - Q177 - Q177 - 75Q177 - 56-37 188 STREET","8b0e6e25-32f4-ea11-b882-24ee9a37d45c",-73787419,40743400,"P.S. 177 - QUEENS","56-37 188 STREET"
5,2,3,"dd9b4c1f-32f4-ea11-b882-24ee9a37d45c","P.S. 152 Gwendoline N. Alleyne School - Q152 - Q152 - 30Q152 - 33-52 62 STREET","de9b4c1f-32f4-ea11-b882-24ee9a37d45c",-73900584,40753094,"P.S. 152 - QUEENS","33-52 62 STREET"
1,0,1,"91d810ab-31f4-ea11-b882-24ee9a37d45c","A. Philip Randolph Campus High School - M540 - M540 - 06M540 - 443 WEST 135 STREET","90d810ab-31f4-ea11-b882-24ee9a37d45c",-73949929,40818500,"A. PHILLIP RANDOLPH HS - MANHATTAN","443 WEST 135 STREET"
1,0,1,"2d0b210d-33f4-ea11-b882-24ee9a37d45c","P.S. 078 Anne Hutchinson - X078 - X078 - 11X078 - 1400 NEEDHAM AVENUE","2e0b210d-33f4-ea11-b882-24ee9a37d45c",-73850563,40878474,"P.S. 78 - BRONX","1400 NEEDHAM AVENUE"
3,1,2,"fc1aad3c-30f4-ea11-b882-24ee9a37d45c","P.S. K141 - K141 - K035 - 75K141 - 272 Macdonough Street","fd1aad3c-30f4-ea11-b882-24ee9a37d45c",-73935891,40681528,"I.S. 35 - BROOKLYN","272 Macdonough Street"
1,0,1,"2deabc42-30f4-ea11-b882-24ee9a37d45c","P.S. K141 - K141 - K054 - 75K141 - 195 SANDFORD STREET","2eeabc42-30f4-ea11-b882-24ee9a37d45c",-73952504,40692616,"P.S. 54 - BROOKLYN","195 SANDFORD STREET"
5,4,1,"66e2635c-32f4-ea11-b882-24ee9a37d45c","Hunters Point Community Middle School - Q291 - Q404 - 30Q291 - 1-50 51ST AVENUE","65e2635c-32f4-ea11-b882-24ee9a37d45c",-73959183,40742964,"HUNTERS POINT CAMPUS - QUEENS","1-50 51ST AVENUE"
3,2,1,"18e2abc9-30f4-ea11-b882-24ee9a37d45c","P.S. K141 - K141 - K380 - 75K141 - 370 MARCY AVENUE","19e2abc9-30f4-ea11-b882-24ee9a37d45c",-73953702,40701790,"P.S. 380 - BROOKLYN","370 MARCY AVENUE"
1,0,1,"917e21a6-ebf6-ea11-b883-24ee9a37d459","The Riverview School - Q277 - Q312 - 75Q277 - 46-08 5TH STREET","cf454b50-32f4-ea11-b882-24ee9a37d45c",-73955145,40747077,"P.S./.IS. 78 - QUEENS","46-08 5TH STREET"
5,4,1,"898946f4-31f4-ea11-b882-24ee9a37d45c","I.S. 059 Springfield Gardens - Q059 - Q059 - 29Q059 - 132-55 RIDGEDALE STREET","878946f4-31f4-ea11-b882-24ee9a37d45c",-73752772,40681881,"I.S. 59 - QUEENS","132-55 RIDGEDALE STREET"
1,0,1,"9669c231-32f4-ea11-b882-24ee9a37d45c","P.S. 201 The Discovery School for Inquiry and Research - Q201 - Q201 - 25Q201 - 65-11 155 STREET","9769c231-32f4-ea11-b882-24ee9a37d45c",-73813011,40736541,"P.S. 201 - QUEENS","65-11 155 STREET"
2,1,1,"1a9ebaee-32f4-ea11-b882-24ee9a37d45c","P.S. 008 Isaac Varian - X008 - X008 - 10X008 - 3010 BRIGGS AVENUE","1b9ebaee-32f4-ea11-b882-24ee9a37d45c",-73883339,40872259,"P.S. 8 - BRONX","3010 BRIGGS AVENUE"
4,2,2,"6a5bc58c-30f4-ea11-b882-24ee9a37d45c","J.H.S. 220 John J. Pershing - K220 - K220 - 20K220 - 4812 9TH AVENUE","695bc58c-30f4-ea11-b882-24ee9a37d45c",-74001250,40640997,"I.S. 220 - BROOKLYN","4812 9TH AVENUE"
1,1,0,"bbfab455-31f4-ea11-b882-24ee9a37d45c","James Weldon Johnson - M057 - M057 - 04M057 - 176 EAST 115 STREET","bcfab455-31f4-ea11-b882-24ee9a37d45c",-73941598,40797205,"P.S. 57 - MANHATTAN","176 EAST 115 STREET"
3,3,0,"6907e99e-31f4-ea11-b882-24ee9a37d45c","Urban Academy Laboratory High School - M565 - M480 - 02M565 - 317 EAST 67 STREET","6007e99e-31f4-ea11-b882-24ee9a37d45c",-73959777,40765638,"JULIA RICHMAN ED. COMPLEX - M","317 EAST 67 STREET"
9,6,3,"ac2aa42b-33f4-ea11-b882-24ee9a37d45c","The New School for Leadership and Journalism - X244 - X143 - 10X244 - 120 WEST 231 STREET","ad2aa42b-33f4-ea11-b882-24ee9a37d45c",-73901565,40875636,"I.S. 143 - BRONX","120 WEST 231 STREET"
6,3,3,"75bc9674-32f4-ea11-b882-24ee9a37d45c","Grover Cleveland High School - Q485 - Q485 - 24Q485 - 21-27 HIMROD STREET","74bc9674-32f4-ea11-b882-24ee9a37d45c",-73909202,40711881,"GROVER CLEVELAND HS - Q","21-27 HIMROD STREET"
1,0,1,"c7315367-30f4-ea11-b882-24ee9a37d45c","John Ericsson Middle School 126 - K126 - K126 - 14K126 - 424 LEONARD STREET","c3315367-30f4-ea11-b882-24ee9a37d45c",-73947932,40719818,"J.H.S. 126 - BROOKLYN","424 LEONARD STREET"
1,0,1,"c837fba4-31f4-ea11-b882-24ee9a37d45c","Park East High School - M495 - M495 - 04M495 - 230 EAST 105 STREET","c737fba4-31f4-ea11-b882-24ee9a37d45c",-73944092,40790191,"PARK EAST HS - MANHATTAN","230 EAST 105 STREET"
7,5,2,"4c8dbfcf-30f4-ea11-b882-24ee9a37d45c","Midwood High School - K405 - K405 - 22K405 - 2839 BEDFORD AVENUE","4d8dbfcf-30f4-ea11-b882-24ee9a37d45c",-73952356,40632829,"MIDWOOD HS - K","2839 BEDFORD AVENUE"
4,0,4,"af2ff20c-32f4-ea11-b882-24ee9a37d45c","P.S. 105 The Bay School - Q105 - Q105 - 27Q105 - 420 BEACH 51 STREET","b02ff20c-32f4-ea11-b882-24ee9a37d45c",-73780961,40595911,"P.S. 105 - QUEENS","420 BEACH 51 STREET"
2,2,0,"44ff3d8d-33f4-ea11-b882-24ee9a37d45c","High School of American Studies at Lehman College - X696 - X905 - 10X696 - 2925 Goulden Avenue","45ff3d8d-33f4-ea11-b882-24ee9a37d45c",-73895543,40874725,"HS OF AMERICAN STUDIES - BRONX","2925 Goulden Avenue"
1,0,1,"c348b1f5-eaf6-ea11-b883-24ee9a37d459","P.S. M811 - Mickey Mantle School - M811 - M841 - 75M811 - 466 West End Avenue","676e70b7-31f4-ea11-b882-24ee9a37d45c",-73979217,40786330,"P.S. 811 (OLD P148/LIVINGS HS) - M","466 West End Avenue"
1,0,1,"4c5bc58c-30f4-ea11-b882-24ee9a37d45c","P.S. 214 Michael Friedsam - K214 - K214 - 19K214 - 2944 PITKIN AVENUE","4b5bc58c-30f4-ea11-b882-24ee9a37d45c",-73862961,40675881,"P.S. 214 - BROOKLYN","2944 PITKIN AVENUE"
1,1,0,"141bad3c-30f4-ea11-b882-24ee9a37d45c","I.S. 98 Bay Academy - K098 - K043 - 21K098 - 1401 EMMONS AVENUE","151bad3c-30f4-ea11-b882-24ee9a37d45c",-73954047,40583893,"I.S. 98 - BROOKLYN","1401 EMMONS AVENUE"
2,0,2,"0dd1de79-30f4-ea11-b882-24ee9a37d45c","P.S. 177 The Marlboro - K177 - K177 - 21K177 - 346 AVENUE P","0ed1de79-30f4-ea11-b882-24ee9a37d45c",-73974425,40608169,"P.S. 177 - BROOKLYN","346 AVENUE P"
3,1,2,"b82ff20c-32f4-ea11-b882-24ee9a37d45c","P.S. 108 Captain Vincent G. Fowler - Q108 - Q108 - 27Q108 - 108-10 109 AVENUE","b92ff20c-32f4-ea11-b882-24ee9a37d45c",-73831025,40679083,"P.S. 108 - QUEENS","108-10 109 AVENUE"
1,0,1,"c7c88e4f-31f4-ea11-b882-24ee9a37d45c","River East Elementary - M037 - M045 - 04M037 - 2351 FIRST AVENUE","c6c88e4f-31f4-ea11-b882-24ee9a37d45c",-73933740,40799265,"I.S. 45 - MANHATTAN","2351 FIRST AVENUE"
4,1,3,"48507380-31f4-ea11-b882-24ee9a37d45c","Amistad Dual Language School - M311 - M176 - 06M311 - 4862 BROADWAY","46507380-31f4-ea11-b882-24ee9a37d45c",-73923818,40866381,"P.S./I.S. 176 - MANHATTAN","4862 BROADWAY"
2,0,2,"9083ff9e-30f4-ea11-b882-24ee9a37d45c","P.S. 249 The Caton - K249 - K249 - 17K249 - 18 MARLBOROUGH ROAD","9183ff9e-30f4-ea11-b882-24ee9a37d45c",-73966456,40649509,"P.S. 249 - BROOKLYN","18 MARLBOROUGH ROAD"
5,3,2,"e4201dab-30f4-ea11-b882-24ee9a37d45c","P.S. 277 Gerritsen Beach - K277 - K277 - 22K277 - 2529 GERRITSEN AVENUE","e5201dab-30f4-ea11-b882-24ee9a37d45c",-73927850,40595798,"P.S. 277 - BROOKLYN","2529 GERRITSEN AVENUE"
2,0,2,"07f32ce2-31f4-ea11-b882-24ee9a37d45c","P.S. 014 Fairview - Q014 - Q014 - 24Q014 - 107-01 OTIS AVENUE","faf22ce2-31f4-ea11-b882-24ee9a37d45c",-73854570,40741020,"P.S. 14 - QUEENS","107-01 OTIS AVENUE"
1,1,0,"aeedf392-32f4-ea11-b882-24ee9a37d45c","P.S. 188 Kingsbury - Q188 - Q858 - 26Q188 - 216-15 Peck Avenue","afedf392-32f4-ea11-b882-24ee9a37d45c",-73754390,40734924,"PS 188 Annex","216-15 Peck Avenue"
1,0,1,"8603194f-30f4-ea11-b882-24ee9a37d45c","Brooklyn Landmark Elementary School - K599 - K073 - 23K599 - 251 MAC DOUGAL STREET","8503194f-30f4-ea11-b882-24ee9a37d45c",-73910719,40680679,"P.S. 73 - BROOKLYN","251 MAC DOUGAL STREET"
5,0,5,"78f4a0ef-eaf6-ea11-b883-24ee9a37d459","Sid Miller Academy - K396 - K396 - 75K396 - 110 CHESTER STREET","2d8dbfcf-30f4-ea11-b882-24ee9a37d45c",-73911788,40668232,"P.S. 396 (TANDEM K327-D23)-K","110 CHESTER STREET"
2,0,2,"553cbf01-ebf6-ea11-b883-24ee9a37d459","The David Marquis School of the Arts - R037 - R840 - 75R037 - 15 Fairfield Street","81be7adc-32f4-ea11-b882-24ee9a37d45c",-74151368,40564100,"P.S. 37 ( OLD I24X)-STATEN ISLAND","15 Fairfield Street"
8,5,3,"e292e6d5-30f4-ea11-b882-24ee9a37d45c","James Madison High School - K425 - K425 - 22K425 - 3787 BEDFORD AVENUE","e092e6d5-30f4-ea11-b882-24ee9a37d45c",-73947661,40610499,"JAMES MADISON HS - K","3787 BEDFORD AVENUE"
2,0,2,"a32ff20c-32f4-ea11-b882-24ee9a37d45c","P.S. 101 School in the Gardens - Q101 - Q101 - 28Q101 - 2 RUSSELL PLACE","a42ff20c-32f4-ea11-b882-24ee9a37d45c",-73843400,40715543,"P.S. 101 - QUEENS","2 RUSSELL PLACE"
3,3,0,"f32ece86-32f4-ea11-b882-24ee9a37d45c","Queens High School for the Sciences at York College - Q687 - Q774 - 28Q687 - 94-50 159 Street","f42ece86-32f4-ea11-b882-24ee9a37d45c",-73798364,40700884,"QUEENS HIGH SCHOOL FOR THE SCIENCES","94-50 159 Street"
4,2,2,"fcae0313-32f4-ea11-b882-24ee9a37d45c","I.S. 125 Thom J. McCann Woodside - Q125 - Q125 - 24Q125 - 46-02 47 AVENUE","fdae0313-32f4-ea11-b882-24ee9a37d45c",-73918762,40740452,"I.S. 125 - QUEENS","46-02 47 AVENUE"
7,5,2,"a93aa668-33f4-ea11-b882-24ee9a37d45c","Celia Cruz Bronx High School of Music, The - X442 - X430 - 10X442 - 2780 RESERVOIR AVENUE","a13aa668-33f4-ea11-b882-24ee9a37d45c",-73897066,40869061,"WALTON HS - X","2780 RESERVOIR AVENUE"
5,5,0,"dc0d3c5b-30f4-ea11-b882-24ee9a37d45c","P.S./I.S. 104 The Fort Hamilton School - K104 - K104 - 20K104 - 9115 5 AVENUE","dd0d3c5b-30f4-ea11-b882-24ee9a37d45c",-74028492,40618077,"P.S. 104 - BROOKLYN","9115 5 AVENUE"
8,7,1,"c7ba3c50-33f4-ea11-b882-24ee9a37d45c","P.S. 279 Captain Manuel Rivera, Jr. - X279 - X279 - 10X279 - 2100 WALTON AVENUE","c8ba3c50-33f4-ea11-b882-24ee9a37d45c",-73904958,40854666,"P.S. 279 - BRONX","2100 WALTON AVENUE"
2,2,0,"7c476368-32f4-ea11-b882-24ee9a37d45c","Newcomers High School - Q555 - Q450 - 30Q555 - 28-01 41 AVENUE","dab66262-32f4-ea11-b882-24ee9a37d45c",-73936592,40751838,"NEWCOMERS HIGH SCHOOL (OLD LIC)-Q","28-01 41 AVENUE"
4,1,3,"fb8ac007-ebf6-ea11-b883-24ee9a37d459","P.S. X721 - Stephen McSweeney School - X721 - X722 - 75X721 - 2697 WESTCHESTER AVENUE","06a31781-33f4-ea11-b882-24ee9a37d45c",-73839114,40842725,"P.S. 721 (OTC) - BRONX","2697 WESTCHESTER AVENUE"
3,2,1,"cee0838c-31f4-ea11-b882-24ee9a37d45c","The River School - M281 - M281 - 02M281 - 425 East 35 Street","cde0838c-31f4-ea11-b882-24ee9a37d45c",-73972592,40744288,"P.S. 281 - MANHATTAN","425 East 35 Street"
3,0,3,"3d3cbf01-ebf6-ea11-b883-24ee9a37d459","John F. Kennedy Jr. School - Q721 - Q722 - 75Q721 - 57-12 94 STREET","b172c880-32f4-ea11-b882-24ee9a37d45c",-73867882,40735613,"JOHN F. KENNEDY JR. SCHOOL - QUEENS","57-12 94 STREET"
4,2,2,"8e69c231-32f4-ea11-b882-24ee9a37d45c","P.S. 199 Maurice A. Fitzgerald - Q199 - Q199 - 24Q199 - 39-20 48 Avenue","98977d2b-32f4-ea11-b882-24ee9a37d45c",-73926081,40739831,"P.S. 199 - QUEENS","39-20 48 Avenue"
5,3,2,"9948b1f5-eaf6-ea11-b883-24ee9a37d459","P.S. K134 - K134 - K849 - 22K134 - 4001 18 AVENUE","12d8cf12-31f4-ea11-b882-24ee9a37d45c",-73973180,40632145,"P.S. 134 - BROOKLYN","4001 18 AVENUE"
6,4,2,"515bc58c-30f4-ea11-b882-24ee9a37d45c","P.S. 215 Morris H. Weiss - K215 - K215 - 21K215 - 415 AVENUE S","505bc58c-30f4-ea11-b882-24ee9a37d45c",-73970171,40602722,"P.S. 215 - BROOKLYN","415 AVENUE S"
2,1,1,"d78a0044-33f4-ea11-b882-24ee9a37d45c","Archimedes Academy for Math, Science and Technology Applications - X367 - X174 - 08X367 - 456 WHITE PLAINS ROAD","2a2ed53d-33f4-ea11-b882-24ee9a37d45c",-73856070,40815043,"I.S. 174 - BRONX","456 WHITE PLAINS ROAD"
1,1,0,"026e3d68-31f4-ea11-b882-24ee9a37d45c","P.S. 110 Florence Nightingale - M110 - M110 - 01M110 - 285 DELANCY STREET","036e3d68-31f4-ea11-b882-24ee9a37d45c",-73979800,40716200,"P.S. 110 - MANHATTAN","285 DELANCY STREET"
1,0,1,"0bcf496e-31f4-ea11-b882-24ee9a37d45c","M.S. 131 - M131 - M131 - 02M131 - 100 HESTER STREET","03cf496e-31f4-ea11-b882-24ee9a37d45c",-73993607,40716231,"I.S. 131 - MANHATTAN","100 HESTER STREET"
1,0,1,"3b0d6d19-33f4-ea11-b882-24ee9a37d45c","P.S. 106 Parkchester - X106 - X106 - 11X106 - 1514 OLMSTEAD AVENUE","3c0d6d19-33f4-ea11-b882-24ee9a37d45c",-73854823,40836974,"P.S. 106 - BRONX","1514 OLMSTEAD AVENUE"
3,0,3,"18e63126-ebf6-ea11-b883-24ee9a37d459","P.S. K771 - K771 - K236 - 75K771 - 6302 AVENUE U","5ba5db98-30f4-ea11-b882-24ee9a37d45c",-73912005,40615494,"P.S. 236 - BROOKLYN","6302 AVENUE U"
6,2,4,"38c73b4a-32f4-ea11-b882-24ee9a37d45c","Corona Arts & Sciences Academy - Q311 - Q311 - 24Q311 - 98-11 44TH AVENUE","36c73b4a-32f4-ea11-b882-24ee9a37d45c",-73865239,40745920,"P.S./ I.S. 311 - QUEENS","98-11 44TH AVENUE"
1,0,1,"039c4c1f-32f4-ea11-b882-24ee9a37d45c","P.S. 163 Flushing Heights - Q163 - Q163 - 25Q163 - 159-01 59 AVENUE","049c4c1f-32f4-ea11-b882-24ee9a37d45c",-73808765,40741107,"P.S. 163 - QUEENS","159-01 59 AVENUE"
2,1,1,"612f77fa-31f4-ea11-b882-24ee9a37d45c","I.S. 061 Leonardo Da Vinci - Q061 - Q061 - 24Q061 - 98-50 50 AVENUE","5f2f77fa-31f4-ea11-b882-24ee9a37d45c",-73862886,40741898,"I.S. 61 - QUEENS","98-50 50 AVENUE"
5,2,3,"e38521d0-32f4-ea11-b882-24ee9a37d45c","I.S. 072 Rocco Laurie - R072 - R072 - 31R072 - 33 FERNDALE AVENUE","e48521d0-32f4-ea11-b882-24ee9a37d45c",-74158618,40592132,"I.S. 72 - STATEN ISLAND","33 FERNDALE AVENUE"
2,0,2,"c9968d36-30f4-ea11-b882-24ee9a37d45c","P.S. 016 Leonard Dunkly - K016 - K016 - 14K016 - 157 WILSON STREET","f9f57030-30f4-ea11-b882-24ee9a37d45c",-73962049,40706069,"P.S. 16 - BROOKLYN","157 WILSON STREET"
9,5,4,"8f977d2b-32f4-ea11-b882-24ee9a37d45c","P.S. 196 Grand Central Parkway - Q196 - Q196 - 28Q196 - 71-25 113 STREET","90977d2b-32f4-ea11-b882-24ee9a37d45c",-73837379,40722792,"P.S. 196 - QUEENS","71-25 113 STREET"
3,1,2,"aafc24e8-31f4-ea11-b882-24ee9a37d45c","P.S. 020 John Bowne - Q020 - Q020 - 25Q020 - 142-30 BARCLAY AVENUE","14f32ce2-31f4-ea11-b882-24ee9a37d45c",-73824388,40758347,"P.S. 20 - QUEENS","142-30 BARCLAY AVENUE"
4,0,4,"e62d6c32-ebf6-ea11-b883-24ee9a37d459","P.S. K771 - K771 - K329 - 75K771 - 2929 WEST 30 STREET","11a198c3-30f4-ea11-b882-24ee9a37d45c",-73995770,40574666,"P.S. 329 - BROOKLYN","2929 WEST 30 STREET"
2,1,1,"1a6e3d68-31f4-ea11-b882-24ee9a37d45c","P.S. 138 - M138 - M117 - 75M138 - 240 EAST 109 STREET","1b6e3d68-31f4-ea11-b882-24ee9a37d45c",-73942285,40792556,"J.H.S. 117 - MANHATTAN","240 EAST 109 STREET"
2,0,2,"e0ba3c50-33f4-ea11-b882-24ee9a37d45c","The Matilda Avenue School - X483 - X314 - 11X483 - 4520 MATILDA AVENUE","dfba3c50-33f4-ea11-b882-24ee9a37d45c",-73854402,40901436,"P.S. 314 - BRONX","4520 MATILDA AVENUE"
4,1,3,"0c78931f-33f4-ea11-b882-24ee9a37d45c","J.H.S. 118 William W. Niles - X118 - X118 - 10X118 - 577 EAST 179 STREET","0b78931f-33f4-ea11-b882-24ee9a37d45c",-73892482,40848702,"I.S. 118 - BRONX","577 EAST 179 STREET"
2,0,2,"43416e00-31f4-ea11-b882-24ee9a37d45c","District 20 Pre-K Center - K768 - K664 - 20K768 - 140 58th Street","44416e00-31f4-ea11-b882-24ee9a37d45c",-74022864,40645338,"PRE-K CENTER @ 58TH STREET - BROOKLYN","140 58th Street"
3,2,1,"2102926e-32f4-ea11-b882-24ee9a37d45c","Queens Collegiate: A College Board School - Q310 - Q470 - 28Q310 - 167-01 GOTHIC DRIVE","1f02926e-32f4-ea11-b882-24ee9a37d45c",-73798658,40714551,"JAMAICA HS - Q","167-01 GOTHIC DRIVE"
2,0,2,"43fdc1bd-32f4-ea11-b882-24ee9a37d45c","I.S. 007 Elias Bernstein - R007 - R007 - 31R007 - 1270 Huguenot Avenue","447c21b7-32f4-ea11-b882-24ee9a37d45c",-74186096,40522971,"I.S. 7 - STATEN ISLAND","1270 Huguenot Avenue"
1,0,1,"6b36d900-33f4-ea11-b882-24ee9a37d45c","Frederick Douglass Academy V. Middle School - X273 - X057 - 12X273 - 2111 CROTONA AVENUE","6c36d900-33f4-ea11-b882-24ee9a37d45c",-73888987,40848748,"P.S. 57 - BRONX","2111 CROTONA AVENUE"
2,1,1,"9369c231-32f4-ea11-b882-24ee9a37d45c","P.S./M.S. 200 - The Magnet School of Global Studies and Leadership - Q200 - Q200 - 25Q200 - 70-10 164 STREET","9469c231-32f4-ea11-b882-24ee9a37d45c",-73805759,40731070,"P.S. 200 - QUEENS","70-10 164 STREET"
1,0,1,"28e0d393-ebf6-ea11-b883-24ee9a37d459","P.S. Q004 - Q004 - Q138 - 75Q004 - 251-11 WELLER AVENUE","1aaf0313-32f4-ea11-b882-24ee9a37d45c",-73734342,40659876,"P.S. 138 - QUEENS","251-11 WELLER AVENUE"
5,1,4,"f83159fa-30f4-ea11-b882-24ee9a37d45c","Transit Tech Career and Technical Education High School - K615 - K615 - 19K615 - 1 WELLS STREET","f93159fa-30f4-ea11-b882-24ee9a37d45c",-73875328,40678780,"E NY VOC HS OF TRANSIT TECH.-K","1 WELLS STREET"
4,0,4,"06b7c337-32f4-ea11-b882-24ee9a37d45c","J.H.S. 217 Robert A. Van Wyck - Q217 - Q217 - 28Q217 - 85-05 144 STREET","fcb6c337-32f4-ea11-b882-24ee9a37d45c",-73811461,40710384,"I.S. 217 - QUEENS","85-05 144 STREET"
2,0,2,"fd6d3d68-31f4-ea11-b882-24ee9a37d45c","P.S. 138 - M138 - M108 - 75M138 - 1615 MADISON AVENUE","5be61462-31f4-ea11-b882-24ee9a37d45c",-73947855,40795032,"P.S. 108 - MANHATTAN","1615 MADISON AVENUE"
4,4,0,"7dc280bd-31f4-ea11-b882-24ee9a37d45c","Manhattan Village Academy - M439 - M873 - 02M439 - 43 WEST 22 STREET","7ec280bd-31f4-ea11-b882-24ee9a37d45c",-73991966,40741963,"MANHATTAN VILLAGE ACADEMY - M","43 WEST 22 STREET"
2,0,2,"e4b36d80-30f4-ea11-b882-24ee9a37d45c","P.S. 192 - The Magnet School for Math and Science Inquiry - K192 - K192 - 20K192 - 4715 18 AVENUE","e5b36d80-30f4-ea11-b882-24ee9a37d45c",-73979540,40628800,"P.S. 192 - BROOKLYN","4715 18 AVENUE"
5,3,2,"d60d3c5b-30f4-ea11-b882-24ee9a37d45c","P.S. 101 The Verrazano - K101 - K101 - 21K101 - 8696 24 Avenue","d70d3c5b-30f4-ea11-b882-24ee9a37d45c",-73991962,40597379,"P.S. 101 - BROOKLYN","8696 24 Avenue"
1,0,1,"f58a0044-33f4-ea11-b882-24ee9a37d45c","The Urban Assembly Bronx Academy of Letters - X551 - X183 - 07X551 - 339 MORRIS AVENUE","ef8a0044-33f4-ea11-b882-24ee9a37d45c",-73925995,40813681,"J.H.S. 203 - BRONX","339 MORRIS AVENUE"
1,0,1,"97dab801-ecf6-ea11-b883-24ee9a37d459","P.S. X721 - Stephen McSweeney School - X721 - X405 - 75X721 - 3000 EAST TREMONT AVENUE","b556635c-33f4-ea11-b882-24ee9a37d45c",-73839583,40839775,"HERBERT H. LEHMAN HS - X","3000 EAST TREMONT AVENUE"
6,3,3,"03b7c337-32f4-ea11-b882-24ee9a37d45c","J.H.S. 216 George J. Ryan - Q216 - Q216 - 26Q216 - 64-20 175 Street","04b7c337-32f4-ea11-b882-24ee9a37d45c",-73794501,40737188,"J.H.S. 216 - QUEENS","64-20 175 Street"
1,1,0,"9034aa92-31f4-ea11-b882-24ee9a37d45c","High School for Dual Language and Asian Studies - M545 - M445 - 02M545 - 350 GRAND STREET","8834aa92-31f4-ea11-b882-24ee9a37d45c",-73989329,40717329,"SEWARD PARK HS - MANHATTAN","350 GRAND STREET"
1,0,1,"e09319d7-ebf6-ea11-b883-24ee9a37d459","The Richmond Pre-K Center - R066 - R093 - 31R066 - 2530 VICTORY BOULEVARD","f58521d0-32f4-ea11-b882-24ee9a37d45c",-74147690,40609601,"3K CENTER @ 2530 VICTORY BOULEVARD - STATEN ISLAND","2530 VICTORY BOULEVARD"
1,1,0,"f602cefa-32f4-ea11-b882-24ee9a37d45c","P.S. 033 Timothy Dwight - X033 - X033 - 10X033 - 2424 JEROME AVENUE","f702cefa-32f4-ea11-b882-24ee9a37d45c",-73901268,40861698,"P.S. 33 - BRONX","2424 JEROME AVENUE"
2,0,2,"d4e8ce00-32f4-ea11-b882-24ee9a37d45c","P.S. 076 William Hallet - Q076 - Q076 - 30Q076 - 36-36 10 Street","d2e8ce00-32f4-ea11-b882-24ee9a37d45c",-73941630,40760862,"P.S. 76 - QUEENS","36-36 10 Street"
3,1,2,"2cff3d8d-33f4-ea11-b882-24ee9a37d45c","Health Opportunities High School - X670 - X884 - 07X670 - 350 Gerard Avenue","2dff3d8d-33f4-ea11-b882-24ee9a37d45c",-73929960,40815712,"HEALTH OPPORTUNITIES HS - X","350 Gerard Avenue"
1,1,0,"8b01ce37-33f4-ea11-b882-24ee9a37d45c","Bronx Latin - X267 - X158 - 12X267 - 800 HOME STREET","8601ce37-33f4-ea11-b882-24ee9a37d45c",-73900593,40826933,"I.S. 158 - BRONX","800 HOME STREET"
1,0,1,"c056635c-33f4-ea11-b882-24ee9a37d45c","Herbert H. Lehman High School - X405 - X405 - 08X405 - 3000 EAST TREMONT AVENUE","b556635c-33f4-ea11-b882-24ee9a37d45c",-73839583,40839775,"HERBERT H. LEHMAN HS - X","3000 EAST TREMONT AVENUE"
1,0,1,"abdab801-ecf6-ea11-b883-24ee9a37d459","P.S. X721 - Stephen McSweeney School - X721 - X440 - 75X721 - 100 WEST MOSHOLU PARKWAY SOUTH","4cffcc6e-33f4-ea11-b882-24ee9a37d45c",-73889011,40879958,"DEWITT CLINTON HS - X","100 WEST MOSHOLU PARKWAY SOUTH"
3,3,0,"01f32ce2-31f4-ea11-b882-24ee9a37d45c","P.S. 012 James B. Colgate - Q012 - Q012 - 24Q012 - 42-00 72 STREET","02f32ce2-31f4-ea11-b882-24ee9a37d45c",-73893466,40742284,"P.S. 12 - QUEENS","42-00 72 STREET"
5,0,5,"7aa9d9c3-32f4-ea11-b882-24ee9a37d45c","P.S. 029 Bardwell - R029 - R029 - 31R029 - 1581 VICTORY BOULEVARD","7ba9d9c3-32f4-ea11-b882-24ee9a37d45c",-74116197,40614039,"P.S. 29 - STATEN ISLAND","1581 VICTORY BOULEVARD"
4,0,4,"cb689025-33f4-ea11-b882-24ee9a37d45c","Soundview Academy for Culture and Scholarship - X448 - X131 - 08X448 - 885 Bolton Avenue","c8689025-33f4-ea11-b882-24ee9a37d45c",-73859998,40822925,"I.S. 131 - BRONX","885 Bolton Avenue"
2,0,2,"e0d10307-33f4-ea11-b882-24ee9a37d45c","P.S. 066 School of Higher Expectations - X066 - X066 - 12X066 - 1001 JENNINGS STREET","ded10307-33f4-ea11-b882-24ee9a37d45c",-73886540,40831493,"P.S. 66 - BRONX","1001 JENNINGS STREET"
1,0,1,"aa2aa42b-33f4-ea11-b882-24ee9a37d45c","Baychester Middle School - X532 - X142 - 11X532 - 3750 BAYCHESTER AVENUE","a32aa42b-33f4-ea11-b882-24ee9a37d45c",-73839682,40886002,"I.S. 142 - BRONX","3750 BAYCHESTER AVENUE"
2,1,1,"4e6e70b7-31f4-ea11-b882-24ee9a37d45c","Community Health Academy of the Heights - M346 - M814 - 06M346 - 504 WEST 158TH STREET","4f6e70b7-31f4-ea11-b882-24ee9a37d45c",-73942074,40833695,"THE COMMUNITY HEALTH ACADEMY OF THE HEIGHTS - M","504 WEST 158TH STREET"
1,0,1,"d82ff20c-32f4-ea11-b882-24ee9a37d45c","P.S./I.S. 119 The Glendale - Q119 - Q119 - 24Q119 - 74-01 78 AVENUE","d92ff20c-32f4-ea11-b882-24ee9a37d45c",-73875073,40705187,"I.S. 119 - QUEENS","74-01 78 AVENUE"
3,2,1,"397eed06-32f4-ea11-b882-24ee9a37d45c","P.S. 100 Glen Morris - Q100 - Q100 - 27Q100 - 111-11 118 Street","267eed06-32f4-ea11-b882-24ee9a37d45c",-73821545,40679694,"P.S. 100 - QUEENS","111-11 118 Street"
3,1,2,"7f283fb1-30f4-ea11-b882-24ee9a37d45c","P.S. 290 Juan Morel Campos - K290 - K290 - 19K290 - 135 Schenck Avenue","7e283fb1-30f4-ea11-b882-24ee9a37d45c",-73889375,40678182,"P.S. 290 - BROOKLYN","135 Schenck Avenue"
1,0,1,"4c2f7d06-31f4-ea11-b882-24ee9a37d45c","District 20 Pre-K Center - K768 - K762 - 20K768 - 1355 84th Street","4d2f7d06-31f4-ea11-b882-24ee9a37d45c",-74011426,40614474,"PRE-K CENTER @1355 84TH STREET - BROOKLYN","1355 84th Street"
1,0,1,"a327ba50-ebf6-ea11-b883-24ee9a37d459","P.S. K721 - Brooklyn Occupational Training Center - K721 - KBSQ - 75K721 - 585 SCHENECTADY AVENUE","9cd91731-31f4-ea11-b882-24ee9a37d45c",-73933800,40659576,"KINGSBROOK JEWISH","585 SCHENECTADY AVENUE"
5,5,0,"68e2635c-32f4-ea11-b882-24ee9a37d45c","Academy for Careers in Television and Film - Q301 - Q404 - 30Q301 - 1-50 51ST AVENUE","65e2635c-32f4-ea11-b882-24ee9a37d45c",-73959183,40742964,"HUNTERS POINT CAMPUS - QUEENS","1-50 51ST AVENUE"
4,3,1,"3a767649-31f4-ea11-b882-24ee9a37d45c","P.S. 028 Wright Brothers - M028 - M028 - 06M028 - 475 WEST 155 STREET","3b767649-31f4-ea11-b882-24ee9a37d45c",-73942023,40831630,"P.S. 28 - MANHATTAN","475 WEST 155 STREET"
3,3,0,"d4f57030-30f4-ea11-b882-24ee9a37d45c","The Emily Warren Roebling School - K008 - K008 - 13K008 - 37 HICKS STREET","d5f57030-30f4-ea11-b882-24ee9a37d45c",-73992841,40700709,"P.S. 8 - BROOKLYN","37 HICKS STREET"
2,0,2,"3ea10a44-32f4-ea11-b882-24ee9a37d45c","Pioneer Academy - Q307 - Q260 - 24Q307 - 40-20 100TH STREET","3da10a44-32f4-ea11-b882-24ee9a37d45c",-73865787,40749175,"P.S. 307- QUEENS","40-20 100TH STREET"
8,1,7,"237eed06-32f4-ea11-b882-24ee9a37d45c","I.S. 093 Ridgewood - Q093 - Q093 - 24Q093 - 66-56 FOREST AVENUE","0f7eed06-32f4-ea11-b882-24ee9a37d45c",-73903057,40705609,"I.S. 93 - QUEENS","66-56 FOREST AVENUE"
7,7,0,"df883319-32f4-ea11-b882-24ee9a37d45c","P.S. 144 Col Jeromus Remsen - Q144 - Q144 - 28Q144 - 69-20 JUNO STREET","e0883319-32f4-ea11-b882-24ee9a37d45c",-73852398,40714890,"P.S. 144 - QUEENS","69-20 JUNO STREET"
2,0,2,"4d3cbf01-ebf6-ea11-b883-24ee9a37d459","P.S. R373 - R373 - R040 - 75R373 - 91 HENDERSON AVENUE","97a9d9c3-32f4-ea11-b882-24ee9a37d45c",-74095454,40641180,"P.S. 373 (OLD P40) - STATEN ISLAND","91 HENDERSON AVENUE"
2,0,2,"40953aac-ebf6-ea11-b883-24ee9a37d459","The Riverview School - Q277 - Q322 - 75Q277 - 89-11 43rd Avenue","ec454b50-32f4-ea11-b882-24ee9a37d45c",-73876706,40742891,"PS 14 Annex","89-11 43rd Avenue"
1,0,1,"f43159fa-30f4-ea11-b882-24ee9a37d45c","District 20 Pre-K Center - K768 - K613 - 20K768 - 369 93rd Street","f53159fa-30f4-ea11-b882-24ee9a37d45c",-74031046,40618135,"PRE-K CENTER @93RD STREET - BROOKLYN","369 93rd Street"
4,3,1,"e68521d0-32f4-ea11-b882-24ee9a37d45c","I.S. 075 Frank D. Paulo - R075 - R075 - 31R075 - 455 HUGUENOT AVENUE","e28521d0-32f4-ea11-b882-24ee9a37d45c",-74197033,40544535,"I.S. 75 - STATEN ISLAND","455 HUGUENOT AVENUE"
3,2,1,"bae0838c-31f4-ea11-b882-24ee9a37d45c","P.S. 234 Independence School - M234 - M234 - 02M234 - 292 GREENWICH STREET","bbe0838c-31f4-ea11-b882-24ee9a37d45c",-74010880,40719530,"P.S. 234 - MANHATTAN","292 GREENWICH STREET"
3,0,3,"56767649-31f4-ea11-b882-24ee9a37d45c","P.S. 042 Benjamin Altman - M042 - M042 - 02M042 - 71 HESTER STREET","51767649-31f4-ea11-b882-24ee9a37d45c",-73990826,40716126,"P.S. 42 - MANHATTAN","71 HESTER STREET"
4,3,1,"1b474313-33f4-ea11-b882-24ee9a37d45c","Sheridan Academy for Young Leaders - X457 - X090 - 09X457 - 1116 SHERIDAN AVENUE","1c474313-33f4-ea11-b882-24ee9a37d45c",-73917526,40831873,"P.S. 90 - BRONX","1116 SHERIDAN AVENUE"
2,1,1,"b3fc24e8-31f4-ea11-b882-24ee9a37d45c","P.S. 022 Thomas Jefferson - Q022 - Q022 - 25Q022 - 153-33 SANFORD AVENUE","b1fc24e8-31f4-ea11-b882-24ee9a37d45c",-73811373,40761744,"P.S. 22 - QUEENS","153-33 SANFORD AVENUE"
1,0,1,"aabf14dd-ebf6-ea11-b883-24ee9a37d459","Pathways to Graduation - Q950 - R801 - 79Q950 - 450 ST MARKS PLACE","69be7adc-32f4-ea11-b882-24ee9a37d45c",-74077564,40638388,"AUX. SERV - ST. GEORGE SCHOOL-S.I.","450 ST MARKS PLACE"
3,2,1,"cbd27c6d-30f4-ea11-b882-24ee9a37d45c","P.S. 139 Alexine A. Fenty - K139 - K139 - 22K139 - 330 RUGBY ROAD","cad27c6d-30f4-ea11-b882-24ee9a37d45c",-73965862,40641340,"P.S. 139 - BROOKLYN","330 RUGBY ROAD"
2,1,1,"fa201dab-30f4-ea11-b882-24ee9a37d45c","P.S. 282 Park Slope - K282 - K282 - 13K282 - 180 6 Avenue","f8201dab-30f4-ea11-b882-24ee9a37d45c",-73977983,40676649,"P.S. 282 - BROOKLYN","180 6 Avenue"
1,0,1,"1430f69f-ebf6-ea11-b883-24ee9a37d459","P.S. Q224 - Q224 - Q205 - 75Q224 - 75-25 BELL BOULEVARD","a769c231-32f4-ea11-b882-24ee9a37d45c",-73756374,40738008,"P.S. 205 - QUEENS","75-25 BELL BOULEVARD"
3,1,2,"81a9d9c3-32f4-ea11-b882-24ee9a37d45c","P.S. 031 William T. Davis - R031 - R031 - 31R031 - 55 LAYTON AVENUE","82a9d9c3-32f4-ea11-b882-24ee9a37d45c",-74085420,40642090,"P.S. 31 - STATEN ISLAND","55 LAYTON AVENUE"
8,6,2,"d2b66262-32f4-ea11-b882-24ee9a37d45c","Forest Hills High School - Q440 - Q440 - 28Q440 - 67-01 110 STREET","d3b66262-32f4-ea11-b882-24ee9a37d45c",-73843972,40730017,"FOREST HILLS HS - Q","67-01 110 STREET"
2,0,2,"b6689025-33f4-ea11-b882-24ee9a37d45c","P.S. 126 Dr Marjorie H Dunbar - X126 - X126 - 09X126 - 175 WEST 166 STREET","b5689025-33f4-ea11-b882-24ee9a37d45c",-73928200,40835866,"P.S. 126 (ECF) - BRONX","175 WEST 166 STREET"
2,1,1,"6ba5db98-30f4-ea11-b882-24ee9a37d45c","Mark Twain I.S. 239 for the Gifted & Talented - K239 - K239 - 21K239 - 2401 NEPTUNE AVENUE","6ca5db98-30f4-ea11-b882-24ee9a37d45c",-73992447,40578640,"I.S. 239 - BROOKLYN","2401 NEPTUNE AVENUE"
7,0,7,"559d7c62-33f4-ea11-b882-24ee9a37d45c","The Metropolitan Soundview High School - X521 - X420 - 12X521 - 1300 BOYNTON AVENUE","519d7c62-33f4-ea11-b882-24ee9a37d45c",-73878191,40832508,"JAMES MONROE EDUCATIONAL CAMPUS - X","1300 BOYNTON AVENUE"
3,0,3,"2bc73b4a-32f4-ea11-b882-24ee9a37d45c","P.S. 092 Harry T. Stewart Sr. - Q092 - Q292 - 30Q092 - 99-01 34 AVENUE","29c73b4a-32f4-ea11-b882-24ee9a37d45c",-73868773,40755983,"P.S. 92 - QUEENS","99-01 34 AVENUE"
7,5,2,"0fa6ba98-31f4-ea11-b882-24ee9a37d45c","University Neighborhood High School - M448 - M446 - 01M448 - 200 Monroe Street","10a6ba98-31f4-ea11-b882-24ee9a37d45c",-73984128,40712269,"UNIVERSITY NEIGHBORHOOD - M","200 Monroe Street"
4,1,3,"92dc32dc-31f4-ea11-b882-24ee9a37d45c","P.S. 002 Alfred Zimberg - Q002 - Q002 - 30Q002 - 75-10 21 Avenue","93dc32dc-31f4-ea11-b882-24ee9a37d45c",-73894108,40769798,"P.S. 2 - QUEENS","75-10 21 Avenue"
2,1,1,"8d83ff9e-30f4-ea11-b882-24ee9a37d45c","P.S. 247 Brooklyn - K247 - K247 - 20K247 - 7000 21 AVENUE","8e83ff9e-30f4-ea11-b882-24ee9a37d45c",-73987195,40612247,"P.S. 247 - BROOKLYN","7000 21 AVENUE"
2,1,1,"ab32c3fb-eaf6-ea11-b883-24ee9a37d459","P.S. Q224 - Q224 - Q186 - 75Q224 - 252-12 72 AVENUE","67977d2b-32f4-ea11-b882-24ee9a37d45c",-73721594,40749556,"P.S. 186 - QUEENS","252-12 72 AVENUE"
5,2,3,"433cbf01-ebf6-ea11-b883-24ee9a37d459","P.S. Q811 - Q811 - Q811 - 75Q811 - 61-25 MARATHON PARKWAY","08bef08c-32f4-ea11-b882-24ee9a37d45c",-73728412,40756481,"P.S. 811 (OLD 187) - QUEENS","61-25 MARATHON PARKWAY"
1,1,0,"58f4a0ef-eaf6-ea11-b883-24ee9a37d459","Explore Excel Charter School - K379 - K114 - 84K379 - 1077 REMSEN AVENUE","29e85c61-30f4-ea11-b882-24ee9a37d45c",-73907880,40642684,"P.S. 114 - BROOKLYN","1077 REMSEN AVENUE"
1,0,1,"673cbf01-ebf6-ea11-b883-24ee9a37d459","P.S. X596 - X596 - X178 - 75X596 - 850 BAYCHESTER AVENUE","e38a0044-33f4-ea11-b882-24ee9a37d45c",-73831669,40874035,"P.S. 178 - BRONX","850 BAYCHESTER AVENUE"
3,0,3,"417c21b7-32f4-ea11-b882-24ee9a37d45c","P.S. 6 Corporal Allan F. Kivlehan School - R006 - R006 - 31R006 - 555 PAGE AVENUE","3c7c21b7-32f4-ea11-b882-24ee9a37d45c",-74230118,40510207,"P.S. 6 - STATEN ISLAND","555 PAGE AVENUE"
2,0,2,"a5e657bd-30f4-ea11-b882-24ee9a37d45c","Ebbets Field Middle School - K352 - K320 - 17K352 - 46 MCKEEVER PLACE","a1e657bd-30f4-ea11-b882-24ee9a37d45c",-73959484,40665199,"P.S. 375 - BROOKLYN","46 MCKEEVER PLACE"
2,1,1,"cf0d3c5b-30f4-ea11-b882-24ee9a37d45c","P.S. 099 Isaac Asimov - K099 - K099 - 21K099 - 1120 EAST 10 STREET","d00d3c5b-30f4-ea11-b882-24ee9a37d45c",-73966031,40621474,"P.S. 99 - BROOKLYN","1120 EAST 10 STREET"
3,3,0,"692f77fa-31f4-ea11-b882-24ee9a37d45c","P.S. 063 Old South - Q063 - Q063 - 27Q063 - 90-15 SUTTER AVENUE","6a2f77fa-31f4-ea11-b882-24ee9a37d45c",-73846796,40676978,"P.S. 63 - QUEENS","90-15 SUTTER AVENUE"
1,0,1,"9f778cb8-ebf6-ea11-b883-24ee9a37d459","P.S. Q811 - Q811 - Q566 - 75Q811 - 74-20 COMMONWEALTH BLVD","27b4977a-32f4-ea11-b882-24ee9a37d45c",-73728834,40744197,"QNS HS OF TEACH., LIB. ARTS&SCI-Q","74-20 COMMONWEALTH BLVD"
2,0,2,"0ee2abc9-30f4-ea11-b882-24ee9a37d45c","P.S. 371 - Lillian L. Rashkis - K371 - K371 - 75K371 - 355 37 STREET","0de2abc9-30f4-ea11-b882-24ee9a37d45c",-74005168,40654306,"P.S. 371 (OLD 615) - BROOKLYN","355 37 STREET"
2,0,2,"69fdc1bd-32f4-ea11-b882-24ee9a37d45c","P.S. 022 Graniteville - R022 - R022 - 31R022 - 1860 Forest Avenue","6afdc1bd-32f4-ea11-b882-24ee9a37d45c",-74150544,40624847,"P.S. 22 - STATEN ISLAND","1860 Forest Avenue"
4,1,3,"f9ae0313-32f4-ea11-b882-24ee9a37d45c","P.S. 124 Osmond A Church - Q124 - Q124 - 27Q124 - 129-15 150 AVENUE","faae0313-32f4-ea11-b882-24ee9a37d45c",-73811266,40665669,"P.S. 124 - QUEENS","129-15 150 AVENUE"
1,0,1,"ab343d0d-85ef-eb11-b8b1-24ee9a37d45c","P.S. Q811 - Q811 - Q140 - 75Q811 - 166-01 116 AVENUE","c7883319-32f4-ea11-b882-24ee9a37d45c",-73781255,40687486,"P.S. 140 - QUEENS","166-01 116 AVENUE"
4,4,0,"197eed06-32f4-ea11-b882-24ee9a37d45c","P.S. 89Q: The Jose Peralta School of Dreamers - Q089 - Q089 - 24Q089 - 85-28 BRITTON AVENUE","1a7eed06-32f4-ea11-b882-24ee9a37d45c",-73879641,40745963,"P.S. 89 - QUEENS","85-28 BRITTON AVENUE"
4,3,1,"1e06003e-32f4-ea11-b882-24ee9a37d45c","East-West School of International Studies - Q281 - Q237 - 25Q281 - 46-21 COLDEN STREET","1b06003e-32f4-ea11-b882-24ee9a37d45c",-73821402,40749430,"J.H.S. 237 - QUEENS","46-21 COLDEN STREET"
1,0,1,"81593c87-33f4-ea11-b882-24ee9a37d45c","Bronx High School for the Visual Arts - X418 - X839 - 11X418 - 2040 ANTIN PL","80593c87-33f4-ea11-b882-24ee9a37d45c",-73864438,40851577,"BRONX HIGH SCHOOL FOR THE VISUAL ARTS","2040 ANTIN PL"
4,1,3,"4dfdc1bd-32f4-ea11-b882-24ee9a37d45c","P.S. 11 Thomas Dongan School - R011 - R011 - 31R011 - 51 Jefferson Street","4efdc1bd-32f4-ea11-b882-24ee9a37d45c",-74098252,40590887,"P.S. 11 - STATEN ISLAND","51 Jefferson Street"
6,4,2,"bbab074a-33f4-ea11-b882-24ee9a37d45c","Urban Scholars Community School - X463 - X198 - 12X463 - 1180 TINTON AVENUE","baab074a-33f4-ea11-b882-24ee9a37d45c",-73900121,40828406,"P.S. 198 - BRONX","1180 TINTON AVENUE"
2,0,2,"2ca6ba98-31f4-ea11-b882-24ee9a37d45c","High School for Law and Public Service - M467 - M465 - 06M467 - 549 AUDUBON AVENUE","25a6ba98-31f4-ea11-b882-24ee9a37d45c",-73926060,40856532,"G. WASHINGTON HS EDUC. CAMPUS - M","549 AUDUBON AVENUE"
2,1,1,"fef22ce2-31f4-ea11-b882-24ee9a37d45c","P.S. 011 Kathryn Phelan - Q011 - Q011 - 30Q011 - 54-25 SKILLMAN AVENUE","fff22ce2-31f4-ea11-b882-24ee9a37d45c",-73909032,40746127,"P.S. 11 - QUEENS","54-25 SKILLMAN AVENUE"
1,0,1,"8dfd7256-8c23-ed11-b0a2-088e901ef405","Pathways to Graduation - Q950 - XCKJ - 79Q950 - 2501 Jerome Avenue","8efd7256-8c23-ed11-b0a2-088e901ef405",-73900075,40864060,"Monroe College","2501 Jerome Avenue"
2,0,2,"21c73b4a-32f4-ea11-b882-24ee9a37d45c","Helen M. Marshall School - Q330 - Q287 - 24Q330 - 110-08 NORTHERN BOULEVARD","20c73b4a-32f4-ea11-b882-24ee9a37d45c",-73859202,40757888,"P.S. 330 - QUEENS","110-08 NORTHERN BOULEVARD"
1,0,1,"4a9d7c62-33f4-ea11-b882-24ee9a37d45c","Bronxdale High School - X508 - X415 - 11X508 - 925 ASTOR AVENUE","439d7c62-33f4-ea11-b882-24ee9a37d45c",-73860729,40860443,"CHRISTOPHER COLUMBUS HS - X","925 ASTOR AVENUE"
2,1,1,"5f6e70b7-31f4-ea11-b882-24ee9a37d45c","High School of Economics and Finance - M489 - M833 - 02M489 - 100 TRINITY PLACE","606e70b7-31f4-ea11-b882-24ee9a37d45c",-74012328,40709270,"HS FOR ECONOMICS & FINANCE - M","100 TRINITY PLACE"
5,4,1,"08cf496e-31f4-ea11-b882-24ee9a37d45c","P.S. 130 Hernando De Soto - M130 - M130 - 02M130 - 143 BAXTER STREET","09cf496e-31f4-ea11-b882-24ee9a37d45c",-73998326,40718660,"P.S. 130 - MANHATTAN","143 BAXTER STREET"
2,0,2,"b6fab455-31f4-ea11-b882-24ee9a37d45c","University Neighborhood Middle School - M332 - M056 - 01M332 - 220 HENRY STREET","affab455-31f4-ea11-b882-24ee9a37d45c",-73986051,40713362,"J.H.S. 56 - MANHATTAN","220 HENRY STREET"
1,1,0,"42a10a44-32f4-ea11-b882-24ee9a37d45c","New York City Academy for Discovery - Q306 - Q262 - 27Q306 - 95-16 89TH AVENUE","43a10a44-32f4-ea11-b882-24ee9a37d45c",-73848577,40691482,"P.S. 262 - QUEENS","95-16 89TH AVENUE"
2,2,0,"ba79df48-30f4-ea11-b882-24ee9a37d45c","P.S. 059 William Floyd - K059 - K059 - 14K059 - 211 THROOP AVENUE","b579df48-30f4-ea11-b882-24ee9a37d45c",-73943279,40697619,"P.S. 59 - BROOKLYN","211 THROOP AVENUE"
1,0,1,"35ff3d8d-33f4-ea11-b882-24ee9a37d45c","Luisa Pineiro Fuentes School of Science and Discovery - X307 - X886 - 10X307 - 124 EAMES PLACE","36ff3d8d-33f4-ea11-b882-24ee9a37d45c",-73901821,40869142,"P.S. 86 ANNEX - BRONX","124 EAMES PLACE"
2,1,1,"c68442ee-31f4-ea11-b882-24ee9a37d45c","P.S. 031 Bayside - Q031 - Q031 - 26Q031 - 211-45 46 ROAD","c78442ee-31f4-ea11-b882-24ee9a37d45c",-73768994,40757701,"P.S. 31 - QUEENS","211-45 46 ROAD"
4,4,0,"81eb6056-32f4-ea11-b882-24ee9a37d45c","The Woodside Community School - Q361 - Q339 - 30Q361 - 39-07 57th Street","82eb6056-32f4-ea11-b882-24ee9a37d45c",-73906430,40747701,"P.S. 339 - Queens","39-07 57th Street"
2,1,1,"d90d3c5b-30f4-ea11-b882-24ee9a37d45c","P.S. 102 The Bayview - K102 - K102 - 20K102 - 211 72 STREET","da0d3c5b-30f4-ea11-b882-24ee9a37d45c",-74028758,40634318,"P.S. 102 - BROOKLYN","211 72 STREET"
1,0,1,"c4315367-30f4-ea11-b882-24ee9a37d45c","P.S. 124 Silas B. Dutcher - K124 - K124 - 15K124 - 515 4 AVENUE","c5315367-30f4-ea11-b882-24ee9a37d45c",-73990620,40667464,"P.S. 124 - BROOKLYN","515 4 AVENUE"
2,1,1,"68a5db98-30f4-ea11-b882-24ee9a37d45c","I. S. 381 - K381 - K240 - 22K381 - 2500 NOSTRAND AVENUE","69a5db98-30f4-ea11-b882-24ee9a37d45c",-73946836,40623788,"I.S. 240 - BROOKLYN","2500 NOSTRAND AVENUE"
11,8,3,"0ffc3df4-30f4-ea11-b882-24ee9a37d45c","All City Leadership Secondary School - K554 - K554 - 32K554 - 321 Palmetto Street","10fc3df4-30f4-ea11-b882-24ee9a37d45c",-73913172,40697378,"ALL CITY LEADERSHIP SECONDARY SCHOOL - BROOKLYN","321 Palmetto Street"
17,12,5,"5d07e99e-31f4-ea11-b882-24ee9a37d45c","Stuyvesant High School - M475 - M477 - 02M475 - 345 CHAMBERS STREET","5c07e99e-31f4-ea11-b882-24ee9a37d45c",-74013921,40718025,"STUYVESANT HS (NEW) - MANHATTAN","345 CHAMBERS STREET"
6,4,2,"e42ece86-32f4-ea11-b882-24ee9a37d45c","Young Women's Leadership School, Astoria - Q286 - Q739 - 30Q286 - 23-15 Newtown Avenue","e52ece86-32f4-ea11-b882-24ee9a37d45c",-73923830,40770769,"YOUNG WOMEN'S LEADERSHIP ACADEMY- QUEENS","23-15 Newtown Avenue"
2,1,1,"989c11e8-30f4-ea11-b882-24ee9a37d45c","Millennium Brooklyn HS - K684 - K460 - 15K684 - 237 7 AVENUE","929c11e8-30f4-ea11-b882-24ee9a37d45c",-73978580,40669255,"John Jay Educational Campus","237 7 AVENUE"
5,3,2,"b03fce93-7c88-ec11-b8d0-24ee9a37d45c","Academy of American Studies - Q575 - Q575 - 30Q575 - 40-11 28th Street","b13fce93-7c88-ec11-b8d0-24ee9a37d45c",-73936596,40751839,"ACADEMY OF AMERICAN STUDIES - QUEENS","40-11 28th Street"
2,0,2,"171bad3c-30f4-ea11-b882-24ee9a37d45c","P.S. 044 Marcus Garvey - K044 - K044 - 13K044 - 432 MONROE STREET","031bad3c-30f4-ea11-b882-24ee9a37d45c",-73940859,40686213,"P.S. 44 - BROOKLYN","432 MONROE STREET"
2,2,0,"8ba87f90-5a04-ec11-b8b4-24ee9a37d45c","Hunters Point Elementary School - Q384 - Q375 - 30Q384 - 1-35 57 Avenue","8ca87f90-5a04-ec11-b8b4-24ee9a37d45c",-73960836,40738864,"Hunters Point","1-35 57 Avenue"
1,0,1,"1202926e-32f4-ea11-b882-24ee9a37d45c","Queens High School for Information, Research, and Technology - Q302 - Q465 - 27Q302 - 8-21 BAY 25 STREET","0b02926e-32f4-ea11-b882-24ee9a37d45c",-73763995,40601537,"FAR ROCKAWAY HS - Q","8-21 BAY 25 STREET"
1,0,1,"cb9452e9-8b23-ed11-b0a2-088e901ef405","P.S. Q224 - Q224 - Q314 - 75Q224 - 88-08 164TH STREET","d5454b50-32f4-ea11-b882-24ee9a37d45c",-73797981,40708698,"P.S./ I.S. 314 - Queens","88-08 164TH STREET"
1,0,1,"66c280bd-31f4-ea11-b882-24ee9a37d45c","P.S. 046 Arthur Tappan - M046 - M846 - 05M046 - 2987 FREDERICK DOUGLAS BLVD","67c280bd-31f4-ea11-b882-24ee9a37d45c",-73936300,40830400,"P.S. 46 MINISCHOOL - MANHATTAN","2987 FREDERICK DOUGLAS BLVD"
3,3,0,"ef9b4c1f-32f4-ea11-b882-24ee9a37d45c","J.H.S. 157 Stephen A. Halsey - Q157 - Q157 - 28Q157 - 63-55 102ND STREET","f09b4c1f-32f4-ea11-b882-24ee9a37d45c",-73852879,40732348,"J.H.S. 157 - QUEENS","63-55 102ND STREET"
3,1,2,"533cbf01-ebf6-ea11-b883-24ee9a37d459","South Richmond High School I.S./P.S. 25 - R025 - R825 - 75R025 - 6581 HYLAN BOULEVARD","77be7adc-32f4-ea11-b882-24ee9a37d45c",-74218688,40512019,"P.S. 25 (MOUNT LORETTO) - S.I.","6581 HYLAN BOULEVARD"
3,1,2,"07fc3df4-30f4-ea11-b882-24ee9a37d45c","John Dewey High School - K540 - K540 - 21K540 - 50 AVENUE X","05fc3df4-30f4-ea11-b882-24ee9a37d45c",-73981925,40588070,"JOHN DEWEY HS - K","50 AVENUE X"
1,1,0,"076e3d68-31f4-ea11-b882-24ee9a37d45c","Opportunity Charter School - M279 - M113 - 84M279 - 240 WEST 113 STREET","086e3d68-31f4-ea11-b882-24ee9a37d45c",-73955583,40801573,"P.S. 241 - MANHATTAN","240 WEST 113 STREET"
1,0,1,"00b7c337-32f4-ea11-b882-24ee9a37d45c","Wave Preparatory Elementary School - Q362 - Q215 - 27Q362 - 535 BRIAR PLACE","01b7c337-32f4-ea11-b882-24ee9a37d45c",-73758587,40599467,"P.S. 215 - QUEENS","535 BRIAR PLACE"
1,0,1,"a53aa668-33f4-ea11-b882-24ee9a37d45c","International School for Liberal Arts - X342 - X430 - 10X342 - 2780 RESERVOIR AVENUE","a13aa668-33f4-ea11-b882-24ee9a37d45c",-73897066,40869061,"WALTON HS - X","2780 RESERVOIR AVENUE"
3,0,3,"cdc88e4f-31f4-ea11-b882-24ee9a37d45c","P.S. 046 Arthur Tappan - M046 - M046 - 05M046 - 2987 FREDERICK DOUGLASS BOULEVARD","ccc88e4f-31f4-ea11-b882-24ee9a37d45c",-73936300,40830400,"P.S. 46 - MANHATTAN","2987 FREDERICK DOUGLASS BOULEVARD"
3,1,2,"2ca31781-33f4-ea11-b882-24ee9a37d45c","P.S. 207 - X207 - X819 - 10X207 - 3030 GODWIN TERRACE","2ba31781-33f4-ea11-b882-24ee9a37d45c",-73906197,40878327,"P.S. 207 - BRONX","3030 GODWIN TERRACE"
6,6,0,"722f77fa-31f4-ea11-b882-24ee9a37d45c","J.H.S. 067 Louis Pasteur - Q067 - Q067 - 26Q067 - 51-60 MARATHON PARKWAY","732f77fa-31f4-ea11-b882-24ee9a37d45c",-73734832,40762241,"J.H.S. 67 - QUEENS","51-60 MARATHON PARKWAY"
4,2,2,"5b5b4cd6-32f4-ea11-b882-24ee9a37d45c","Curtis High School - R450 - R450 - 31R450 - 105 HAMILTON AVENUE","5a5b4cd6-32f4-ea11-b882-24ee9a37d45c",-74082149,40645436,"CURTIS HS - S. I.","105 HAMILTON AVENUE"
5,5,0,"a672c880-32f4-ea11-b882-24ee9a37d45c","Queens Metropolitan High School - Q686 - Q686 - 28Q686 - 91-30 METROPOLITAN AVENUE","a372c880-32f4-ea11-b882-24ee9a37d45c",-73855543,40708431,"METROPOLITAN AVENUE CAMPUS - QUEENS","91-30 METROPOLITAN AVENUE"
2,1,1,"9d476368-32f4-ea11-b882-24ee9a37d45c","Queens High School for Language Studies - Q241 - Q460 - 25Q241 - 35-01 UNION STREET","97476368-32f4-ea11-b882-24ee9a37d45c",-73826811,40764892,"FLUSHING HS - Q","35-01 UNION STREET"
19,15,4,"63ffcc6e-33f4-ea11-b882-24ee9a37d45c","The Bronx High School of Science - X445 - X445 - 10X445 - 75 WEST 205 STREET","64ffcc6e-33f4-ea11-b882-24ee9a37d45c",-73889011,40879958,"BRONX HS OF SCIENCE - X","75 WEST 205 STREET"
1,0,1,"7c8d8486-31f4-ea11-b882-24ee9a37d45c","P.S. 197 John B. Russwurm - M197 - M197 - 05M197 - 2230 5 AVENUE","7b8d8486-31f4-ea11-b882-24ee9a37d45c",-73938347,40813532,"P.S. 197 - MANHATTAN","2230 5 AVENUE"
1,0,1,"4c953aac-ebf6-ea11-b883-24ee9a37d459","P.S. Q255 - Q255 - Q397 - 75Q255 - 32-52 37th Street","a4eb6056-32f4-ea11-b882-24ee9a37d45c",-73920948,40759308,"PRE-K CENTER @37TH STREET - QUEENS","32-52 37th Street"
3,0,3,"2da198c3-30f4-ea11-b882-24ee9a37d45c","P.S. 345 Patrolman Robert Bolden - K345 - K345 - 19K345 - 111 BERRIMAN STREET","2ca198c3-30f4-ea11-b882-24ee9a37d45c",-73879886,40676207,"P.S. 345 - BROOKLYN","111 BERRIMAN STREET"
16,11,5,"1eb4977a-32f4-ea11-b882-24ee9a37d45c","Townsend Harris High School - Q525 - Q515 - 25Q525 - 149-11 MELBOURNE AVENUE","1db4977a-32f4-ea11-b882-24ee9a37d45c",-73821532,40737038,"TOWNSEND HARRIS HS - Q","149-11 MELBOURNE AVENUE"
2,1,1,"ca92e6d5-30f4-ea11-b882-24ee9a37d45c","Academy of Innovative Technology - K618 - K420 - 19K618 - 999 JAMAICA AVENUE","c692e6d5-30f4-ea11-b882-24ee9a37d45c",-73869305,40693002,"FRANKLIN K. LANE HS - K","999 JAMAICA AVENUE"
1,0,1,"8653dd74-33f4-ea11-b882-24ee9a37d45c","Harry S Truman High School - X455 - X455 - 11X455 - 750 BAYCHESTER AVENUE","8253dd74-33f4-ea11-b882-24ee9a37d45c",-73831669,40874035,"HARRY S. TRUMAN HS - X","750 BAYCHESTER AVENUE"
1,1,0,"ea201dab-30f4-ea11-b882-24ee9a37d45c","P.S. 279 Herman Schreiber - K279 - K279 - 18K279 - 1070 EAST 104 STREET","e3201dab-30f4-ea11-b882-24ee9a37d45c",-73892797,40644134,"P.S. 279 - BROOKLYN","1070 EAST 104 STREET"
2,0,2,"480b210d-33f4-ea11-b882-24ee9a37d45c","P.S. X811 - X811 - X084 - 75X811 - 1434 Longfellow Avenue","490b210d-33f4-ea11-b882-24ee9a37d45c",-73886798,40830552,"P.S. 811 (OLD I84) - BRONX","1434 Longfellow Avenue"
3,2,1,"85d810ab-31f4-ea11-b882-24ee9a37d45c","Food and Finance High School - M288 - M535 - 02M288 - 525 WEST 50TH STREET","f137fba4-31f4-ea11-b882-24ee9a37d45c",-73992700,40765474,"PARK WEST HS (ECF) - MANHATTAN","525 WEST 50TH STREET"
1,0,1,"56395a2c-ebf6-ea11-b883-24ee9a37d459","Sid Miller Academy - K396 - K263 - 75K396 - 210 CHESTER STREET","6eb50aa5-30f4-ea11-b882-24ee9a37d45c",-73911279,40666187,"P.S./I.S. 323 - BROOKLYN","210 CHESTER STREET"
1,0,1,"43767649-31f4-ea11-b882-24ee9a37d45c","P.S. 033 Chelsea Prep - M033 - M033 - 02M033 - 281 9 AVENUE","42767649-31f4-ea11-b882-24ee9a37d45c",-74000238,40749014,"P.S. 33 - MANHATTAN","281 9 AVENUE"
3,0,3,"d53159fa-30f4-ea11-b882-24ee9a37d45c","George Westinghouse Career and Technical Education High School - K605 - K580 - 13K605 - 105 TECH PLACE","d33159fa-30f4-ea11-b882-24ee9a37d45c",-73986105,40695444,"GEORGE WESTINGHOUSE VOC HS - K","105 TECH PLACE"
2,1,1,"bc315367-30f4-ea11-b882-24ee9a37d45c","P.S. 121 Nelson A. Rockefeller - K121 - K121 - 21K121 - 5301 20 AVENUE","bd315367-30f4-ea11-b882-24ee9a37d45c",-73978472,40622671,"P.S. 121 - BROOKLYN","5301 20 AVENUE"
3,2,1,"d39b4c1f-32f4-ea11-b882-24ee9a37d45c","P.S. 149 Christa McAuliffe - Q149 - Q149 - 30Q149 - 93-11 34 AVENUE","f3883319-32f4-ea11-b882-24ee9a37d45c",-73874505,40755759,"P.S. 149 - QUEENS","93-11 34 AVENUE"
1,1,0,"29e2abc9-30f4-ea11-b882-24ee9a37d45c","New Heights Middle School - K722 - K391 - 17K722 - 790 EAST NEW YORK AVENUE","2ae2abc9-30f4-ea11-b882-24ee9a37d45c",-73936313,40662092,"I.S. 391 - BROOKLYN","790 EAST NEW YORK AVENUE"
3,0,3,"2feabc42-30f4-ea11-b882-24ee9a37d45c","P.S. 054 Samuel C. Barnes - K054 - K054 - 13K054 - 195 SANDFORD STREET","2eeabc42-30f4-ea11-b882-24ee9a37d45c",-73952504,40692616,"P.S. 54 - BROOKLYN","195 SANDFORD STREET"
3,3,0,"6541e65b-31f4-ea11-b882-24ee9a37d45c","New York City Lab Middle School for Collaborative Studies - M312 - M070 - 02M312 - 333 WEST 17 STREET","defab455-31f4-ea11-b882-24ee9a37d45c",-74002222,40742512,"I.S. 70 - MANHATTAN","333 WEST 17 STREET"
2,1,1,"d38521d0-32f4-ea11-b882-24ee9a37d45c","The Kathleen Grimm School for Leadership and Sustainability - R062 - R062 - 31R062 - 644 Bloomingdale Road","d48521d0-32f4-ea11-b882-24ee9a37d45c",-74217934,40541563,"K.GRIMM SCL FOR LDRSHP&SUSTAINABLTY@SANDY GR -S.I.","644 Bloomingdale Road"
2,1,1,"1ae2abc9-30f4-ea11-b882-24ee9a37d45c","P.S. 380 John Wayne Elementary - K380 - K380 - 14K380 - 370 MARCY AVENUE","19e2abc9-30f4-ea11-b882-24ee9a37d45c",-73953702,40701790,"P.S. 380 - BROOKLYN","370 MARCY AVENUE"
1,0,1,"f38ac007-ebf6-ea11-b883-24ee9a37d459","P.S. X176 - X176 - X455 - 75X176 - 750 BAYCHESTER AVENUE","8253dd74-33f4-ea11-b882-24ee9a37d45c",-73831669,40874035,"HARRY S. TRUMAN HS - X","750 BAYCHESTER AVENUE"
1,1,0,"1de85c61-30f4-ea11-b882-24ee9a37d45c","Achievement First East New York Charter School - K358 - K111 - 84K358 - 35 STARR STREET","18e85c61-30f4-ea11-b882-24ee9a37d45c",-73927938,40700810,"I.S. 111 - BROOKLYN","35 STARR STREET"
6,4,2,"6ca9d9c3-32f4-ea11-b882-24ee9a37d45c","I.S. 024 Myra S. Barnes - R024 - R024 - 31R024 - 750 DURANT AVENUE","5bfdc1bd-32f4-ea11-b882-24ee9a37d45c",-74145558,40545490,"I.S. 24 - STATEN ISLAND","750 DURANT AVENUE"
1,0,1,"d937fba4-31f4-ea11-b882-24ee9a37d45c","Forsyth Satellite Academy - M458 - M510 - 01M458 - 198 Forsyth Street","d737fba4-31f4-ea11-b882-24ee9a37d45c",-73990468,40722415,"FORSYTH HS (AUXSVC-OLD 91) - M","198 Forsyth Street"
2,1,1,"b332c3fb-eaf6-ea11-b883-24ee9a37d459","Mosaic Pre-K Center - Q331 - Q392 - 24Q331 - 68-20 Myrtle Avenue","a2eb6056-32f4-ea11-b882-24ee9a37d45c",-73883878,40701694,"PRE-K CENTER @ 68-20 MYRTLE AVENUE - QUEENS","68-20 Myrtle Avenue"
3,1,2,"ff6d3d68-31f4-ea11-b882-24ee9a37d45c","City Knoll Middle School - M933 - M111 - 02M933 - 440 WEST 53 STREET","006e3d68-31f4-ea11-b882-24ee9a37d45c",-73989776,40765880,"P.S. 111 - MANHATTAN","440 WEST 53 STREET"
2,1,1,"4b6e70b7-31f4-ea11-b882-24ee9a37d45c","High School for Mathematics, Science and Engineering at City College - M692 - M812 - 05M692 - 240 CONVENT AVE","4c6e70b7-31f4-ea11-b882-24ee9a37d45c",-73950354,40820208,"HS FOR MATH, SCI & ENGINEERING-M","240 CONVENT AVE"
5,0,5,"12ae38fc-7001-ed11-b8db-24ee9a37d45c","The Richard H. Hungerford School - R721 - R086 - 75R721 - 715 L Ocean Terrace","713f38e4-e9e5-ec11-b8d9-24ee9a37d45c",-74108045,40608374,"I.S./H.S. @ 715L OCEAN TERRACE - STATEN ISLAND","715 L Ocean Terrace"
1,0,1,"ae27ba50-ebf6-ea11-b883-24ee9a37d459","Adult and Continuing Education - K755 - KCAL - 79K755 - 790 Broadway","215b5337-31f4-ea11-b882-24ee9a37d45c",-73940753,40699693,"P2G@ST. NICK ALLIANCE WORKFORCE DEVELOPMENT","790 Broadway"
4,1,3,"9b476368-32f4-ea11-b882-24ee9a37d45c","Veritas Academy - Q240 - Q460 - 25Q240 - 35-01 UNION STREET","97476368-32f4-ea11-b882-24ee9a37d45c",-73826811,40764892,"FLUSHING HS - Q","35-01 UNION STREET"
2,0,2,"bc689025-33f4-ea11-b882-24ee9a37d45c","Linden Tree Elementary School - X567 - X127 - 11X567 - 1560 PURDY STREET","b9689025-33f4-ea11-b882-24ee9a37d45c",-73853203,40838759,"I.S. 127 - BRONX","1560 PURDY STREET"
2,1,1,"c72e1d9f-f81e-eb11-b885-24ee9a37d45c","Region 7 Adult Learning Center - E007 - K779 -  - 1474 Gates Avenue","5c2f7d06-31f4-ea11-b882-24ee9a37d45c",-73913900,40697800,"ALL CITY LEADERSHIP SCHOOL - K","1474 Gates Avenue"
4,1,3,"bb48b1f5-eaf6-ea11-b883-24ee9a37d459","School for Cooperative Technical Education - M645 - M646 - 79M645 - 321 East 96 Street","5e0c1bb1-31f4-ea11-b882-24ee9a37d45c",-73945647,40784112,"SCL COOP TECH ED (MNH VOC HS) - M","321 East 96 Street"
1,0,1,"2fff3d8d-33f4-ea11-b882-24ee9a37d45c","Community School for Social Justice - X427 - X884 - 07X427 - 350 Gerard Avenue","2dff3d8d-33f4-ea11-b882-24ee9a37d45c",-73929960,40815712,"HEALTH OPPORTUNITIES HS - X","350 Gerard Avenue"
1,0,1,"4ede5eb7-30f4-ea11-b882-24ee9a37d45c","I.S. 303 Herbert S. Eisenberg - K303 - K303 - 21K303 - 501 WEST AVENUE","4cde5eb7-30f4-ea11-b882-24ee9a37d45c",-73972009,40582518,"I.S. 303 - BROOKLYN","521 WEST AVENUE"
2,1,1,"6f41e65b-31f4-ea11-b882-24ee9a37d45c","P.S. 075 Emily Dickinson - M075 - M075 - 03M075 - 735 WEST END AVENUE","6a41e65b-31f4-ea11-b882-24ee9a37d45c",-73973996,40795109,"P.S. 75 - MANHATTAN","735 WEST END AVENUE"
1,0,1,"19497593-33f4-ea11-b882-24ee9a37d45c","J.H.S. 118 William W. Niles - X118 - X932 - 10X118 - 577 East 179 Street","1a497593-33f4-ea11-b882-24ee9a37d45c",-73892482,40848702,"I.S. 118 TEMP. C.R. BLDG. - X","577 East 179 Street"
4,2,2,"c50d3c5b-30f4-ea11-b882-24ee9a37d45c","I.S. 096 Seth Low - K096 - K096 - 21K096 - 99 AVENUE P","c10d3c5b-30f4-ea11-b882-24ee9a37d45c",-73984985,40608135,"I.S. 96 - BROOKLYN","99 AVENUE P"
1,0,1,"2502926e-32f4-ea11-b882-24ee9a37d45c","Jamaica Gateway to the Sciences - Q350 - Q470 - 28Q350 - 167-01 GOTHIC DRIVE","1f02926e-32f4-ea11-b882-24ee9a37d45c",-73798658,40714551,"JAMAICA HS - Q","167-01 GOTHIC DRIVE"
4,4,0,"cee8ce00-32f4-ea11-b882-24ee9a37d45c","J.H.S. 074 Nathaniel Hawthorne - Q074 - Q074 - 26Q074 - 61-15 Oceania Street","cfe8ce00-32f4-ea11-b882-24ee9a37d45c",-73766653,40744743,"I.S. 74 - QUEENS","61-15 Oceania Street"
1,0,1,"399ebaee-32f4-ea11-b882-24ee9a37d45c","P.S. 019 Judith K. Weiss - X019 - X019 - 11X019 - 311 East 237 Street","319ebaee-32f4-ea11-b882-24ee9a37d45c",-73866949,40899351,"P.S. 19 - BRONX","311 East 237 Street"
2,1,1,"3b88e6db-30f4-ea11-b882-24ee9a37d45c","Performing Arts and Technology High School - K507 - K435 - 19K507 - 400 PENNSYLVANIA AVENUE","3688e6db-30f4-ea11-b882-24ee9a37d45c",-73895122,40666868,"THOMAS JEFFERSON HS - K","400 PENNSYLVANIA AVENUE"
3,2,1,"95886843-31f4-ea11-b882-24ee9a37d45c","P.S. 009 Sarah Anderson - M009 - M009 - 03M009 - 100 WEST 84 STREET","87886843-31f4-ea11-b882-24ee9a37d45c",-73974256,40785234,"P.S. 9 - MANHATTAN","100 WEST 84 STREET"
5,5,0,"14e85c61-30f4-ea11-b882-24ee9a37d45c","P.S. 110 The Monitor - K110 - K110 - 14K110 - 124 MONITOR STREET","e50d3c5b-30f4-ea11-b882-24ee9a37d45c",-73941926,40723743,"P.S. 110 - BROOKLYN","124 MONITOR STREET"
5,2,3,"91e657bd-30f4-ea11-b882-24ee9a37d45c","P.S. 506: The School of Journalism & Technology - K506 - K314 - 20K506 - 330 59 Street","8ee657bd-30f4-ea11-b882-24ee9a37d45c",-74019299,40641950,"P.S. 314 - BROOKLYN","330 59 Street"
2,1,1,"5f9f4974-31f4-ea11-b882-24ee9a37d45c","P.S. 154 Harriet Tubman - M154 - M154 - 05M154 - 250 WEST 127 STREET","609f4974-31f4-ea11-b882-24ee9a37d45c",-73948902,40810499,"P.S. 154 - MANHATTAN","250 WEST 127 STREET"
1,0,1,"6be03d56-33f4-ea11-b882-24ee9a37d45c","New World High School - X513 - X362 - 11X513 - 921 EAST 228TH STREET","6ce03d56-33f4-ea11-b882-24ee9a37d45c",-73852714,40888242,"I.S./H.S. 362 - BRONX","921 EAST 228TH STREET"
4,3,1,"99d810ab-31f4-ea11-b882-24ee9a37d45c","Chelsea Career and Technical Education High School - M615 - M615 - 02M615 - 131 AVENUE OF THE AMERICAS","9ad810ab-31f4-ea11-b882-24ee9a37d45c",-74005058,40724630,"CHELSEA VOC HS - MANHATTAN","131 AVENUE OF THE AMERICAS"
9,8,1,"538dbfcf-30f4-ea11-b882-24ee9a37d45c","Abraham Lincoln High School - K410 - K410 - 21K410 - 2800 OCEAN PARKWAY","518dbfcf-30f4-ea11-b882-24ee9a37d45c",-73968733,40582627,"ABRAHAM LINCOLN HS - K","2800 OCEAN PARKWAY"
2,1,1,"5907e99e-31f4-ea11-b882-24ee9a37d45c","High School for Health Professions and Human Services - M420 - M475 - 02M420 - 345 East 15th Street","5607e99e-31f4-ea11-b882-24ee9a37d45c",-73982590,40732665,"HEALTH PROFESSIONS HS (OL STY) - M","345 East 15th Street"
2,0,2,"6f283fb1-30f4-ea11-b882-24ee9a37d45c","I.S. 285 Meyer Levin - K285 - K285 - 18K285 - 5909 BEVERLY ROAD","70283fb1-30f4-ea11-b882-24ee9a37d45c",-73920784,40647818,"I.S. 285 - BROOKLYN","5909 BEVERLY ROAD"
1,1,0,"89977d2b-32f4-ea11-b882-24ee9a37d45c","J.H.S. 194 William Carr - Q194 - Q194 - 25Q194 - 154-60 17 AVENUE","8a977d2b-32f4-ea11-b882-24ee9a37d45c",-73806990,40783231,"J.H.S. 194 - QUEENS","154-60 17 AVENUE"
6,4,2,"dab36d80-30f4-ea11-b882-24ee9a37d45c","Legacy School of the Arts - K907 - K190 - 19K907 - 590 SHEFFIELD AVENUE","dbb36d80-30f4-ea11-b882-24ee9a37d45c",-73894877,40662243,"P.S. 190 - BROOKLYN","590 SHEFFIELD AVENUE"
3,2,1,"a072c880-32f4-ea11-b882-24ee9a37d45c","Young Women's Leadership School, Queens - Q896 - Q680 - 28Q896 - 150-91 87 ROAD","9d72c880-32f4-ea11-b882-24ee9a37d45c",-73804166,40708409,"YOUNG WOMENS' LEADERSHIP SCHOOL - QUEENS","150-91 87 ROAD"
2,1,1,"31eabc42-30f4-ea11-b882-24ee9a37d45c","Achievement First Brownsville Charter School - K626 - K055 - 84K626 - 2021 BERGEN STREET","32eabc42-30f4-ea11-b882-24ee9a37d45c",-73912685,40674456,"I.S. 55 - BROOKLYN","2021 BERGEN STREET"
3,2,1,"0c5d0a12-4afb-ea11-b883-24ee9a37d459","Tabernacle Day Care Center, Inc. - KBCV - KBCV -  - 34-52 KOSCIUSKO STREET","0d5d0a12-4afb-ea11-b883-24ee9a37d459",-73953631,40690133,"TABERNACLE DAY CARE CENTER, INC.","34-52 KOSCIUSKO STREET"
1,0,1,"752f77fa-31f4-ea11-b882-24ee9a37d45c","P.S. 068 Cambridge - Q068 - Q068 - 24Q068 - 59-09 SAINT FELIX AVENUE","762f77fa-31f4-ea11-b882-24ee9a37d45c",-73897372,40696961,"P.S. 68 - QUEENS","59-09 SAINT FELIX AVENUE"
1,0,1,"9ae657bd-30f4-ea11-b882-24ee9a37d45c","P.S. 133 William A. Butler - K133 - K317 - 13K133 - 610 Baltic Street","99e657bd-30f4-ea11-b882-24ee9a37d45c",-73980455,40679916,"P.S. 133 WILLIAM A. BUTLER - BROOKLYN","610 Baltic Street"
4,3,1,"340410ca-32f4-ea11-b882-24ee9a37d45c","The Barbara Esselborn School - R053 - R053 - 31R053 - 330 DURANT AVENUE","350410ca-32f4-ea11-b882-24ee9a37d45c",-74136640,40551926,"P.S. 53 - STATEN ISLAND","330 DURANT AVENUE"
3,2,1,"e83159fa-30f4-ea11-b882-24ee9a37d45c","Clara Barton High School - K600 - K600 - 17K600 - 901 CLASSON AVENUE","e13159fa-30f4-ea11-b882-24ee9a37d45c",-73960689,40669805,"CLARA BARTON HS - K","901 CLASSON AVENUE"
2,0,2,"1eaf0313-32f4-ea11-b882-24ee9a37d45c","P.S. 136 Roy Wilkins - Q136 - Q136 - 29Q136 - 201-15 115 AVENUE","1faf0313-32f4-ea11-b882-24ee9a37d45c",-73752694,40698940,"P.S. 136 - QUEENS","201-15 115 AVENUE"
3,2,1,"d8e8ce00-32f4-ea11-b882-24ee9a37d45c","P.S. 079 Francis Lewis - Q079 - Q079 - 25Q079 - 147-27 15 DRIVE","d7e8ce00-32f4-ea11-b882-24ee9a37d45c",-73817338,40786201,"P.S. 79 - QUEENS","147-27 15 DRIVE"
3,2,1,"4e2b3eee-30f4-ea11-b882-24ee9a37d45c","The Christa McAuliffe School\I.S. 187 - K187 - K486 - 20K187 - 1171 65 STREET","4f2b3eee-30f4-ea11-b882-24ee9a37d45c",-74003883,40627929,"I.S. 187 - BROOKLYN","1171 65 STREET"
1,0,1,"eef22ce2-31f4-ea11-b882-24ee9a37d45c","P.S. 007 Louis F. Simeone - Q007 - Q007 - 24Q007 - 80-55 CORNISH AVENUE","ecf22ce2-31f4-ea11-b882-24ee9a37d45c",-73882446,40739644,"P.S. 7 - QUEENS","80-55 CORNISH AVENUE"
4,2,2,"a783ff9e-30f4-ea11-b882-24ee9a37d45c","P.S. 255 Barbara Reing School - K255 - K255 - 22K255 - 1866 EAST 17 STREET","a883ff9e-30f4-ea11-b882-24ee9a37d45c",-73955891,40604461,"P.S. 255 - BROOKLYN","1866 EAST 17 STREET"
2,1,1,"692b3eee-30f4-ea11-b882-24ee9a37d45c","Franklin Delano Roosevelt High School - K505 - K505 - 20K505 - 5800 20 AVENUE","682b3eee-30f4-ea11-b882-24ee9a37d45c",-73982583,40621299,"FRANKLIN D. ROOSEVELT HS - K","5800 20 AVENUE"
1,0,1,"62be7adc-32f4-ea11-b882-24ee9a37d45c","Ralph R. McKee Career and Technical Education High School - R600 - R600 - 31R600 - 101 Belmont Place","5ebe7adc-32f4-ea11-b882-24ee9a37d45c",-74079263,40642820,"RALPH MCKEE VOC HS - S. I.","101 Belmont Place"
2,0,2,"ed8442ee-31f4-ea11-b882-24ee9a37d45c","P.S. Q256 - Q256 - Q043 - 75Q256 - 160 BEACH 29 STREET","ee8442ee-31f4-ea11-b882-24ee9a37d45c",-73761086,40593480,"P.S. 43 - QUEENS","160 BEACH 29 STREET"
2,2,0,"28416e00-31f4-ea11-b882-24ee9a37d45c","Williamsburg High School for Architecture and Design - K558 - K650 - 14K558 - 257 NORTH 6 STREET","29416e00-31f4-ea11-b882-24ee9a37d45c",-73954815,40715561,"HARRY VANARSDALE VOC H (WHITNEY)-K","257 NORTH 6 STREET"
2,2,0,"d5ab074a-33f4-ea11-b882-24ee9a37d45c","The School of Science and Applied Learning - X300 - X234 - 12X300 - 2050 PROSPECT AVENUE","d4ab074a-33f4-ea11-b882-24ee9a37d45c",-73886721,40846128,"P.S. 234 (PAIRED W I129) - BRONX","2050 PROSPECT AVENUE"
4,0,4,"882aa42b-33f4-ea11-b882-24ee9a37d45c","P186X Walter J. Damrosch School - X186 - X136 - 75X186 - 750 Jennings Street","892aa42b-33f4-ea11-b882-24ee9a37d45c",-73897797,40831388,"P.S. 186 (OLD J136) - BRONX","750 Jennings Street"
1,0,1,"db92e6d5-30f4-ea11-b882-24ee9a37d45c","Academy for Young Writers - K404 - K422 - 19K404 - 1065 Elton Street","da92e6d5-30f4-ea11-b882-24ee9a37d45c",-73874064,40657266,"SPRING CREEK EDUCATIONAL CAMPUS - BROOKLYN","1065 Elton Street"
1,1,0,"830e93d5-49fb-ea11-b883-24ee9a37d459","SAINT DOMINICS TORCH - XAPI - XAPI -  - 2340 ANDREWS AVE","840e93d5-49fb-ea11-b883-24ee9a37d459",-73906158,40862300,"SAINT DOMINICS TORCH","2340 ANDREWS AVE"
2,2,0,"8407e99e-31f4-ea11-b882-24ee9a37d45c","Manhattan / Hunter Science High School - M541 - M490 - 03M541 - 122 AMSTERDAM AVENUE","7c07e99e-31f4-ea11-b882-24ee9a37d45c",-73985608,40774891,"MARTIN LUTHER KING, JR. HS - M","122 AMSTERDAM AVENUE"
2,2,0,"5de61462-31f4-ea11-b882-24ee9a37d45c","J.H.S. 104 Simon Baruch - M104 - M104 - 02M104 - 330 EAST 21 STREET","5ee61462-31f4-ea11-b882-24ee9a37d45c",-73981034,40735879,"I.S. 104 - MANHATTAN","330 EAST 21 STREET"
5,5,0,"9c28a20c-31f4-ea11-b882-24ee9a37d45c","Khalil Gibran International Academy - K592 - K806 - 15K592 - 362 SCHERMERHORN STREET","9d28a20c-31f4-ea11-b882-24ee9a37d45c",-73979829,40686147,"METROPOLITAN CORPORATE ACAD. - K","362 SCHERMERHORN STREET"
2,0,2,"362f7d06-31f4-ea11-b882-24ee9a37d45c","Brooklyn Studio Secondary School - K690 - K721 - 21K690 - 8310 21ST AVENUE","56416e00-31f4-ea11-b882-24ee9a37d45c",-73995084,40604980,"BROOKLYN STUDIO (TANDEM K128) - K","8310 21ST AVENUE"
11,11,0,"6ce2635c-32f4-ea11-b882-24ee9a37d45c","Bayside High School - Q495 - Q405 - 26Q495 - 32-24 CORPORAL KENNEDY STREET","6be2635c-32f4-ea11-b882-24ee9a37d45c",-73781041,40771398,"BAYSIDE HS - Q","32-24 CORPORAL KENNEDY STREET"
3,1,2,"9ee657bd-30f4-ea11-b882-24ee9a37d45c","I.S. 318 Eugenio Maria De Hostos - K318 - K318 - 14K318 - 101 WALTON STREET","9de657bd-30f4-ea11-b882-24ee9a37d45c",-73948771,40703034,"I.S. 318 - BROOKLYN","101 WALTON STREET"
9,7,2,"4c5b4cd6-32f4-ea11-b882-24ee9a37d45c","Staten Island Technical High School - R605 - R440 - 31R605 - 485 CLAWSON STREET","4b5b4cd6-32f4-ea11-b882-24ee9a37d45c",-74117086,40568299,"STATEN ISLAND TECHNICAL HS - S.I.","485 CLAWSON STREET"
3,3,0,"6f8d8486-31f4-ea11-b882-24ee9a37d45c","Harlem Village Academy West Charter School - M709 - M194 - 84M709 - 244 WEST 144 STREET","708d8486-31f4-ea11-b882-24ee9a37d45c",-73941111,40821208,"P.S. 194 - MANHATTAN","244 WEST 144 STREET"
3,2,1,"ea09e2e1-30f4-ea11-b882-24ee9a37d45c","PROGRESS High School for Professional Careers - K474 - K450 - 14K474 - 850 GRAND STREET","e909e2e1-30f4-ea11-b882-24ee9a37d45c",-73938921,40711134,"GRAND STREET CAMPUS (OLD E.D.HS)- K","850 GRAND STREET"
10,5,5,"f2ae0313-32f4-ea11-b882-24ee9a37d45c","P.S. 122 Mamie Fay - Q122 - Q122 - 30Q122 - 21-21 DITMARS BOULEVARD","cb2ff20c-32f4-ea11-b882-24ee9a37d45c",-73915785,40780507,"P.S. 122 - QUEENS","21-21 DITMARS BOULEVARD"
1,1,0,"c0fc24e8-31f4-ea11-b882-24ee9a37d45c","I.S. 025 Adrien Block - Q025 - Q025 - 25Q025 - 34-65 192 STREET","befc24e8-31f4-ea11-b882-24ee9a37d45c",-73789365,40764884,"J.H.S. 25 - QUEENS","34-65 192 STREET"
1,1,0,"e09b4c1f-32f4-ea11-b882-24ee9a37d45c","P.S. 153 Maspeth Elem - Q153 - Q153 - 24Q153 - 60-02 60 LANE","e19b4c1f-32f4-ea11-b882-24ee9a37d45c",-73904463,40716296,"P.S. 153 - QUEENS","60-02 60 LANE"
2,0,2,"dc8521d0-32f4-ea11-b882-24ee9a37d45c","P.S. 069 Daniel D. Tompkins - R069 - R069 - 31R069 - 144 KEATING PLACE","dd8521d0-32f4-ea11-b882-24ee9a37d45c",-74157327,40591480,"P.S. 69 - STATEN ISLAND","144 KEATING PLACE"
1,0,1,"0cf32ce2-31f4-ea11-b882-24ee9a37d45c","P.S. 015 Jackie Robinson - Q015 - Q015 - 29Q015 - 121-15 LUCAS STREET","0df32ce2-31f4-ea11-b882-24ee9a37d45c",-73756546,40686050,"P.S. 15 - QUEENS","121-15 LUCAS STREET"
3,3,0,"abd810ab-31f4-ea11-b882-24ee9a37d45c","Stephen T. Mather Building Arts & Craftsmanship High School - M139 - M625 - 02M139 - 439 WEST 49TH STREET","a9d810ab-31f4-ea11-b882-24ee9a37d45c",-73990318,40763655,"HS OF GRAPHIC COMMUNICATION ARTS-M","439 WEST 49TH STREET"
1,1,0,"45332a24-4afb-ea11-b883-24ee9a37d459","SAMUEL FIELD YM & YWHA (LITTLE NECK) - QAKH - QAKH -  - 58-20 LITTLE NECK PARKWAY","46332a24-4afb-ea11-b883-24ee9a37d459",-73723308,40760998,"Little Meadows- Samuel Field","58-20 LITTLE NECK PARKWAY"
4,2,2,"4ba10a44-32f4-ea11-b882-24ee9a37d45c","P.S./I.S. 266 - Q266 - Q266 - 26Q266 - 74-10 COMMONWEALTH BOULEVARD","4aa10a44-32f4-ea11-b882-24ee9a37d45c",-73728415,40746128,"P.S./I.S. 266 - QUEENS","74-10 COMMONWEALTH BOULEVARD"
2,0,2,"b42aa42b-33f4-ea11-b882-24ee9a37d45c","J.H.S. 144 Michelangelo - X144 - X144 - 11X144 - 2545 GUNTHER AVENUE","b22aa42b-33f4-ea11-b882-24ee9a37d45c",-73836525,40863842,"I.S. 144 - BRONX","2545 GUNTHER AVENUE"
4,1,3,"5f3cbf01-ebf6-ea11-b883-24ee9a37d459","P.S. X010 - X010 - X101 - 75X010 - 2750 LAFAYETTE AVENUE","4e474313-33f4-ea11-b882-24ee9a37d45c",-73829211,40827080,"I.S. 101 - BRONX","2750 LAFAYETTE AVENUE"
1,1,0,"4f507380-31f4-ea11-b882-24ee9a37d45c","P.S. 180 Hugo Newman - M180 - M180 - 03M180 - 370 WEST 120TH STREET","50507380-31f4-ea11-b882-24ee9a37d45c",-73955861,40807570,"P.S. 180 - MANHATTAN","370 WEST 120TH STREET"
4,4,0,"29b7c337-32f4-ea11-b882-24ee9a37d45c","I.S. 227 Louis Armstrong - Q227 - Q227 - 30Q227 - 32-02 JUNCTION BOULEVARD","27b7c337-32f4-ea11-b882-24ee9a37d45c",-73874614,40757567,"I.S. 227 - QUEENS","32-02 JUNCTION BOULEVARD"
4,3,1,"db11f898-32f4-ea11-b882-24ee9a37d45c","Robert F. Wagner, Jr. Secondary School for Arts and Technology - Q560 - Q891 - 24Q560 - 47-07 30th Place","d911f898-32f4-ea11-b882-24ee9a37d45c",-73936442,40742217,"R. F. WAGNER SEC SCL ARTS & TECH-Q","47-07 30th Place"
1,1,0,"6741e65b-31f4-ea11-b882-24ee9a37d45c","N.Y.C. Museum School - M414 - M070 - 02M414 - 333 WEST 17 STREET","defab455-31f4-ea11-b882-24ee9a37d45c",-74002222,40742512,"I.S. 70 - MANHATTAN","333 WEST 17 STREET"
1,0,1,"588dbfcf-30f4-ea11-b882-24ee9a37d45c","Abraham Lincoln High School - K410 - K411 - 21K410 - 2800 Ocean Parkway","598dbfcf-30f4-ea11-b882-24ee9a37d45c",-73968733,40582627,"LINCOLN AF - BROOKLYN","2800 Ocean Parkway"
2,1,1,"9353dd74-33f4-ea11-b882-24ee9a37d45c","Mott Haven Village Preparatory High School - X473 - X470 - 07X473 - 701 ST. ANNS AVENUE","9253dd74-33f4-ea11-b882-24ee9a37d45c",-73911633,40818041,"SOUTH BRONX EDUCATIONAL CAMPUS (OLD 38) - X","701 ST. ANNS AVENUE"
4,1,3,"9f48b1f5-eaf6-ea11-b883-24ee9a37d459","Brooklyn College Academy - K555 - K917 - 22K555 - 350 CONEY ISLAND AVENUE","1668ee1e-31f4-ea11-b882-24ee9a37d45c",-73972312,40649055,"BKLYN COLL ACAD (BRIDGES TO K)-K","350 CONEY ISLAND AVENUE"
5,2,3,"350d6d19-33f4-ea11-b882-24ee9a37d45c","P.S. 199X - The Shakespeare School - X199 - X104 - 09X199 - 1449 SHAKESPEARE AVENUE","360d6d19-33f4-ea11-b882-24ee9a37d45c",-73920826,40843453,"P.S. 199 - BRONX","1449 SHAKESPEARE AVENUE"
2,2,0,"26c73b4a-32f4-ea11-b882-24ee9a37d45c","A.C.E. Academy for Scholars at the Geraldine Ferraro Campus - Q290 - Q290 - 24Q290 - 55-20 METROPOLITAN AVENUE","24c73b4a-32f4-ea11-b882-24ee9a37d45c",-73908307,40713030,"THE GERALDINE FERRARO CAMPUS - QUEENS","55-20 METROPOLITAN AVENUE"
2,0,2,"8034aa92-31f4-ea11-b882-24ee9a37d45c","Hudson High School of Learning Technologies - M437 - M440 - 02M437 - 351 WEST 18 STREET","7834aa92-31f4-ea11-b882-24ee9a37d45c",-74002540,40743407,"BAYARD RUSTIN EDUCATIONAL COMP-M","351 WEST 18 STREET"
1,0,1,"eb9b4c1f-32f4-ea11-b882-24ee9a37d45c","P.S. 156 Laurelton - Q156 - Q156 - 29Q156 - 229-02 137 AVENUE","e69b4c1f-32f4-ea11-b882-24ee9a37d45c",-73743327,40672259,"P.S. 156 - QUEENS","229-02 137 AVENUE"
2,2,0,"6f2f77fa-31f4-ea11-b882-24ee9a37d45c","P.S. 066 Jacqueline Kennedy Onassis - Q066 - Q066 - 27Q066 - 85-11 102 Street","702f77fa-31f4-ea11-b882-24ee9a37d45c",-73846135,40697941,"P.S. 66 - QUEENS","85-11 102 Street"
2,0,2,"fcae1f69-ebf6-ea11-b883-24ee9a37d459","P.S. M226 - M226 - M208 - 75M226 - 21 WEST 111 STREET","938d8486-31f4-ea11-b882-24ee9a37d45c",-73950146,40798461,"P.S. 208 (TANDEM M185) - MANHATTAN","21 WEST 111 STREET"
2,2,0,"0fead4e1-d214-ec11-b8b5-24ee9a37d45c","East New York Family Academy - K409 - K599 - 19K409 - 760 Van Siclen Avenue","7b3fd300-d214-ec11-b8b5-24ee9a37d45c",-73886668,40661102,"K599 – East New York","760 Van Siclen Avenue"
1,0,1,"0ea198c3-30f4-ea11-b882-24ee9a37d45c","P.S. 328 Phyllis Wheatley - K328 - K328 - 19K328 - 330 ALABAMA AVENUE","0ca198c3-30f4-ea11-b882-24ee9a37d45c",-73898249,40667985,"P.S. 328 - BROOKLYN","330 ALABAMA AVENUE"
2,2,0,"e8b98b86-30f4-ea11-b882-24ee9a37d45c","M.S. 582 - K582 - K196 - 14K582 - 207 BUSHWICK AVENUE","e9b98b86-30f4-ea11-b882-24ee9a37d45c",-73939385,40708804,"P.S. 196 - BROOKLYN","207 BUSHWICK AVENUE"
5,1,4,"ee09e2e1-30f4-ea11-b882-24ee9a37d45c","The High School for Enterprise, Business and Technology - K478 - K450 - 14K478 - 850 GRAND STREET","e909e2e1-30f4-ea11-b882-24ee9a37d45c",-73938921,40711134,"GRAND STREET CAMPUS (OLD E.D.HS)- K","850 GRAND STREET"
9,7,2,"307eed06-32f4-ea11-b882-24ee9a37d45c","P.S. 097 Forest Park - Q097 - Q097 - 27Q097 - 85-52 85 STREET","317eed06-32f4-ea11-b882-24ee9a37d45c",-73860031,40694232,"P.S. 97 - QUEENS","85-52 85 STREET"
1,0,1,"1168ee1e-31f4-ea11-b882-24ee9a37d45c","P.S. 373 - Brooklyn Transition Center - K373 - K909 - 75K373 - 561 GRAND AVENUE","1268ee1e-31f4-ea11-b882-24ee9a37d45c",-73961636,40678591,"ACORN COMMUNITY HS - K","561 GRAND AVENUE"
3,3,0,"920e6e25-32f4-ea11-b882-24ee9a37d45c","P.S. 174 William Sidney Mount - Q174 - Q174 - 28Q174 - 65-10 DIETERLE CRESCENT","930e6e25-32f4-ea11-b882-24ee9a37d45c",-73861462,40720583,"P.S. 174 - QUEENS","65-10 DIETERLE CRESCENT"
8,6,2,"c08442ee-31f4-ea11-b882-24ee9a37d45c","P.S. 029 Queens - Q029 - Q029 - 25Q029 - 125-10 23 AVENUE","c18442ee-31f4-ea11-b882-24ee9a37d45c",-73842967,40778029,"P.S. 29 - QUEENS","125-10 23 AVENUE"
2,0,2,"e621d292-30f4-ea11-b882-24ee9a37d45c","P.S. K225 - The Eileen E. Zaglin - K225 - K225 - 21K225 - 1075 OCEAN VIEW AVENUE","e521d292-30f4-ea11-b882-24ee9a37d45c",-73955856,40580260,"P.S. 225 - BROOKLYN","1075 OCEAN VIEW AVENUE"
3,2,1,"e7f22ce2-31f4-ea11-b882-24ee9a37d45c","I.S. 5 - The Walter Crowley Intermediate School - Q005 - Q005 - 24Q005 - 50-40 JACOBUS STREET","9adc32dc-31f4-ea11-b882-24ee9a37d45c",-73888133,40737405,"I.S. 5 - QUEENS","50-40 JACOBUS STREET"
2,0,2,"38e61462-31f4-ea11-b882-24ee9a37d45c","P.S. 092 Mary McLeod Bethune - M092 - M092 - 05M092 - 222 WEST 134 STREET","36e61462-31f4-ea11-b882-24ee9a37d45c",-73945838,40814917,"P.S. 92 - MANHATTAN","222 WEST 134 STREET"
1,0,1,"a169c231-32f4-ea11-b882-24ee9a37d45c","I.S. 204 Oliver W. Holmes - Q204 - Q204 - 30Q204 - 36-41 28 STREET","9c69c231-32f4-ea11-b882-24ee9a37d45c",-73932628,40756471,"I.S. 204 - QUEENS","36-41 28 STREET"
4,2,2,"8c72c880-32f4-ea11-b882-24ee9a37d45c","Thomas A. Edison Career and Technical Education High School - Q620 - Q620 - 28Q620 - 165-65 84 AVENUE","49b4977a-32f4-ea11-b882-24ee9a37d45c",-73799692,40716071,"THOMAS A. EDISON VOC HS - Q","165-65 84 AVENUE"
1,1,0,"1c6e3d68-31f4-ea11-b882-24ee9a37d45c","P.S. 116 Mary Lindley Murray - M116 - M116 - 02M116 - 210 East 33 Street","1d6e3d68-31f4-ea11-b882-24ee9a37d45c",-73977906,40744511,"P.S. 116 - MANHATTAN","210 East 33 Street"
1,0,1,"24e2abc9-30f4-ea11-b882-24ee9a37d45c","KIPP Always Mentally Prepared Charter School - K357 - K390 - 84K357 - 1224 PARK PLACE","25e2abc9-30f4-ea11-b882-24ee9a37d45c",-73937601,40672290,"I.S. 390 - BROOKLYN","1224 PARK PLACE"
3,2,1,"70a78d44-ebf6-ea11-b883-24ee9a37d459","Brooklyn College Academy - K555 - K555 - 22K555 - 2900 Bedford Avenue","0efc3df4-30f4-ea11-b882-24ee9a37d45c",-73954800,40630673,"BKLYN COLL ACAD (AT BKLYN COLL)-K","2900 Bedford Avenue"
2,2,0,"fc454b50-32f4-ea11-b882-24ee9a37d45c","College Point Collaborative - Q379 - Q336 - 25Q379 - 12406 14TH AVENUE","fd454b50-32f4-ea11-b882-24ee9a37d45c",-73843504,40785129,"The College Point Collaborative Educational Buildi","12406 14TH AVENUE"
1,1,0,"35a10a44-32f4-ea11-b882-24ee9a37d45c","The Randolph Holder School for Social Justice - Q253 - Q253 - 27Q253 - 1307 CENTRAL AVENUE","30a10a44-32f4-ea11-b882-24ee9a37d45c",-73748799,40607247,"P.S. 253 -QUEENS","1307 CENTRAL AVENUE"
1,1,0,"725bc58c-30f4-ea11-b882-24ee9a37d45c","Urban Assembly School for Leadership and Empowerment - K609 - K223 - 20K609 - 4200 16 AVENUE","735bc58c-30f4-ea11-b882-24ee9a37d45c",-73982424,40635100,"I.S. 223 - BROOKLYN","4200 16 AVENUE"
4,4,0,"b269c231-32f4-ea11-b882-24ee9a37d45c","P.S./I.S. 208 - Q208 - Q208 - 29Q208 - 74-30 COMMONWEALTH BLVD","ab69c231-32f4-ea11-b882-24ee9a37d45c",-73727632,40744276,"P.S./I.S. 208 - QUEENS","74-30 COMMONWEALTH BLVD"
2,0,2,"bebfa431-33f4-ea11-b882-24ee9a37d45c","South Bronx Preparatory: A College Board School - X221 - X149 - 07X221 - 360 EAST 145 STREET","bcbfa431-33f4-ea11-b882-24ee9a37d45c",-73920851,40813612,"J.H.S. 149 - BRONX","360 EAST 145 STREET"
3,2,1,"ace657bd-30f4-ea11-b882-24ee9a37d45c","P.S. 321 William Penn - K321 - K321 - 15K321 - 180 7 AVENUE","ade657bd-30f4-ea11-b882-24ee9a37d45c",-73978633,40671816,"P.S. 321 - BROOKLYN","180 7 AVENUE"
1,1,0,"818946f4-31f4-ea11-b882-24ee9a37d45c","P.S. 056 Harry Eichler - Q056 - Q056 - 27Q056 - 86-10 114 STREET","828946f4-31f4-ea11-b882-24ee9a37d45c",-73835735,40698989,"P.S. 56 (OLD R HILL AX) - QUEENS","86-10 114 STREET"
1,0,1,"96e657bd-30f4-ea11-b882-24ee9a37d45c","P.S. 316 Elijah Stroud - K316 - K316 - 17K316 - 750 CLASSON AVENUE","94e657bd-30f4-ea11-b882-24ee9a37d45c",-73961418,40674685,"P.S. 316 - BROOKLYN","750 CLASSON AVENUE"
2,2,0,"912aa42b-33f4-ea11-b882-24ee9a37d45c","The Angelo Patri Middle School - X391 - X137 - 10X391 - 2225 WEBSTER AVENUE","8e2aa42b-33f4-ea11-b882-24ee9a37d45c",-73897404,40854257,"I.S. 391 (UDC) - BRONX","2225 WEBSTER AVENUE"
3,2,1,"35005d7a-31f4-ea11-b882-24ee9a37d45c","P.S. 166 The Richard Rodgers School of The Arts and Technology - M166 - M166 - 03M166 - 132 WEST 89 STREET","36005d7a-31f4-ea11-b882-24ee9a37d45c",-73972557,40788925,"P.S. 166 - MANHATTAN","132 WEST 89 STREET"
1,0,1,"72c17bb2-e11e-eb11-b885-24ee9a37d45c","P.S. Q256 - Q256 - Q438 - 75Q256 - 445 Beach 135 Street","73c17bb2-e11e-eb11-b885-24ee9a37d45c",-73855146,40577474,"P.S. 256 ANNEX - QUEENS","445 Beach 135 Street"
2,1,1,"9f476368-32f4-ea11-b882-24ee9a37d45c","Flushing High School - Q460 - Q460 - 25Q460 - 35-01 UNION STREET","97476368-32f4-ea11-b882-24ee9a37d45c",-73826811,40764892,"FLUSHING HS - Q","35-01 UNION STREET"
2,2,0,"1206003e-32f4-ea11-b882-24ee9a37d45c","P.S. 232 Lindenwood - Q232 - Q232 - 27Q232 - 153-23 83 STREET","1106003e-32f4-ea11-b882-24ee9a37d45c",-73850622,40665408,"P.S. 232 - QUEENS","153-23 83 STREET"
1,0,1,"04af1f69-ebf6-ea11-b883-24ee9a37d459","P.S. M094 - M094 - M340 - 75M094 - 590 SIXTH AVENUE","e3e0838c-31f4-ea11-b882-24ee9a37d45c",-73995534,40739145,"THE SIXTH AVENUE EDUCATIONAL CAMPUS - MANHATTAN","64 WEST 17 STREET"
2,2,0,"45e61462-31f4-ea11-b882-24ee9a37d45c","Bard High School Early College - M696 - M097 - 01M696 - 525 EAST HOUSTON STREET","46e61462-31f4-ea11-b882-24ee9a37d45c",-73976093,40718276,"BARD COLLEGE HS (OLD M097) - M","525 EAST HOUSTON STREET"
1,0,1,"a5dab801-ecf6-ea11-b883-24ee9a37d459","Rose Hill Pre-K Center - X535 - X432 - 10X535 - 2490-2500 WEBSTER AVENUE","ae3aa668-33f4-ea11-b882-24ee9a37d45c",-73891838,40860601,"PRE-K CENTER @WEBSTER AVENUE - BRONX","2490-2500 WEBSTER AVENUE"
2,0,2,"a932c3fb-eaf6-ea11-b883-24ee9a37d459","P.S. Q004 - Q004 - Q179 - 75Q004 - 196-25 Peck Avenue","9c0e6e25-32f4-ea11-b882-24ee9a37d45c",-73778118,40741700,"P.S. 179 - QUEENS","196-25 Peck Avenue"
2,0,2,"fde1abc9-30f4-ea11-b882-24ee9a37d45c","P.S. 156 Waverly - K156 - K356 - 23K156 - 104 SUTTER AVENUE","35a198c3-30f4-ea11-b882-24ee9a37d45c",-73917880,40665553,"P.S. 156 - BROOKLYN","104 SUTTER AVENUE"
1,0,1,"780067b2-ebf6-ea11-b883-24ee9a37d459","Curious Young Learners Pre-K Center - Q336 - Q477 - 27Q336 - 87-40 88 STREET","68bc9674-32f4-ea11-b882-24ee9a37d45c",-73856363,40691406,"3K CENTER @ 87-40 88 STREET - QUEENS","87-40 88 STREET"
3,2,1,"7303194f-30f4-ea11-b882-24ee9a37d45c","P.S. 69 Vincent D. Grippo School - K069 - K069 - 20K069 - 6302 9TH AVENUE","7203194f-30f4-ea11-b882-24ee9a37d45c",-74009752,40632392,"P.S. 69 - BROOKLYN","6302 9TH AVENUE"
7,2,5,"bd8442ee-31f4-ea11-b882-24ee9a37d45c","P.S. 28 - The Thomas Emanuel Early Childhood Center - Q028 - Q028 - 24Q028 - 109-10 47 AVENUE","be8442ee-31f4-ea11-b882-24ee9a37d45c",-73854268,40747017,"P.S. 28 - QUEENS","109-10 47 AVENUE"
1,0,1,"db8fd20d-ebf6-ea11-b883-24ee9a37d459","P.S. K771 - K771 - K014 - 75K771 - 2424 BATCHELDER STREET","eef57030-30f4-ea11-b882-24ee9a37d45c",-73938107,40593232,"I.S. 14 - BROOKLYN","2424 BATCHELDER STREET"
1,1,0,"86eb6056-32f4-ea11-b882-24ee9a37d45c","The CIVIC School of Bayside Hills - Q390 - Q361 - 26Q390 - 56-10 214 Street","85eb6056-32f4-ea11-b882-24ee9a37d45c",-73764954,40749673,"P.S. @ 56-10 214 STREET - QUEENS","56-10 214 Street"
1,1,0,"179ebaee-32f4-ea11-b882-24ee9a37d45c","Milton Fein School - X007 - X007 - 10X007 - 3201 KINGSBRIDGE AVENUE","189ebaee-32f4-ea11-b882-24ee9a37d45c",-73905697,40881562,"P.S. 7 - BRONX","3201 KINGSBRIDGE AVENUE"
4,3,1,"c392e6d5-30f4-ea11-b882-24ee9a37d45c","Cultural Academy for the Arts and Sciences - K629 - K415 - 18K629 - 5800 TILDEN AVENUE","5b8dbfcf-30f4-ea11-b882-24ee9a37d45c",-73922212,40647728,"SAMUEL J. TILDEN EDUCATIONAL CAMPUS - K","5800 TILDEN AVENUE"
3,1,2,"89886843-31f4-ea11-b882-24ee9a37d45c","P.S. 005 Ellen Lurie - M005 - M005 - 06M005 - 3703 TENTH AVENUE","8a886843-31f4-ea11-b882-24ee9a37d45c",-73922277,40857633,"P.S. 5 - MANHATTAN","3703 TENTH AVENUE"
2,2,0,"ed17b7f4-32f4-ea11-b882-24ee9a37d45c","P.S. 024 Spuyten Duyvil - X024 - X024 - 10X024 - 660 WEST 236 STREET","ee17b7f4-32f4-ea11-b882-24ee9a37d45c",-73915114,40886922,"P.S. 24 - BRONX","660 WEST 236 STREET"
1,0,1,"340b210d-33f4-ea11-b882-24ee9a37d45c","Creston Academy - X447 - X079 - 10X447 - 125 EAST 181 STREET","2c0b210d-33f4-ea11-b882-24ee9a37d45c",-73903139,40855337,"P.S. 79 - BRONX","125 EAST 181 STREET"
1,1,0,"07ba8b86-30f4-ea11-b882-24ee9a37d45c","Explore Empower Charter School - K742 - K210 - 84K742 - 188 ROCHESTER AVENUE","08ba8b86-30f4-ea11-b882-24ee9a37d45c",-73928917,40672710,"I.S. 394 - BROOKLYN","188 ROCHESTER AVENUE"
1,1,0,"bde0838c-31f4-ea11-b882-24ee9a37d45c","Washington Heights Academy - M366 - M263 - 06M366 - 202 SHERMAN AVE","bee0838c-31f4-ea11-b882-24ee9a37d45c",-73921631,40865575,"PS/IS 263 - Manhattan","202 SHERMAN AVE"
3,1,2,"8801ce37-33f4-ea11-b882-24ee9a37d45c","P.S. 157 Grove Hill - X157 - X157 - 07X157 - 757 CAULDWELL AVENUE","8901ce37-33f4-ea11-b882-24ee9a37d45c",-73908965,40819419,"P.S. 157 - BRONX","757 CAULDWELL AVENUE"
3,0,3,"a7886843-31f4-ea11-b882-24ee9a37d45c","P.S. 015 Roberto Clemente - M015 - M015 - 01M015 - 333 EAST 4 STREET","a5886843-31f4-ea11-b882-24ee9a37d45c",-73978747,40722075,"P.S. 15 - MANHATTAN","333 EAST 4 STREET"
8,5,3,"9748b1f5-eaf6-ea11-b883-24ee9a37d459","P.S. 372 -The Children's School - K372 - K834 - 75K372 - 512 CARROLL STREET","fcd7cf12-31f4-ea11-b882-24ee9a37d45c",-73985500,40676198,"P.S. 372 (OUR LADY OF PEACE)-K","512 CARROLL STREET"
6,4,2,"d79b4c1f-32f4-ea11-b882-24ee9a37d45c","P.S. 150 Queens - Q150 - Q150 - 30Q150 - 40-01 43 AVENUE","d89b4c1f-32f4-ea11-b882-24ee9a37d45c",-73923375,40745887,"P.S. 150 - QUEENS","40-01 43 AVENUE"
1,1,0,"2d7c21b7-32f4-ea11-b882-24ee9a37d45c","P.S. 001 Tottenville - R001 - R001 - 31R001 - 58 SUMMIT STREET","2e7c21b7-32f4-ea11-b882-24ee9a37d45c",-74243950,40508638,"P.S. 1 - STATEN ISLAND","58 SUMMIT STREET"
3,1,2,"f4fb3df4-30f4-ea11-b882-24ee9a37d45c","P.S. 160 William T. Sampson - K160 - K521 - 20K160 - 1057 52ND STREET","f5fb3df4-30f4-ea11-b882-24ee9a37d45c",-73999057,40636501,"P.S. 160 ANNEX - BROOKLYN","1057 52ND STREET"
1,1,0,"0be63126-ebf6-ea11-b883-24ee9a37d459","P.S. 36 - K036 - K224 - 75K036 - 757 WORTMAN AVENUE","e121d292-30f4-ea11-b882-24ee9a37d45c",-73866542,40664143,"P.S. 224 - BROOKLYN","757 WORTMAN AVENUE"
1,0,1,"f1b98b86-30f4-ea11-b882-24ee9a37d45c","P.S. 196 Ten Eyck - K196 - K196 - 14K196 - 207 BUSHWICK AVENUE","e9b98b86-30f4-ea11-b882-24ee9a37d45c",-73939385,40708804,"P.S. 196 - BROOKLYN","207 BUSHWICK AVENUE"
2,2,0,"8d01ce37-33f4-ea11-b882-24ee9a37d45c","Dr. Richard Izquierdo Health and Science Charter School - X482 - X158 - 84X482 - 800 HOME STREET","8601ce37-33f4-ea11-b882-24ee9a37d45c",-73900593,40826933,"I.S. 158 - BRONX","800 HOME STREET"
4,2,2,"7836d900-33f4-ea11-b882-24ee9a37d45c","P.S. 059 The Community School of Technology - X059 - X059 - 10X059 - 2185 BATHGATE AVENUE","7936d900-33f4-ea11-b882-24ee9a37d45c",-73893639,40853141,"P.S. 59 - BRONX","2185 BATHGATE AVENUE"
3,1,2,"52507380-31f4-ea11-b882-24ee9a37d45c","P.S. 183 Robert L. Stevenson - M183 - M183 - 02M183 - 419 East 66 Street","53507380-31f4-ea11-b882-24ee9a37d45c",-73957731,40763804,"P.S. 183 - MANHATTAN","419 East 66 Street"
3,0,3,"dea2f813-ebf6-ea11-b883-24ee9a37d459","P.S. K771 - K771 - K066 - 75K771 - 845 EAST 96 STREET","cc79df48-30f4-ea11-b882-24ee9a37d45c",-73907064,40648749,"P.S. 66 - BROOKLYN","845 EAST 96 STREET"
2,1,1,"1402926e-32f4-ea11-b882-24ee9a37d45c","Academy of Medical Technology: A College Board School - Q309 - Q465 - 27Q309 - 8-21 BAY 25 STREET","0b02926e-32f4-ea11-b882-24ee9a37d45c",-73763995,40601537,"FAR ROCKAWAY HS - Q","8-21 BAY 25 STREET"
1,0,1,"8e476368-32f4-ea11-b882-24ee9a37d45c","International High School for Health Sciences - Q236 - Q455 - 24Q236 - 48-01 90 STREET","8c476368-32f4-ea11-b882-24ee9a37d45c",-73874129,40740824,"NEWTOWN HS - Q","48-01 90 STREET"
1,0,1,"2eebaa73-30f4-ea11-b882-24ee9a37d45c","P.S. 160 William T. Sampson - K160 - K160 - 20K160 - 5105 Fort Hamilton Parkway","27ebaa73-30f4-ea11-b882-24ee9a37d45c",-73999045,40636932,"P.S. 160 - BROOKLYN","5105 Fort Hamilton Parkway"
6,5,1,"6e36d900-33f4-ea11-b882-24ee9a37d45c","P.S. 056 Norwood Heights - X056 - X056 - 10X056 - 341 EAST 207 STREET","6f36d900-33f4-ea11-b882-24ee9a37d45c",-73874912,40875481,"P.S. 56 - BRONX","341 EAST 207 STREET"
1,1,0,"21b4977a-32f4-ea11-b882-24ee9a37d45c","International High School at LaGuardia Community College - Q530 - Q520 - 24Q530 - 45-35 VAN DAM STREET","22b4977a-32f4-ea11-b882-24ee9a37d45c",-73933316,40743253,"MIDDLE COLLEGE CAMPUS - QUEENS","45-35 VAN DAM STREET"
6,2,4,"509f4974-31f4-ea11-b882-24ee9a37d45c","P.S. 146 Ann M. Short - M146 - M146 - 04M146 - 421 EAST 106 STREET","4f9f4974-31f4-ea11-b882-24ee9a37d45c",-73938727,40789535,"P.S. 146 - MANHATTAN","421 EAST 106 STREET"
1,0,1,"ac8fd48d-ebf6-ea11-b883-24ee9a37d459","P.S. Q233 - Q233 - Q042 - 75Q233 - 488 Beach 66 Street","ea8442ee-31f4-ea11-b882-24ee9a37d45c",-73794804,40594358,"P.S. 42 - QUEENS","488 Beach 66 Street"
1,1,0,"489d7c62-33f4-ea11-b882-24ee9a37d45c","Astor Collegiate Academy - X299 - X415 - 11X299 - 925 ASTOR AVENUE","439d7c62-33f4-ea11-b882-24ee9a37d45c",-73860729,40860443,"CHRISTOPHER COLUMBUS HS - X","925 ASTOR AVENUE"
2,0,2,"807e21a6-ebf6-ea11-b883-24ee9a37d459","P.S. Q224 - Q224 - Q266 - 75Q224 - 74-10 COMMONWEALTH BOULEVARD","4aa10a44-32f4-ea11-b882-24ee9a37d45c",-73728415,40746128,"P.S./I.S. 266 - QUEENS","74-10 COMMONWEALTH BOULEVARD"
1,1,0,"4788e6db-30f4-ea11-b882-24ee9a37d45c","M.S. 839 - K839 - K437 - 15K839 - 713 CATON AVENUE","4488e6db-30f4-ea11-b882-24ee9a37d45c",-73973363,40647598,"P.S./I.S. 437 - BROOKLYN","713 CATON AVENUE"
2,0,2,"6ea5db98-30f4-ea11-b882-24ee9a37d45c","Andries Hudde - K240 - K240 - 22K240 - 2500 NOSTRAND AVENUE","69a5db98-30f4-ea11-b882-24ee9a37d45c",-73946836,40623788,"I.S. 240 - BROOKLYN","2500 NOSTRAND AVENUE"
2,2,0,"8f2aa42b-33f4-ea11-b882-24ee9a37d45c","Theatre Arts Production Company School - X225 - X137 - 10X225 - 2225 WEBSTER AVENUE","8e2aa42b-33f4-ea11-b882-24ee9a37d45c",-73897404,40854257,"I.S. 391 (UDC) - BRONX","2225 WEBSTER AVENUE"
3,2,1,"90bc9674-32f4-ea11-b882-24ee9a37d45c","Hillcrest High School - Q505 - Q505 - 28Q505 - 160-05 HIGHLAND AVENUE","8fbc9674-32f4-ea11-b882-24ee9a37d45c",-73803001,40709461,"HILLCREST HS - Q","160-05 HIGHLAND AVENUE"
2,2,0,"bab36d80-30f4-ea11-b882-24ee9a37d45c","The SEEALL Academy - K180 - K180 - 20K180 - 5601 16 AVENUE","b8b36d80-30f4-ea11-b882-24ee9a37d45c",-73989250,40626454,"P.S. 180 - BROOKLYN","5601 16 AVENUE"
2,0,2,"0d8bc007-ebf6-ea11-b883-24ee9a37d459","Passages Academy - X695 - X991 - 79X695 - 560 BROOK AVENUE","0178bb9f-33f4-ea11-b882-24ee9a37d45c",-73913386,40814614,"PASSAGES ACADEMY(HORIZON) - BRONX","560 BROOK AVENUE"
3,0,3,"7da9d9c3-32f4-ea11-b882-24ee9a37d45c","P.S. 030 Westerleigh - R030 - R030 - 31R030 - 200 Wardwell Avenue","73a9d9c3-32f4-ea11-b882-24ee9a37d45c",-74133080,40618097,"P.S. 30 - STATEN ISLAND","200 Wardwell Avenue"
1,0,1,"6336d900-33f4-ea11-b882-24ee9a37d45c","P.S. 053 Basheer Quisim - X053 - X053 - 09X053 - 360 EAST 168 STREET","6436d900-33f4-ea11-b882-24ee9a37d45c",-73911906,40832648,"P.S. 53 - BRONX","360 EAST 168 STREET"
4,3,1,"3aa10a44-32f4-ea11-b882-24ee9a37d45c","P.S. 254 - The Rosa Parks School - Q254 - Q254 - 27Q254 - 84-40 101 STREET","39a10a44-32f4-ea11-b882-24ee9a37d45c",-73847886,40697200,"P.S. 254 - QUEENS","84-40 101 STREET"
1,1,0,"818d8486-31f4-ea11-b882-24ee9a37d45c","P.S. 77 Lower Lab School - M077 - M198 - 02M077 - 1700 3 AVENUE","7f8d8486-31f4-ea11-b882-24ee9a37d45c",-73950420,40785018,"P.S. 198 - MANHATTAN","1700 3 AVENUE"
1,0,1,"0d2ed53d-33f4-ea11-b882-24ee9a37d45c","P.S. 163 Arthur A. Schomburg - X163 - X163 - 09X163 - 2075 Webster Avenue","0e2ed53d-33f4-ea11-b882-24ee9a37d45c",-73899005,40851700,"P.S. 163 - BRONX","2075 Webster Avenue"
1,0,1,"1703cefa-32f4-ea11-b882-24ee9a37d45c","P.S. 043 Jonas Bronck - X043 - X043 - 07X043 - 165 BROWN PLACE","1803cefa-32f4-ea11-b882-24ee9a37d45c",-73921593,40806452,"P.S. 43 - BRONX","165 BROWN PLACE"
1,0,1,"69c130ae-6c0c-ed11-b091-088e901ef405","P.S. X010 - X010 - X104 - 75X010 - 1449 SHAKESPEARE AVENUE","360d6d19-33f4-ea11-b882-24ee9a37d45c",-73920826,40843453,"P.S. 199 - BRONX","1449 SHAKESPEARE AVENUE"
1,1,0,"0018b7f4-32f4-ea11-b882-24ee9a37d45c","American Dream Charter School - X471 - X030 - 84X471 - 510 EAST 141 STREET","0118b7f4-32f4-ea11-b882-24ee9a37d45c",-73917417,40809023,"P.S. 30 - BRONX","510 EAST 141 STREET"
3,0,3,"16b7c337-32f4-ea11-b882-24ee9a37d45c","P.S. 223 Lyndon B. Johnson - Q223 - Q223 - 27Q223 - 125-20 Sutphin Boulevard","09b7c337-32f4-ea11-b882-24ee9a37d45c",-73789530,40673898,"P.S. 223 - QUEENS","125-20 Sutphin Boulevard"
10,8,2,"512b3eee-30f4-ea11-b882-24ee9a37d45c","Fort Hamilton High School - K490 - K490 - 20K490 - 8301 SHORE ROAD","522b3eee-30f4-ea11-b882-24ee9a37d45c",-74038103,40626827,"FORT HAMILTON HS - K","8301 SHORE ROAD"
1,0,1,"552f7d06-31f4-ea11-b882-24ee9a37d45c","P.S. 112 Lefferts Park - K112 - K768 - 20K112 - 7301 15th Avenue","562f7d06-31f4-ea11-b882-24ee9a37d45c",-74001900,40618726,"P.S. 768 - BROOKLYN","7301 15th Avenue"
2,2,0,"55a5db98-30f4-ea11-b882-24ee9a37d45c","J.H.S. 234 Arthur W. Cunningham - K234 - K234 - 22K234 - 1875 EAST 17 STREET","56a5db98-30f4-ea11-b882-24ee9a37d45c",-73955217,40604447,"I.S. 234 - BROOKLYN","1875 EAST 17 STREET"
3,2,1,"add810ab-31f4-ea11-b882-24ee9a37d45c","Business Of Sports School - M393 - M625 - 02M393 - 439 WEST 49TH STREET","a9d810ab-31f4-ea11-b882-24ee9a37d45c",-73990318,40763655,"HS OF GRAPHIC COMMUNICATION ARTS-M","439 WEST 49TH STREET"
3,1,2,"b68442ee-31f4-ea11-b882-24ee9a37d45c","P.S. 026 Rufus King - Q026 - Q026 - 26Q026 - 195-02 69 AVENUE","c5fc24e8-31f4-ea11-b882-24ee9a37d45c",-73777607,40735935,"P.S. 26 - QUEENS","195-02 69 AVENUE"
3,0,3,"86c1797b-ebf6-ea11-b883-24ee9a37d459","P.S. M094 - M094 - M971 - 75M094 - 12 SPRUCE STREET","01ee94c3-31f4-ea11-b882-24ee9a37d45c",-74005473,40711321,"THE SPRUCE STREET EDUCATIONAL CAMPUS","12 SPRUCE STREET"
3,0,3,"bd0d3c5b-30f4-ea11-b882-24ee9a37d45c","P.S. 094 The Henry Longfellow - K094 - K094 - 15K094 - 5010 6 AVENUE","8fd92255-30f4-ea11-b882-24ee9a37d45c",-74008795,40643730,"P.S. 94 - BROOKLYN","5010 6 AVENUE"
1,0,1,"5ade5eb7-30f4-ea11-b882-24ee9a37d45c","P.S. 306 Ethan Allen - K306 - K306 - 19K306 - 970 VERMONT STREET","59de5eb7-30f4-ea11-b882-24ee9a37d45c",-73886620,40655340,"P.S. 306 - BROOKLYN","970 VERMONT STREET"
2,0,2,"7e8d8486-31f4-ea11-b882-24ee9a37d45c","P.S. 198 Isador E. Ida Straus - M198 - M198 - 02M198 - 1700 3 AVENUE","7f8d8486-31f4-ea11-b882-24ee9a37d45c",-73950420,40785018,"P.S. 198 - MANHATTAN","1700 3 AVENUE"
2,1,1,"e8c1392a-30f4-ea11-b882-24ee9a37d45c","Explore Charter School - K704 - K002 - 84K704 - 655 Parkside Avenue","dfc1392a-30f4-ea11-b882-24ee9a37d45c",-73951575,40656423,"I.S. 2 - BROOKLYN","655 Parkside Avenue"
2,2,0,"6373198d-e31e-eb11-b885-24ee9a37d45c","American Dream Charter School - X471 - XAXQ - 84X471 - 403 Concord Avenue","a7845cb8-33f4-ea11-b882-24ee9a37d45c",-73909595,40809100,"Heketi Community Charter School","403 Concord Avenue"
6,2,4,"cbe8ce00-32f4-ea11-b882-24ee9a37d45c","I.S. 73 - The Frank Sansivieri Intermediate School - Q073 - Q073 - 24Q073 - 70-02 54 AVENUE","cce8ce00-32f4-ea11-b882-24ee9a37d45c",-73893318,40728558,"I.S. 73 - QUEENS","70-02 54 AVENUE"
3,2,1,"d3ed94c3-31f4-ea11-b882-24ee9a37d45c","Young Women's Leadership School - M610 - M895 - 04M610 - 105 East 106th Street","d4ed94c3-31f4-ea11-b882-24ee9a37d45c",-73947171,40792932,"YOUNG WOMEN'S LEADERSHIP HS - M","105 East 106th Street"
7,7,0,"ff02cefa-32f4-ea11-b882-24ee9a37d45c","P.S. 036 Unionport - X036 - X036 - 08X036 - 1070 Castle Hill Avenue","0c18b7f4-32f4-ea11-b882-24ee9a37d45c",-73849791,40829480,"P.S. 36 - BRONX","1070 Castle Hill Avenue"
1,0,1,"cab36d80-30f4-ea11-b882-24ee9a37d45c","P.S. 184 Newport - K184 - K184 - 23K184 - 273 NEWPORT STREET","c8b36d80-30f4-ea11-b882-24ee9a37d45c",-73905004,40660385,"P.S. 184 - BROOKLYN","273 NEWPORT STREET"
1,0,1,"daaeb707-ecf6-ea11-b883-24ee9a37d459","P.S. X017 - X017 - X450 - 75X017 - 1980 LAFAYETTE AVENUE","62ffcc6e-33f4-ea11-b882-24ee9a37d45c",-73855930,40821218,"Adlai E. Stevenson Educational Campus","1980 LAFAYETTE AVENUE"
5,5,0,"fbf22ce2-31f4-ea11-b882-24ee9a37d45c","I.S. 010 Horace Greeley - Q010 - Q010 - 30Q010 - 45-11 31st Ave","fcf22ce2-31f4-ea11-b882-24ee9a37d45c",-73911962,40760122,"I.S. 10 - QUEENS","45-11 31st Ave"
3,2,1,"1f005d7a-31f4-ea11-b882-24ee9a37d45c","P.S. 158 Bayard Taylor - M158 - M158 - 02M158 - 1458 YORK AVENUE","1d005d7a-31f4-ea11-b882-24ee9a37d45c",-73950745,40770215,"P.S. 158 - MANHATTAN","1458 YORK AVENUE"
1,0,1,"e7883319-32f4-ea11-b882-24ee9a37d45c","P.S. 146 Howard Beach - Q146 - Q146 - 27Q146 - 98-01 159 AVENUE","e8883319-32f4-ea11-b882-24ee9a37d45c",-73834896,40660531,"P.S. 146 - QUEENS","98-01 159 AVENUE"
3,2,1,"c52ff20c-32f4-ea11-b882-24ee9a37d45c","P.S./I.S. 113 Anthony J. Pranzo - Q113 - Q113 - 24Q113 - 78-23 87TH STREET","c62ff20c-32f4-ea11-b882-24ee9a37d45c",-73861493,40705476,"P.S./I.S. 113 - QUEENS","78-23 87TH STREET"
1,0,1,"176e3d68-31f4-ea11-b882-24ee9a37d45c","KIPP NYC Washington Heights Academy Charter School - M068 - M115 - 84M068 - 586 WEST 177 STREET","166e3d68-31f4-ea11-b882-24ee9a37d45c",-73935140,40846116,"P.S. 115 - MANHATTAN","586 WEST 177 STREET"
1,0,1,"7c977d2b-32f4-ea11-b882-24ee9a37d45c","P.S. 191 Mayflower - Q191 - Q191 - 26Q191 - 85-15 258 STREET","7b977d2b-32f4-ea11-b882-24ee9a37d45c",-73708617,40734266,"P.S. 191 - QUEENS","85-15 258 STREET"
1,1,0,"47953aac-ebf6-ea11-b883-24ee9a37d459","Mosaic Pre-K Center - Q331 - Q372 - 24Q331 - 104-14 ROOSEVELT AVENUE","8beb6056-32f4-ea11-b882-24ee9a37d45c",-73861044,40749771,"PRE-K CENTER @ 104-14 ROOSEVELT AVENUE - QUEENS","104-14 ROOSEVELT AVENUE"
1,0,1,"9a778cb8-ebf6-ea11-b883-24ee9a37d459","P.S. Q993 - Q993 - Q499 - 75Q993 - 148-20 REEVES AVENUE","8bbc9674-32f4-ea11-b882-24ee9a37d45c",-73820821,40738599,"P.S./I.S. 499 - QUEENS","148-20 REEVES AVENUE"
2,2,0,"f59b4c1f-32f4-ea11-b882-24ee9a37d45c","P.S. 159 - Q159 - Q159 - 26Q159 - 205-01 33 AVENUE","f69b4c1f-32f4-ea11-b882-24ee9a37d45c",-73783973,40770108,"P.S. 159 - QUEENS","205-01 33 AVENUE"
1,1,0,"76b50aa5-30f4-ea11-b882-24ee9a37d45c","P.S. 264 Bay Ridge Elementary School For The Arts - K264 - K264 - 20K264 - 371 89th Street","74b50aa5-30f4-ea11-b882-24ee9a37d45c",-74029444,40621025,"PS 264 BAY RIDGE ELEM SCL FOR THE ARTS - BROOKLYN","371 89th Street"
1,1,0,"b73aa668-33f4-ea11-b882-24ee9a37d45c","Fordham High School for the Arts - X437 - X435 - 10X437 - 500 EAST FORDHAM ROAD","b03aa668-33f4-ea11-b882-24ee9a37d45c",-73888625,40859466,"THEODORE ROOSEVELT EDUCATIONAL CAMPUS - X","500 EAST FORDHAM ROAD"
12,11,1,"668946f4-31f4-ea11-b882-24ee9a37d45c","P.S. 049 Dorothy Bonawit Kole - Q049 - Q049 - 24Q049 - 63-60 80th Street","678946f4-31f4-ea11-b882-24ee9a37d45c",-73875493,40719567,"P.S./I.S. 49 - QUEENS","63-60 80th Street"
4,0,4,"82283fb1-30f4-ea11-b882-24ee9a37d45c","Bushwick Community High School - K564 - K291 - 32K564 - 231 PALMETTO STREET","83283fb1-30f4-ea11-b882-24ee9a37d45c",-73915217,40695875,"I.S. 291 - BROOKLYN","231 PALMETTO STREET"
5,0,5,"cd79df48-30f4-ea11-b882-24ee9a37d45c","P.S. 66 - K066 - K066 - 18K066 - 845 EAST 96 STREET","cc79df48-30f4-ea11-b882-24ee9a37d45c",-73907064,40648749,"P.S. 66 - BROOKLYN","845 EAST 96 STREET"
2,2,0,"e7201dab-30f4-ea11-b882-24ee9a37d45c","J.H.S. 278 Marine Park - K278 - K278 - 22K278 - 1925 STUART STREET","e8201dab-30f4-ea11-b882-24ee9a37d45c",-73938721,40606745,"I.S. 278 - BROOKLYN","1925 STUART STREET"
1,0,1,"37a10a44-32f4-ea11-b882-24ee9a37d45c","P.S. Q256 - Q256 - Q253 - 75Q256 - 1307 CENTRAL AVENUE","30a10a44-32f4-ea11-b882-24ee9a37d45c",-73748799,40607247,"P.S. 253 -QUEENS","1307 CENTRAL AVENUE"
3,2,1,"b272c880-32f4-ea11-b882-24ee9a37d45c","Robert F. Kennedy Community High School - Q670 - Q707 - 25Q670 - 75-40 PARSONS BOULEVARD","b372c880-32f4-ea11-b882-24ee9a37d45c",-73811408,40725280,"R. F. KENNEDY COMM. MIDDLE/HS-Q","75-40 PARSONS BOULEVARD"
10,7,3,"fbfb3df4-30f4-ea11-b882-24ee9a37d45c","Edward R. Murrow High School - K525 - K525 - 21K525 - 1600 AVENUE L","fafb3df4-30f4-ea11-b882-24ee9a37d45c",-73959141,40619671,"EDWARD R. MURROW HS - K","1600 AVENUE L"
7,6,1,"a52aa42b-33f4-ea11-b882-24ee9a37d45c","Riverdale / Kingsbridge Academy (Middle School / High School 141) - X141 - X141 - 10X141 - 660 West 237 Street","a62aa42b-33f4-ea11-b882-24ee9a37d45c",-73914141,40887407,"M.S./H.S. 141 - BRONX","660 West 237 Street"
2,2,0,"e3c4bd60-4afb-ea11-b883-24ee9a37d459","EVBO, INC. DBA JACK & JILL NURSERY SCHOOL - QATU - QATU -  - 43-23 COLDEN STREET","e4c4bd60-4afb-ea11-b883-24ee9a37d459",-73824913,40752470,"EVBO, INC. DBA JACK & JILL NURSERY SCHOOL","43-23 COLDEN STREET"
8,6,2,"9672c880-32f4-ea11-b882-24ee9a37d45c","High School for Construction Trades, Engineering and Architecture - Q650 - Q650 - 27Q650 - 94-06 104TH STREET","8f72c880-32f4-ea11-b882-24ee9a37d45c",-73841475,40689177,"HS FOR CONST.TRADES,ENGG.,& ARCH-Q","94-06 104TH STREET"
1,0,1,"45ef7338-ebf6-ea11-b883-24ee9a37d459","P.S. K053 - K053 - K437 - 75K053 - 713 CATON AVENUE","4488e6db-30f4-ea11-b882-24ee9a37d45c",-73973363,40647598,"P.S./I.S. 437 - BROOKLYN","713 CATON AVENUE"
2,1,1,"53ffcc6e-33f4-ea11-b882-24ee9a37d45c","World View High School - X353 - X440 - 10X353 - 100 WEST MOSHOLU PARKWAY SOUTH","4cffcc6e-33f4-ea11-b882-24ee9a37d45c",-73889011,40879958,"DEWITT CLINTON HS - X","100 WEST MOSHOLU PARKWAY SOUTH"
2,0,2,"84977d2b-32f4-ea11-b882-24ee9a37d45c","P.S. Q256 - Q256 - Q198 - 75Q256 - 3-65 BEACH 56 STREET","85977d2b-32f4-ea11-b882-24ee9a37d45c",-73786649,40594008,"I.S. 198 - QUEENS","3-65 BEACH 56 STREET"
2,2,0,"b779df48-30f4-ea11-b882-24ee9a37d45c","P.S. 058 The Carroll - K058 - K058 - 15K058 - 330 SMITH STREET","b879df48-30f4-ea11-b882-24ee9a37d45c",-73995486,40680379,"P.S. 58 - BROOKLYN","330 SMITH STREET"
3,0,3,"f7d27c6d-30f4-ea11-b882-24ee9a37d45c","P.S. 153 Homecrest - K153 - K153 - 21K153 - 1970 HOMECREST AVENUE","f8d27c6d-30f4-ea11-b882-24ee9a37d45c",-73960027,40601179,"P.S. 153 - BROOKLYN","1970 HOMECREST AVENUE"
1,0,1,"23ff3d8d-33f4-ea11-b882-24ee9a37d45c","Bronx Leadership Academy High School - X525 - X876 - 09X525 - 1710 Webster Avenue","24ff3d8d-33f4-ea11-b882-24ee9a37d45c",-73902969,40843250,"BRONX LEADERSHIP ACADEMY - BRONX","1710 Webster Avenue"
4,3,1,"5d2f7d06-31f4-ea11-b882-24ee9a37d45c","El Puente Academy for Peace and Justice - K685 - K778 - 14K685 - 250 Hooper Street","5e2f7d06-31f4-ea11-b882-24ee9a37d45c",-73955741,40705540,"EL PUENTE HS - BROOKLYN","250 Hooper Street"
3,0,3,"5ae61462-31f4-ea11-b882-24ee9a37d45c","P.S. 108 Assemblyman Angelo Del Toro Educational Complex - M108 - M108 - 04M108 - 1615 MADISON AVENUE","5be61462-31f4-ea11-b882-24ee9a37d45c",-73947855,40795032,"P.S. 108 - MANHATTAN","1615 MADISON AVENUE"
1,0,1,"e4ba3c50-33f4-ea11-b882-24ee9a37d45c","P.S. 583 - X583 - X317 - 08X583 - 1028 WHITE PLAINS ROAD","e5ba3c50-33f4-ea11-b882-24ee9a37d45c",-73859622,40826949,"P.S. 317 - BRONX","1028 WHITE PLAINS ROAD"
2,1,1,"ea21d292-30f4-ea11-b882-24ee9a37d45c","P.S. 226 Alfred De B. Mason - K226 - K226 - 21K226 - 6006 23 AVENUE","eb21d292-30f4-ea11-b882-24ee9a37d45c",-73977099,40615405,"P.S. 226 - BROOKLYN","6006 23 AVENUE"
2,2,0,"1b0410ca-32f4-ea11-b882-24ee9a37d45c","P.S. 044 Thomas C. Brown - R044 - R044 - 31R044 - 80 MAPLE PARKWAY","1c0410ca-32f4-ea11-b882-24ee9a37d45c",-74157303,40631689,"P.S. 44 - STATEN ISLAND","80 MAPLE PARKWAY"
1,0,1,"ac72c880-32f4-ea11-b882-24ee9a37d45c","Queens Transition Center - Q752 - Q695 - 75Q752 - 160-20 GOETHALS AVENUE","ad72c880-32f4-ea11-b882-24ee9a37d45c",-73805923,40718027,"QUEENS GATEWAY TO HEALTH SCIENCES SECONDARY SCHOOL","160-20 GOETHALS AVENUE"
7,4,3,"18474313-33f4-ea11-b882-24ee9a37d45c","P.S. 086 Kingsbridge Heights - X086 - X086 - 10X086 - 2756 RESERVOIR AVENUE","19474313-33f4-ea11-b882-24ee9a37d45c",-73897066,40869061,"P.S. 86 - BRONX","2756 RESERVOIR AVENUE"
4,4,0,"e437fba4-31f4-ea11-b882-24ee9a37d45c","Urban Assembly Maker Academy - M282 - M520 - 02M282 - 411 PEARL STREET","e037fba4-31f4-ea11-b882-24ee9a37d45c",-74000851,40711441,"MURRY BERGTRAUM HS (ECF) - M","411 PEARL STREET"
3,1,2,"afeb6056-32f4-ea11-b882-24ee9a37d45c","New Visions Charter High School for Advanced Math and Science IV - Q320 - Q400 - 84Q320 - 156-10 BAISLEY BOULEVARD","a9eb6056-32f4-ea11-b882-24ee9a37d45c",-73782684,40673949,"AUGUST MARTIN HS - QUEENS","156-10 BAISLEY BOULEVARD"
5,1,4,"d6d27c6d-30f4-ea11-b882-24ee9a37d45c","P.S. 145 Andrew Jackson - K145 - K145 - 32K145 - 100 NOLL STREET","d7d27c6d-30f4-ea11-b882-24ee9a37d45c",-73932388,40701107,"P.S. 145 - BROOKLYN","100 NOLL STREET"
4,2,2,"7e886843-31f4-ea11-b882-24ee9a37d45c","P.S. 004 Duke Ellington - M004 - M004 - 06M004 - 500 WEST 160 STREET","7f886843-31f4-ea11-b882-24ee9a37d45c",-73941594,40834877,"P.S. 4 - MANHATTAN","500 WEST 160 STREET"
2,0,2,"07e2abc9-30f4-ea11-b882-24ee9a37d45c","The Science And Medicine Middle School - K366 - K366 - 18K366 - 965 EAST 107TH STREET","08e2abc9-30f4-ea11-b882-24ee9a37d45c",-73891743,40647396,"SHIRLEY CHISHOLM CAMPUS - K","965 EAST 107TH STREET"
1,1,0,"8b11b2e2-32f4-ea11-b882-24ee9a37d45c","Staten Island School of Civic Leadership - R861 - R861 - 31R861 - 280 REGIS DRIVE","8a11b2e2-32f4-ea11-b882-24ee9a37d45c",-74164427,40620310,"ELIZABETH A. CONNELLY CAMPUS - S.I.","280 REGIS DRIVE"
1,1,0,"20025a42-4afb-ea11-b883-24ee9a37d459","Immanual Creative - QASD - QASD -  - 213-01 Northern Boulevard","21025a42-4afb-ea11-b883-24ee9a37d459",-73770125,0,"Immanuel Creative","213-01 Northern Boulevard"
3,3,0,"af69c231-32f4-ea11-b882-24ee9a37d45c","P.S. 207 Rockwood Park - Q207 - Q207 - 27Q207 - 159-15 88 STREET","b069c231-32f4-ea11-b882-24ee9a37d45c",-73843881,40657736,"PS/MS 207 Queens","159-15 88 STREET"
1,0,1,"f89b4c1f-32f4-ea11-b882-24ee9a37d45c","P.S. 160 Walter Francis Bishop - Q160 - Q160 - 28Q160 - 109-59 INWOOD STREET","ee9b4c1f-32f4-ea11-b882-24ee9a37d45c",-73799685,40688373,"P.S. 160 - QUEENS","109-59 INWOOD STREET"
2,2,0,"29a198c3-30f4-ea11-b882-24ee9a37d45c","P.S. 889 - K889 - K338 - 22K889 - 21 HINCKLEY PLACE","27a198c3-30f4-ea11-b882-24ee9a37d45c",-73971010,40644861,"P.S. 338 - Brooklyn","21 HINCKLEY PLACE"
5,2,3,"320b210d-33f4-ea11-b882-24ee9a37d45c","School for Environmental Citizenship - X386 - X079 - 10X386 - 125 EAST 181 STREET","2c0b210d-33f4-ea11-b882-24ee9a37d45c",-73903139,40855337,"P.S. 79 - BRONX","125 EAST 181 STREET"
1,1,0,"12a31781-33f4-ea11-b882-24ee9a37d45c","The Bronx STEM and Arts Academy - X051 - X781 - 10X051 - 695 East 182nd Street","13a31781-33f4-ea11-b882-24ee9a37d45c",-73886997,40850674,"P.S. 51 - BRONX","695 East 182nd Street"
1,0,1,"eb2ece86-32f4-ea11-b882-24ee9a37d45c","Queens Transition Center - Q752 - Q744 - 75Q752 - 45-10 94th Street","e22ece86-32f4-ea11-b882-24ee9a37d45c",-73871505,40743228,"ELMHURST EDUCATIONAL CAMPUS - Q","45-10 94th Street"
1,0,1,"0baf0313-32f4-ea11-b882-24ee9a37d45c","P.S. 130 - Q130 - Q130 - 25Q130 - 200-01 42 AVENUE","04af0313-32f4-ea11-b882-24ee9a37d45c",-73784009,40760219,"P.S. 130 - QUEENS","200-01 42 AVENUE"
1,1,0,"15ff3d8d-33f4-ea11-b882-24ee9a37d45c","P.S. 086 Kingsbridge Heights - X086 - X868 - 10X086 - 2756 RESERVOIR AVENUE","16ff3d8d-33f4-ea11-b882-24ee9a37d45c",-73897066,40869061,"P.S. 86 MINISCHOOL - BRONX","2756 RESERVOIR AVENUE"
1,1,0,"0dbdc8e1-49fb-ea11-b883-24ee9a37d459","Saint Sebastian Catholic Academy - QAGP - QAGP -  - 39-76 58 STREET","0ebdc8e1-49fb-ea11-b883-24ee9a37d459",-73906669,40745982,"SAINT SEBASTIAN SCHOOL","39-76 58 STREET"
1,1,0,"840e6e25-32f4-ea11-b882-24ee9a37d45c","P.S. 169 Bay Terrace - Q169 - Q169 - 25Q169 - 18-25 212 STREET","820e6e25-32f4-ea11-b882-24ee9a37d45c",-73778430,40782331,"P.S. 169 - QUEENS","18-25 212 STREET"
1,1,0,"58507380-31f4-ea11-b882-24ee9a37d45c","P.S./I.S. 187 Hudson Cliffs - M187 - M187 - 06M187 - 349 CABRINI BOULEVARD","59507380-31f4-ea11-b882-24ee9a37d45c",-73936840,40856239,"P.S./I.S. 187 - MANHATTAN","349 CABRINI BOULEVARD"
11,9,2,"77c280bd-31f4-ea11-b882-24ee9a37d45c","The Clinton School - M260 - M868 - 02M260 - 10 East 15th Street","78c280bd-31f4-ea11-b882-24ee9a37d45c",-73992727,40736526,"THE CLINTON SCHOOL - MANHATTAN","10 East 15th Street"
3,1,2,"1530f69f-ebf6-ea11-b883-24ee9a37d459","P.S. Q993 - Q993 - Q208 - 75Q993 - 74-30 COMMONWEALTH BLVD","ab69c231-32f4-ea11-b882-24ee9a37d45c",-73727632,40744276,"P.S./I.S. 208 - QUEENS","74-30 COMMONWEALTH BLVD"
2,0,2,"d1b36d80-30f4-ea11-b882-24ee9a37d45c","P.S. 186 Dr. Irving A Gladstone - K186 - K186 - 20K186 - 7601 19 AVENUE","d2b36d80-30f4-ea11-b882-24ee9a37d45c",-73994258,40610917,"P.S. 186 - BROOKLYN","7601 19 AVENUE"
1,1,0,"cdba3c50-33f4-ea11-b882-24ee9a37d45c","The Highbridge Green School - X361 - X285 - 09X361 - 200 West 167th Street","ceba3c50-33f4-ea11-b882-24ee9a37d45c",-73927892,40838232,"HIGHBRIDGE ENVIRONMENTAL EDUCATION CAMPUS - BRONX","200 West 167th Street"
3,0,3,"9a2aa42b-33f4-ea11-b882-24ee9a37d45c","International Community High School - X334 - X139 - 07X334 - 345 BROOK AVENUE","942aa42b-33f4-ea11-b882-24ee9a37d45c",-73918774,40810314,"J.H.S. 222 - BRONX","345 BROOK AVENUE"
1,1,0,"ad9c11e8-30f4-ea11-b882-24ee9a37d45c","High School for Public Service: Heroes of Tomorrow - K546 - K470 - 17K546 - 600 KINGSTON AVENUE","aa9c11e8-30f4-ea11-b882-24ee9a37d45c",-73943839,40658671,"GEORGE W. WINGATE HS - K","600 KINGSTON AVENUE"
2,1,1,"92886843-31f4-ea11-b882-24ee9a37d45c","P.S. 008 Luis Belliard - M008 - M008 - 06M008 - 465 WEST 167 STREET","93886843-31f4-ea11-b882-24ee9a37d45c",-73936614,40839235,"P.S. 8 - MANHATTAN","465 WEST 167 STREET"
2,1,1,"d9883319-32f4-ea11-b882-24ee9a37d45c","P.S. 143 Louis Armstrong - Q143 - Q143 - 24Q143 - 34-74 113 Street","d7883319-32f4-ea11-b882-24ee9a37d45c",-73855715,40755393,"P.S. 143 - QUEENS","34-74 113 Street"
2,0,2,"f5454b50-32f4-ea11-b882-24ee9a37d45c","P.S. 376 - Q376 - Q332 - 26Q376 - 210-21 48 AVENUE","f6454b50-32f4-ea11-b882-24ee9a37d45c",-73770314,40754954,"Bayside Hills School of Excellence","210-21 48 AVENUE"
2,1,1,"7ed92255-30f4-ea11-b882-24ee9a37d45c","P.S. 90 Edna Cohen School - K090 - K090 - 21K090 - 2840 WEST 12 STREET","7dd92255-30f4-ea11-b882-24ee9a37d45c",-73980387,40578192,"P.S. 90 - BROOKLYN","2840 WEST 12 STREET"
4,4,0,"e0e0838c-31f4-ea11-b882-24ee9a37d45c","P.S. 051 Elias Howe - M051 - M338 - 02M051 - 525 WEST 44TH STREET","dfe0838c-31f4-ea11-b882-24ee9a37d45c",-73995825,40761487,"P.S. 51 ELIAS HOWE - MANHATTAN","525 WEST 44TH STREET"
2,1,1,"822f77fa-31f4-ea11-b882-24ee9a37d45c","P.S. 071 Forest - Q071 - Q071 - 24Q071 - 62-85 FOREST AVENUE","802f77fa-31f4-ea11-b882-24ee9a37d45c",-73904798,40711388,"P.S. 71 - QUEENS","62-85 FOREST AVENUE"
3,1,2,"2d767649-31f4-ea11-b882-24ee9a37d45c","P.S. 020 Anna Silver - M020 - M020 - 01M020 - 166 ESSEX STREET","2e767649-31f4-ea11-b882-24ee9a37d45c",-73986312,40721305,"P.S. 20 - MANHATTAN","166 ESSEX STREET"
2,1,1,"dd92e6d5-30f4-ea11-b882-24ee9a37d45c","Spring Creek Community School - K422 - K422 - 19K422 - 1065 Elton Street","da92e6d5-30f4-ea11-b882-24ee9a37d45c",-73874064,40657266,"SPRING CREEK EDUCATIONAL CAMPUS - BROOKLYN","1065 Elton Street"
1,0,1,"0eaf1f69-ebf6-ea11-b883-24ee9a37d459","Restart Academy - M973 - M465 -  - 549 AUDUBON AVENUE","25a6ba98-31f4-ea11-b882-24ee9a37d45c",-73926060,40856532,"G. WASHINGTON HS EDUC. CAMPUS - M","549 AUDUBON AVENUE"
3,0,3,"4c507380-31f4-ea11-b882-24ee9a37d45c","Professor Juan Bosch Public School - M178 - M178 - 06M178 - 12-18 ELLWOOD STREET","4d507380-31f4-ea11-b882-24ee9a37d45c",-73928301,40859240,"P.S. 178 - MANHATTAN","12-18 ELLWOOD STREET"
2,0,2,"0a6e3d68-31f4-ea11-b882-24ee9a37d45c","P.S. 112 Jose Celso Barbosa - M112 - M112 - 04M112 - 535 EAST 119 STREET","0b6e3d68-31f4-ea11-b882-24ee9a37d45c",-73930528,40796889,"P.S. 112 (TANDEM M206) - MANHATTAN","535 EAST 119 STREET"
1,1,0,"c8edf392-32f4-ea11-b882-24ee9a37d45c","P.S. 007 Louis F. Simeone - Q007 - Q877 - 24Q007 - 76-05 51 AVENUE","c9edf392-32f4-ea11-b882-24ee9a37d45c",-73887011,40737222,"51ST AVENUE ACADEMY - QUEENS","76-05 51 AVENUE"
2,2,0,"dbfab455-31f4-ea11-b882-24ee9a37d45c","Tompkins Square Middle School - M839 - M064 - 01M839 - 600 EAST 6 STREET","d3fab455-31f4-ea11-b882-24ee9a37d45c",-73981597,40723130,"P.S. 64 (OLD 71) - MANHATTAN","600 EAST 6 STREET"
4,4,0,"5588e6db-30f4-ea11-b882-24ee9a37d45c","New Utrecht High School - K445 - K445 - 20K445 - 1601 80 STREET","5488e6db-30f4-ea11-b882-24ee9a37d45c",-74002308,40613041,"NEW UTRECHT HS - K","1601 80 STREET"
5,4,1,"7be2635c-32f4-ea11-b882-24ee9a37d45c","Rockaway Collegiate High School - Q351 - Q410 - 27Q351 - 100-00 BEACH CHANNEL DRIVE","71e2635c-32f4-ea11-b882-24ee9a37d45c",-73825317,40586012,"Beach Channel Educational Campus","100-00 BEACH CHANNEL DRIVE"
4,2,2,"40b4977a-32f4-ea11-b882-24ee9a37d45c","Queens Technical High School - Q600 - Q600 - 24Q600 - 37-02 47 AVENUE","41b4977a-32f4-ea11-b882-24ee9a37d45c",-73927995,40741658,"QUEENS VOC HS - Q","37-02 47 AVENUE"
4,0,4,"5ca5db98-30f4-ea11-b882-24ee9a37d45c","P.S. 236 Mill Basin - K236 - K236 - 22K236 - 6302 AVENUE U","5ba5db98-30f4-ea11-b882-24ee9a37d45c",-73912005,40615494,"P.S. 236 - BROOKLYN","6302 AVENUE U"
1,0,1,"1c1bad3c-30f4-ea11-b882-24ee9a37d45c","P.S./I.S. 045 Horace E. Greene - K045 - K045 - 32K045 - 84 SCHAEFER STREET","1d1bad3c-30f4-ea11-b882-24ee9a37d45c",-73910430,40686424,"P.S. 45 - BROOKLYN","84 SCHAEFER STREET"
2,1,1,"5e8946f4-31f4-ea11-b882-24ee9a37d45c","P.S. 046 Alley Pond - Q046 - Q046 - 26Q046 - 64-45 218 STREET","5f8946f4-31f4-ea11-b882-24ee9a37d45c",-73758042,40745744,"P.S. 46 - QUEENS","64-45 218 STREET"
2,1,1,"f4201dab-30f4-ea11-b882-24ee9a37d45c","I.S. 281 Joseph B Cavallaro - K281 - K281 - 21K281 - 8787 24 AVENUE","f2201dab-30f4-ea11-b882-24ee9a37d45c",-73993565,40594648,"I.S. 281 - BROOKLYN","8787 24 AVENUE"
4,2,2,"0db7c337-32f4-ea11-b882-24ee9a37d45c","P.S. 220 Edward Mandel - Q220 - Q220 - 28Q220 - 62-10 108 STREET","0eb7c337-32f4-ea11-b882-24ee9a37d45c",-73852621,40736314,"P.S. 220 - QUEENS","62-10 108 STREET"
1,0,1,"2578931f-33f4-ea11-b882-24ee9a37d45c","J.H.S. 123 James M. Kieran - X123 - X123 - 08X123 - 1025 MORRISON AVENUE","2378931f-33f4-ea11-b882-24ee9a37d45c",-73874162,40824989,"I.S. 123 - BRONX","1025 MORRISON AVENUE"
1,1,0,"ab48b1f5-eaf6-ea11-b883-24ee9a37d459","P.S. M169 - Robert F. Kennedy - M169 - M169 - 75M169 - 110 East 88 Street","34005d7a-31f4-ea11-b882-24ee9a37d45c",-73955594,40780798,"P.S. 169 (ECF) - MANHATTAN","110 East 88 Street"
2,0,2,"f0d27c6d-30f4-ea11-b882-24ee9a37d45c","School of Science & Technology - K152 - K152 - 22K152 - 725 EAST 23 STREET","efd27c6d-30f4-ea11-b882-24ee9a37d45c",-73954269,40632619,"P.S. 152 - BROOKLYN","725 EAST 23 STREET"
9,2,7,"f6f57030-30f4-ea11-b882-24ee9a37d45c","P.S. 015 Patrick F. Daly - K015 - K015 - 15K015 - 71 SULLIVAN STREET","f5f57030-30f4-ea11-b882-24ee9a37d45c",-74011864,40677085,"P.S. 15 - BROOKLYN","71 SULLIVAN STREET"
3,1,2,"367eed06-32f4-ea11-b882-24ee9a37d45c","P.S. 099 Kew Gardens - Q099 - Q099 - 28Q099 - 82-37 KEW GARDENS ROAD","377eed06-32f4-ea11-b882-24ee9a37d45c",-73827722,40711502,"P.S. 99 - QUEENS","82-37 KEW GARDENS ROAD"
1,0,1,"49ebaa73-30f4-ea11-b882-24ee9a37d45c","The East New York Arts and Civics High School - K953 - K166 - 19K953 - 800 VAN SICLEN AVE","41ebaa73-30f4-ea11-b882-24ee9a37d45c",-73885704,40659934,"I.S. 166 - BROOKLYN","800 VAN SICLEN AVE"
1,0,1,"369ebaee-32f4-ea11-b882-24ee9a37d45c","P.S. 018 John Peter Zenger - X018 - X018 - 07X018 - 502 MORRIS AVENUE","379ebaee-32f4-ea11-b882-24ee9a37d45c",-73922697,40816369,"P.S. 18 - BRONX","502 MORRIS AVENUE"
2,0,2,"5536d900-33f4-ea11-b882-24ee9a37d45c","P.S. 049 Willis Avenue - X049 - X049 - 07X049 - 383 EAST 139 STREET","4d36d900-33f4-ea11-b882-24ee9a37d45c",-73922730,40810413,"P.S. 49 - BRONX","383 EAST 139 STREET"
3,2,1,"9cd810ab-31f4-ea11-b882-24ee9a37d45c","NYC iSchool - M376 - M615 - 02M376 - 131 AVENUE OF THE AMERICAS","9ad810ab-31f4-ea11-b882-24ee9a37d45c",-74005058,40724630,"CHELSEA VOC HS - MANHATTAN","131 AVENUE OF THE AMERICAS"
6,2,4,"b7ab074a-33f4-ea11-b882-24ee9a37d45c","P.S./M.S. 194 - X194 - X194 - 11X194 - 2365 WATERBURY AVENUE","b6ab074a-33f4-ea11-b882-24ee9a37d45c",-73846594,40835410,"P.S./I.S. 194 - BRONX","2365 WATERBURY AVENUE"
3,0,3,"bfba3c50-33f4-ea11-b882-24ee9a37d45c","P186X Walter J. Damrosch School - X186 - X306 - 75X186 - 40 WEST TREMONT AVENUE","c0ba3c50-33f4-ea11-b882-24ee9a37d45c",-73910827,40850722,"P.S. 306 - BRONX","40 WEST TREMONT AVENUE"
2,1,1,"98a9d9c3-32f4-ea11-b882-24ee9a37d45c","P.S. 39 Francis J. Murphy Jr. - R039 - R039 - 31R039 - 99 Macfarland Avenue","99a9d9c3-32f4-ea11-b882-24ee9a37d45c",-74070610,40597824,"P.S. 39 - STATEN ISLAND","99 Macfarland Avenue"
2,0,2,"ed2d6c32-ebf6-ea11-b883-24ee9a37d459","P.S. K053 - K053 - K384 - 75K053 - 242 COOPER STREET","21e2abc9-30f4-ea11-b882-24ee9a37d45c",-73904695,40689883,"P.S. 384 - BROOKLYN","242 COOPER STREET"
2,0,2,"817e21a6-ebf6-ea11-b883-24ee9a37d459","P.S. 009 - Q009 - Q268 - 75Q009 - 92-07 175 STREET","4ea10a44-32f4-ea11-b882-24ee9a37d45c",-73785210,40707648,"P.S. 268 - QUEENS","92-07 175 STREET"
3,2,1,"c0e0838c-31f4-ea11-b882-24ee9a37d45c","East Side Elementary School, PS 267 - M267 - M267 - 02M267 - 213 EAST 63RD STREET","c1e0838c-31f4-ea11-b882-24ee9a37d45c",-73963861,40763883,"P.S. 59 - (MEETH) -MANHATTAN","213 EAST 63RD STREET"
2,0,2,"1630f69f-ebf6-ea11-b883-24ee9a37d459","P.S. 009 - Q009 - Q209 - 75Q009 - 16-10 Utopia Parkway","b569c231-32f4-ea11-b882-24ee9a37d45c",-73795845,40783777,"P.S. 209 - QUEENS","16-10 Utopia Parkway"
7,5,2,"a40e6e25-32f4-ea11-b882-24ee9a37d45c","Scholars' Academy - Q323 - Q180 - 27Q323 - 320 BEACH 104TH STREET","a50e6e25-32f4-ea11-b882-24ee9a37d45c",-73825162,40584543,"I.S. 323 (OLD IS 180) - QUEENS","320 BEACH 104TH STREET"
1,0,1,"a4bfa431-33f4-ea11-b882-24ee9a37d45c","P186X Walter J. Damrosch School - X186 - X146 - 75X186 - 968 CAULDWELL AVENUE","a5bfa431-33f4-ea11-b882-24ee9a37d45c",-73905734,40824717,"P.S. 146 - BRONX","968 CAULDWELL AVENUE"
3,0,3,"8f0e6e25-32f4-ea11-b882-24ee9a37d45c","P.S. 173 Fresh Meadows - Q173 - Q173 - 26Q173 - 174-10 67 AVENUE","900e6e25-32f4-ea11-b882-24ee9a37d45c",-73795651,40734097,"P.S. 173 - QUEENS","174-10 67 AVENUE"
2,1,1,"130410ca-32f4-ea11-b882-24ee9a37d45c","CSI High School for International Studies - R047 - R043 - 31R047 - 100 ESSEX DRIVE","a0a9d9c3-32f4-ea11-b882-24ee9a37d45c",-74159343,40581958,"JEROME PARKER CAMPUS - S.I.","100 ESSEX DRIVE"
7,7,0,"1a68ee1e-31f4-ea11-b882-24ee9a37d45c","Benjamin Banneker Academy - K670 - K914 - 13K670 - 71-77 Clinton Avenue","1b68ee1e-31f4-ea11-b882-24ee9a37d45c",-73968759,40695389,"BENJAMIN BANNEKER ACADEMY-BROOKLYN","71-77 Clinton Avenue"
3,2,1,"762b3eee-30f4-ea11-b882-24ee9a37d45c","Academy for Conservation and the Environment - K637 - K515 - 18K637 - 6565 FLATLANDS AVENUE","6d2b3eee-30f4-ea11-b882-24ee9a37d45c",-73916927,40634451,"SOUTH SHORE EDUCATIONAL CAMPUS - K","6565 FLATLANDS AVENUE"
1,1,0,"7d53dd74-33f4-ea11-b882-24ee9a37d45c","Bronx Compass High School - X561 - X450 - 08X561 - 1980 LAFAYETTE AVENUE","62ffcc6e-33f4-ea11-b882-24ee9a37d45c",-73855930,40821218,"Adlai E. Stevenson Educational Campus","1980 LAFAYETTE AVENUE"
2,0,2,"f717b7f4-32f4-ea11-b882-24ee9a37d45c","M.S. 390 - X390 - X026 - 10X390 - 1930 ANDREWS AVENUE","e917b7f4-32f4-ea11-b882-24ee9a37d45c",-73913016,40854335,"P.S. 396 - BRONX","1930 ANDREWS AVENUE"
3,1,2,"1baf0313-32f4-ea11-b882-24ee9a37d45c","The Bellaire School - Q135 - Q135 - 29Q135 - 207-11 89 AVENUE","1caf0313-32f4-ea11-b882-24ee9a37d45c",-73757591,40720864,"P.S. 135 - QUEENS","207-11 89 AVENUE"
2,2,0,"f5f22ce2-31f4-ea11-b882-24ee9a37d45c","The Emerson School - Q287 - Q008 - 28Q287 - 108-35 167 STREET","f1f22ce2-31f4-ea11-b882-24ee9a37d45c",-73786403,40696910,"J.H.S. 8 - QUEENS","108-35 167 STREET"
12,7,5,"8b476368-32f4-ea11-b882-24ee9a37d45c","Newtown High School - Q455 - Q455 - 24Q455 - 48-01 90 STREET","8c476368-32f4-ea11-b882-24ee9a37d45c",-73874129,40740824,"NEWTOWN HS - Q","48-01 90 STREET"
2,1,1,"4e9d7c62-33f4-ea11-b882-24ee9a37d45c","Pelham Preparatory Academy - X542 - X415 - 11X542 - 925 ASTOR AVENUE","439d7c62-33f4-ea11-b882-24ee9a37d45c",-73860729,40860443,"CHRISTOPHER COLUMBUS HS - X","925 ASTOR AVENUE"
1,1,0,"94a9d9c3-32f4-ea11-b882-24ee9a37d45c","P.S. 038 George Cromwell - R038 - R038 - 31R038 - 421 LINCOLN AVENUE","92a9d9c3-32f4-ea11-b882-24ee9a37d45c",-74099409,40574799,"P.S. 38 - STATEN ISLAND","421 LINCOLN AVENUE"
3,2,1,"f917b7f4-32f4-ea11-b882-24ee9a37d45c","P.S. 396 - X396 - X026 - 10X396 - 1930 ANDREWS AVENUE","e917b7f4-32f4-ea11-b882-24ee9a37d45c",-73913016,40854335,"P.S. 396 - BRONX","1930 ANDREWS AVENUE"
2,0,2,"4b71bd14-8b23-ed11-b0a2-088e901ef405","The East Village Community School - M315 - M019 - 01M315 - 185 1 AVENUE","2b767649-31f4-ea11-b882-24ee9a37d45c",-73984496,40730009,"P.S. 19 - MANHATTAN","185 1 AVENUE"
1,0,1,"be56635c-33f4-ea11-b882-24ee9a37d45c","Bronx River High School - X349 - X405 - 08X349 - 3000 EAST TREMONT AVENUE","b556635c-33f4-ea11-b882-24ee9a37d45c",-73839583,40839775,"HERBERT H. LEHMAN HS - X","3000 EAST TREMONT AVENUE"
1,0,1,"af0e6e25-32f4-ea11-b882-24ee9a37d45c","P.S. 184 Flushing Manor - Q184 - Q184 - 25Q184 - 163-15 21 ROAD","b00e6e25-32f4-ea11-b882-24ee9a37d45c",-73799158,40778334,"P.S. 184 - QUEENS","163-15 21 ROAD"
1,0,1,"66395a2c-ebf6-ea11-b883-24ee9a37d459","P.S. K053 - K053 - K296 - 75K053 - 125 COVERT STREET","99283fb1-30f4-ea11-b882-24ee9a37d45c",-73910589,40688647,"I.S. 296 - BROOKLYN","125 COVERT STREET"
3,3,0,"52474313-33f4-ea11-b882-24ee9a37d45c","M.S. X101 Edward R. Byrne - X101 - X101 - 08X101 - 2750 LAFAYETTE AVENUE","4e474313-33f4-ea11-b882-24ee9a37d45c",-73829211,40827080,"I.S. 101 - BRONX","2750 LAFAYETTE AVENUE"
4,4,0,"df37fba4-31f4-ea11-b882-24ee9a37d45c","Manhattan Early College School for Advertising - M280 - M520 - 02M280 - 411 PEARL STREET","e037fba4-31f4-ea11-b882-24ee9a37d45c",-74000851,40711441,"MURRY BERGTRAUM HS (ECF) - M","411 PEARL STREET"
2,1,1,"9d69c231-32f4-ea11-b882-24ee9a37d45c","P.S. 203 Oakland Gardens - Q203 - Q203 - 26Q203 - 53-11 SPRINGFIELD BOULEVARD","9e69c231-32f4-ea11-b882-24ee9a37d45c",-73759822,40753606,"P.S. 203 - QUEENS","53-11 SPRINGFIELD BOULEVARD"
1,1,0,"7b53dd74-33f4-ea11-b882-24ee9a37d45c","Gotham Collaborative High School - X452 - X450 - 08X452 - 1980 LAFAYETTE AVENUE","62ffcc6e-33f4-ea11-b882-24ee9a37d45c",-73855930,40821218,"Adlai E. Stevenson Educational Campus","1980 LAFAYETTE AVENUE"
5,0,5,"445bc58c-30f4-ea11-b882-24ee9a37d45c","P.S. 212 Lady Deborah Moody - K212 - K212 - 21K212 - 87 BAY 49 STREET","455bc58c-30f4-ea11-b882-24ee9a37d45c",-73985368,40587612,"P.S. 212 - BROOKLYN","87 BAY 49 STREET"
1,1,0,"370410ca-32f4-ea11-b882-24ee9a37d45c","P.S. 054 Charles W. Leng - R054 - R054 - 31R054 - 1060 WILLOWBROOK ROAD","380410ca-32f4-ea11-b882-24ee9a37d45c",-74137259,40602779,"P.S. 54 - STATEN ISLAND","1060 WILLOWBROOK ROAD"
4,2,2,"d0ba3c50-33f4-ea11-b882-24ee9a37d45c","Young Voices Academy of the Bronx - X357 - X292 - 11X357 - 800 LYDIG AVENUE","d1ba3c50-33f4-ea11-b882-24ee9a37d45c",-73863733,40854423,"THE DOMINIC CASTORE EDUCATIONAL CAMPUS - BRONX","800 LYDIG AVENUE"
1,0,1,"a483ff9e-30f4-ea11-b882-24ee9a37d45c","P.S. 254 Dag Hammarskjold - K254 - K254 - 22K254 - 2469 East 18 Street","a583ff9e-30f4-ea11-b882-24ee9a37d45c",-73951550,40591103,"P.S. 254 - BROOKLYN","2469 East 18 Street"
2,1,1,"a369c231-32f4-ea11-b882-24ee9a37d45c","Energy Tech High School - Q258 - Q204 - 30Q258 - 36-41 28 STREET","9c69c231-32f4-ea11-b882-24ee9a37d45c",-73932628,40756471,"I.S. 204 - QUEENS","36-41 28 STREET"
1,1,0,"7de2635c-32f4-ea11-b882-24ee9a37d45c","New Visions Charter High School for the Humanities IV - Q373 - Q410 - 84Q373 - 100-00 BEACH CHANNEL DRIVE","71e2635c-32f4-ea11-b882-24ee9a37d45c",-73825317,40586012,"Beach Channel Educational Campus","100-00 BEACH CHANNEL DRIVE"
2,2,0,"8803194f-30f4-ea11-b882-24ee9a37d45c","Brooklyn Environmental Exploration School (BEES) - K664 - K073 - 23K664 - 251 MAC DOUGAL STREET","8503194f-30f4-ea11-b882-24ee9a37d45c",-73910719,40680679,"P.S. 73 - BROOKLYN","251 MAC DOUGAL STREET"
4,3,1,"686e70b7-31f4-ea11-b882-24ee9a37d45c","West End Secondary School - M291 - M837 - 03M291 - 227-243 West 61st Street","696e70b7-31f4-ea11-b882-24ee9a37d45c",-73988338,40772608,"BEACON HS - MANHATTAN","227-243 West 61st Street"
1,0,1,"a7eb0e7b-33f4-ea11-b882-24ee9a37d45c","High School for Energy and Technology - X565 - X660 - 10X565 - 2474 CROTONA AVENUE","a3eb0e7b-33f4-ea11-b882-24ee9a37d45c",-73882487,40855392,"GRACE H. DODGE VOC HS - X","2474 CROTONA AVENUE"
3,3,0,"ee37fba4-31f4-ea11-b882-24ee9a37d45c","I.S. 528 Bea Fuller Rodgers School - M528 - M528 - 06M528 - 180 WADSWORTH AVENUE","ed37fba4-31f4-ea11-b882-24ee9a37d45c",-73934676,40850683,"I.S. 528 - MANHATTAN","180 WADSWORTH AVENUE"
3,2,1,"555bc58c-30f4-ea11-b882-24ee9a37d45c","P.S. 216 Arturo Toscanini - K216 - K216 - 21K216 - 350 AVENUE X","565bc58c-30f4-ea11-b882-24ee9a37d45c",-73969647,40590000,"P.S. 216 - BROOKLYN","350 AVENUE X"
2,1,1,"629d7c62-33f4-ea11-b882-24ee9a37d45c","The Cinema School - X478 - X423 - 12X478 - 1551 EAST 172ND STREET","639d7c62-33f4-ea11-b882-24ee9a37d45c",-73878191,40832508,"JAMES MONROE HS CAMPUS ANNEX - BRONX","1551 EAST 172ND STREET"
2,0,2,"46de5eb7-30f4-ea11-b882-24ee9a37d45c","Vista Academy - K661 - K302 - 19K661 - 350 LINWOOD STREET","42de5eb7-30f4-ea11-b882-24ee9a37d45c",-73884211,40677112,"I.S. 302 - BROOKLYN","350 LINWOOD STREET"
2,1,1,"70e03d56-33f4-ea11-b882-24ee9a37d45c","The Bronxwood Preparatory Academy - X514 - X362 - 11X514 - 921 EAST 228TH STREET","6ce03d56-33f4-ea11-b882-24ee9a37d45c",-73852714,40888242,"I.S./H.S. 362 - BRONX","921 EAST 228TH STREET"
2,0,2,"86e657bd-30f4-ea11-b882-24ee9a37d45c","P.S. 312 Bergen Beach - K312 - K312 - 22K312 - 7103 Avenue T","87e657bd-30f4-ea11-b882-24ee9a37d45c",-73909554,40622442,"P.S. 312 - BROOKLYN","7103 Avenue T"
4,2,2,"d3201dab-30f4-ea11-b882-24ee9a37d45c","P.S. 274 Kosciusko - K274 - K274 - 32K274 - 800 BUSHWICK AVENUE","d4201dab-30f4-ea11-b882-24ee9a37d45c",-73928180,40694179,"P.S. 274 - BROOKLYN","800 BUSHWICK AVENUE"
3,3,0,"ec09e2e1-30f4-ea11-b882-24ee9a37d45c","East Williamsburg Scholars Academy - K477 - K450 - 14K477 - 850 GRAND STREET","e909e2e1-30f4-ea11-b882-24ee9a37d45c",-73938921,40711134,"GRAND STREET CAMPUS (OLD E.D.HS)- K","850 GRAND STREET"
1,0,1,"4c02fdd0-ebf6-ea11-b883-24ee9a37d459","The Richard H. Hungerford School - R721 - R043 - 75R721 - 100 ESSEX DRIVE","a0a9d9c3-32f4-ea11-b882-24ee9a37d45c",-74159343,40581958,"JEROME PARKER CAMPUS - S.I.","100 ESSEX DRIVE"
3,1,2,"68977d2b-32f4-ea11-b882-24ee9a37d45c","P.S. 186 Castlewood - Q186 - Q186 - 26Q186 - 252-12 72 AVENUE","67977d2b-32f4-ea11-b882-24ee9a37d45c",-73721594,40749556,"P.S. 186 - QUEENS","252-12 72 AVENUE"
1,0,1,"3b2682ef-ebf6-ea11-b883-24ee9a37d459","P.S. 723 - X723 - X099 - 75X723 - 1180 REV. J.A. POLITE AVE.","4a474313-33f4-ea11-b882-24ee9a37d45c",-73896925,40827539,"REV. J.A. POLITE AVE SCHOOL CAMPUS - BRONX","1180 REV. J.A. POLITE AVE."
2,0,2,"df0d3c5b-30f4-ea11-b882-24ee9a37d45c","P.S. 105 The Blythebourne - K105 - K105 - 20K105 - 1031 59 STREET","e00d3c5b-30f4-ea11-b882-24ee9a37d45c",-74003635,40633320,"P.S. 105 - BROOKLYN","1031 59 STREET"
2,1,1,"bbbfa431-33f4-ea11-b882-24ee9a37d45c","The Laboratory School of Finance and Technology: X223 - X223 - X149 - 07X223 - 360 EAST 145 STREET","bcbfa431-33f4-ea11-b882-24ee9a37d45c",-73920851,40813612,"J.H.S. 149 - BRONX","360 EAST 145 STREET"
3,2,1,"b732c3fb-eaf6-ea11-b883-24ee9a37d459","Curious Young Learners Pre-K Center - Q336 - Q473 - 27Q336 - 133-40 79TH STREET","2c02926e-32f4-ea11-b882-24ee9a37d45c",-73857176,0,"3K CENTER @ 133-40 79TH STREET - QUEENS","133-40 79TH STREET"
1,1,0,"dcba3c50-33f4-ea11-b882-24ee9a37d45c","The STEAM Bridge School - X481 - X311 - 11X481 - 1684 WHITE PLAINS ROAD","daba3c50-33f4-ea11-b882-24ee9a37d45c",-73865498,40843531,"P.S. 311 - BRONX","1684 WHITE PLAINS ROAD"
1,0,1,"190965df-f725-ec11-b8bd-24ee9a37d45c","District 75 Secondary Site 75Q721 (Q269) - S061 - Q269 -  - 86-37 53rd Avenue","25457b28-e21e-eb11-b885-24ee9a37d45c",-73878711,40735875,"P.S./I.S. 269 - QUEENS","86-37 53rd Avenue"
1,1,0,"dced94c3-31f4-ea11-b882-24ee9a37d45c","Ballet Tech, NYC Public School for Dance - M442 - M905 - 02M442 - 890 BROADWAY","daed94c3-31f4-ea11-b882-24ee9a37d45c",-73989481,40738521,"BALLET TECH/PUB. SCL FOR DANCE - M","890 BROADWAY"
2,2,0,"3fbc749d-4afb-ea11-b883-24ee9a37d459","Holy Child Jesus Catholic Academy - QABS - QABS -  - 111-02 86 AVENUE","40bc749d-4afb-ea11-b883-24ee9a37d459",-73837478,40698498,"HOLY CHILD JESUS SCHOOL","111-02 86 AVENUE"
4,3,1,"78977d2b-32f4-ea11-b882-24ee9a37d45c","J.H.S. 190 Russell Sage - Q190 - Q190 - 28Q190 - 68-17 AUSTIN STREET","75977d2b-32f4-ea11-b882-24ee9a37d45c",-73851700,40723478,"J.H.S. 190 - QUEENS","68-17 AUSTIN STREET"
2,0,2,"4a0d6d19-33f4-ea11-b882-24ee9a37d45c","P.S. 110 Theodore Schoenfeld - X110 - X110 - 09X110 - 580 CROTONA PARK SOUTH","420d6d19-33f4-ea11-b882-24ee9a37d45c",-73900654,40834470,"P.S. 110 - BRONX","580 CROTONA PARK SOUTH"
3,1,2,"a3778cb8-ebf6-ea11-b883-24ee9a37d459","John F. Kennedy Jr. School - Q721 - Q585 - 75Q721 - 54-40 74TH STREET","34b4977a-32f4-ea11-b882-24ee9a37d45c",-73887909,40729104,"MASPETH HIGH SCHOOL - QUEENS","54-40 74TH STREET"
1,0,1,"858d8486-31f4-ea11-b882-24ee9a37d45c","P.S. 199 Jessie Isador Straus - M199 - M199 - 03M199 - 270 WEST 70 STREET","868d8486-31f4-ea11-b882-24ee9a37d45c",-73984423,40777603,"P.S. 199 - MANHATTAN","270 WEST 70 STREET"
1,1,0,"f8d7cf12-31f4-ea11-b882-24ee9a37d45c","South Brooklyn Community High School - K698 - K825 - 15K698 - 173 Conover Street","f9d7cf12-31f4-ea11-b882-24ee9a37d45c",-74014363,40677968,"SOUTH BROOKLYN COMM. HS - K","173 Conover Street"
3,3,0,"e377bb9f-33f4-ea11-b882-24ee9a37d45c","Urban Assembly School for Applied Math and Science, The - X241 - X970 - 09X241 - 1595 BATHGATE AVENUE","e177bb9f-33f4-ea11-b882-24ee9a37d45c",-73901774,40839508,"BATHGATE HS - BRONX","1595 BATHGATE AVENUE"
7,7,0,"eace496e-31f4-ea11-b882-24ee9a37d45c","P.S. 124 Yung Wing - M124 - M124 - 02M124 - 40 DIVISION STREET","e8ce496e-31f4-ea11-b882-24ee9a37d45c",-73996017,40715097,"P.S. 124 (ECF) - MANHATTAN","40 DIVISION STREET"
1,1,0,"c979df48-30f4-ea11-b882-24ee9a37d45c","Achievement First East New York Charter School - K358 - K065 - 84K358 - 158 RICHMOND STREET","ca79df48-30f4-ea11-b882-24ee9a37d45c",-73877256,40683399,"P.S. 65 - BROOKLYN","158 RICHMOND STREET"
2,0,2,"77a9d9c3-32f4-ea11-b882-24ee9a37d45c","I.S. 027 Anning S. Prall - R027 - R027 - 31R027 - 11 CLOVE LAKE PLACE","78a9d9c3-32f4-ea11-b882-24ee9a37d45c",-74117818,40628291,"I.S. 27 - STATEN ISLAND","11 CLOVE LAKE PLACE"
6,2,4,"38005d7a-31f4-ea11-b882-24ee9a37d45c","J.H.S. 167 Robert F. Wagner - M167 - M167 - 02M167 - 220 EAST 76 STREET","39005d7a-31f4-ea11-b882-24ee9a37d45c",-73957827,40771541,"I.S. 167 - MANHATTAN","220 EAST 76 STREET"
3,3,0,"ddfab455-31f4-ea11-b882-24ee9a37d45c","N.Y.C. Lab School for Collaborative Studies - M412 - M070 - 02M412 - 333 WEST 17 STREET","defab455-31f4-ea11-b882-24ee9a37d45c",-74002222,40742512,"I.S. 70 - MANHATTAN","333 WEST 17 STREET"
1,0,1,"0e45378b-4afb-ea11-b883-24ee9a37d459","HELP MORRIS EARLY CHILDHOOD PROGRAM - XANU - XANU -  - 285 EAST 171 STREET","0f45378b-4afb-ea11-b883-24ee9a37d459",-73909931,40839443,"HELP MORRIS EARLY CHILDHOOD PROGRAM","285 EAST 171 STREET"
3,3,0,"daf57030-30f4-ea11-b882-24ee9a37d45c","Magnet School of Math, Science and Design Technology - K010 - K010 - 15K010 - 511 7 AVENUE","dbf57030-30f4-ea11-b882-24ee9a37d45c",-73985946,40660912,"P.S. 10 - BROOKLYN","511 7 AVENUE"
2,2,0,"71c280bd-31f4-ea11-b882-24ee9a37d45c","Eleanor Roosevelt High School - M416 - M855 - 02M416 - 411 EAST 76 STREET","72c280bd-31f4-ea11-b882-24ee9a37d45c",-73953276,40770288,"ELEANOR ROOSEVELT HS - MANHATTAN","411 EAST 76 STREET"
1,1,0,"93e657bd-30f4-ea11-b882-24ee9a37d45c","Elijah Stroud Middle School - K353 - K316 - 17K353 - 750 CLASSON AVENUE","94e657bd-30f4-ea11-b882-24ee9a37d45c",-73961418,40674685,"P.S. 316 - BROOKLYN","750 CLASSON AVENUE"
3,3,0,"d6689025-33f4-ea11-b882-24ee9a37d45c","P.S. 134 George F. Bristow - X134 - X134 - 12X134 - 1330 BRISTOW STREET","d7689025-33f4-ea11-b882-24ee9a37d45c",-73894241,40831613,"P.S. 134 - BRONX","1330 BRISTOW STREET"
3,2,1,"db21d292-30f4-ea11-b882-24ee9a37d45c","P.S. 222 Katherine R. Snyder - K222 - K222 - 22K222 - 3301 QUENTIN ROAD","dc21d292-30f4-ea11-b882-24ee9a37d45c",-73939205,40614005,"P.S. 222 - BROOKLYN","3301 QUENTIN ROAD"
2,1,1,"0aba8b86-30f4-ea11-b882-24ee9a37d45c","P.S. 203 Floyd Bennett School - K203 - K203 - 22K203 - 5101 AVENUE M","0bba8b86-30f4-ea11-b882-24ee9a37d45c",-73925732,40622108,"P.S. 203 - BROOKLYN","5101 AVENUE M"
1,0,1,"96d91731-31f4-ea11-b882-24ee9a37d45c","Brooklyn Urban Garden Charter School - K758 - KBNU - 84K758 - 500 19 Street","97d91731-31f4-ea11-b882-24ee9a37d45c",-73982624,40656202,"STANLEY LAMM INSTITUE PRE-SCHOOL OF LONGISLAND HO","500 19 Street"
2,1,1,"0ff32ce2-31f4-ea11-b882-24ee9a37d45c","P.S. 017 Henry David Thoreau - Q017 - Q017 - 30Q017 - 28-37 29 STREET","0af32ce2-31f4-ea11-b882-24ee9a37d45c",-73922544,40768034,"P.S. 17 - QUEENS","28-37 29 STREET"
1,1,0,"21e85c61-30f4-ea11-b882-24ee9a37d45c","P.S. 112 Lefferts Park - K112 - K112 - 20K112 - 7115 15 AVENUE","22e85c61-30f4-ea11-b882-24ee9a37d45c",-74000565,40619417,"P.S. 112 - BROOKLYN","7115 15 AVENUE"
3,1,2,"fbce496e-31f4-ea11-b882-24ee9a37d45c","P.S. 128 Audubon - M128 - M128 - 06M128 - 560 WEST 169 STREET","f9ce496e-31f4-ea11-b882-24ee9a37d45c",-73938701,40841032,"P.S. 128 - MANHATTAN","560 WEST 169 STREET"
2,1,1,"1ee2abc9-30f4-ea11-b882-24ee9a37d45c","J.H.S. 383 Philippa Schuyler - K383 - K383 - 32K383 - 1300 GREENE AVENUE","1de2abc9-30f4-ea11-b882-24ee9a37d45c",-73919088,40697898,"I.S. 383 - BROOKLYN","1300 GREENE AVENUE"
4,0,4,"e6b98b86-30f4-ea11-b882-24ee9a37d45c","P.S. 193 Gil Hodges - K193 - K193 - 22K193 - 2515 AVENUE L","e5b98b86-30f4-ea11-b882-24ee9a37d45c",-73950321,40622080,"P.S. 193 - BROOKLYN","2515 AVENUE L"
3,1,2,"81a5db98-30f4-ea11-b882-24ee9a37d45c","P.S. 244 Richard R. Green - K244 - K244 - 18K244 - 5404 TILDEN AVENUE","7fa5db98-30f4-ea11-b882-24ee9a37d45c",-73925592,40647851,"P.S. 244 - BROOKLYN","5404 TILDEN AVENUE"
1,1,0,"186e3d68-31f4-ea11-b882-24ee9a37d45c","P.S. 115 Alexander Humboldt - M115 - M115 - 06M115 - 586 WEST 177 STREET","166e3d68-31f4-ea11-b882-24ee9a37d45c",-73935140,40846116,"P.S. 115 - MANHATTAN","586 WEST 177 STREET"
2,2,0,"b669c231-32f4-ea11-b882-24ee9a37d45c","P.S. 209 Clearview Gardens - Q209 - Q209 - 25Q209 - 16-10 Utopia Parkway","b569c231-32f4-ea11-b882-24ee9a37d45c",-73795845,40783777,"P.S. 209 - QUEENS","16-10 Utopia Parkway"
2,0,2,"b9edf392-32f4-ea11-b882-24ee9a37d45c","P.S. 099 Kew Gardens - Q099 - Q866 - 28Q099 - 83-34 Kew Gardens Road","baedf392-32f4-ea11-b882-24ee9a37d45c",-73827276,40709492,"P.S. 99 ANNEX - QUEENS","83-34 Kew Gardens Road"
4,2,2,"e39b4c1f-32f4-ea11-b882-24ee9a37d45c","P.S. 154 Queens - Q154 - Q154 - 25Q154 - 75-02 162 Street","d69b4c1f-32f4-ea11-b882-24ee9a37d45c",-73807750,40726473,"P.S. 154 - QUEENS","75-02 162 Street"
1,0,1,"ec968d36-30f4-ea11-b882-24ee9a37d45c","P.S. 024 - K024 - K024 - 15K024 - 427 38 STREET","ed968d36-30f4-ea11-b882-24ee9a37d45c",-74004533,40652832,"P.S. 24 - BROOKLYN","427 38 STREET"
4,1,3,"9601ce37-33f4-ea11-b882-24ee9a37d45c","P.S. 160 Walt Disney - X160 - X160 - 11X160 - 4140 HUTCHINSON RIVER PKWAY EA","9501ce37-33f4-ea11-b882-24ee9a37d45c",-73823816,40864073,"P.S. 160 - BRONX","4140 HUTCHINSON RIVER PKWAY EA"
2,0,2,"f6d10307-33f4-ea11-b882-24ee9a37d45c","P.S. 072 Dr. William Dorney - X072 - X072 - 08X072 - 2951 DEWEY AVENUE","f4d10307-33f4-ea11-b882-24ee9a37d45c",-73818172,40823237,"P.S. 72 - BRONX","2951 DEWEY AVENUE"
1,0,1,"71dfafe6-52e6-eb11-b8b1-24ee9a37d45c","New Visions Charter High School for the Humanities II - X208 - X650 - 84X208 - 900 TINTON AVENUE","91eb0e7b-33f4-ea11-b882-24ee9a37d45c",-73902892,40821723,"JANE ADDAMS HS - X","900 TINTON AVENUE"
1,0,1,"d3ba3c50-33f4-ea11-b882-24ee9a37d45c","P.S. 306 - X306 - X306 - 10X306 - 40 WEST TREMONT AVENUE","c0ba3c50-33f4-ea11-b882-24ee9a37d45c",-73910827,40850722,"P.S. 306 - BRONX","40 WEST TREMONT AVENUE"
1,1,0,"39a6ba98-31f4-ea11-b882-24ee9a37d45c","Frank McCourt High School - M417 - M470 - 03M417 - 145 WEST 84 STREET","33a6ba98-31f4-ea11-b882-24ee9a37d45c",-73974483,40786134,"LOUIS D. BRANDEIS HS - MANHATTAN","145 WEST 84 STREET"
3,0,3,"c22ff20c-32f4-ea11-b882-24ee9a37d45c","P.S. 112 Dutch Kills - Q112 - Q112 - 30Q112 - 25-05 37 AVENUE","c32ff20c-32f4-ea11-b882-24ee9a37d45c",-73933562,40757293,"P.S. 112 - QUEENS","25-05 37 AVENUE"
3,3,0,"d9454b50-32f4-ea11-b882-24ee9a37d45c","The Queens School for Leadership and Excellence - Q349 - Q314 - 28Q349 - 88-08 164TH STREET","d5454b50-32f4-ea11-b882-24ee9a37d45c",-73797981,40708698,"P.S./ I.S. 314 - Queens","88-08 164TH STREET"
1,1,0,"16ba8b86-30f4-ea11-b882-24ee9a37d45c","P.S. 207 Elizabeth G. Leary - K207 - K207 - 22K207 - 4011 FILLMORE AVENUE","17ba8b86-30f4-ea11-b882-24ee9a37d45c",-73930485,40613981,"P.S. 207 - BROOKLYN","4011 FILLMORE AVENUE"
4,2,2,"17c73b4a-32f4-ea11-b882-24ee9a37d45c","P.S. 182 Samantha Smith - Q182 - Q277 - 28Q182 - 153-27 88th Avenue","15c73b4a-32f4-ea11-b882-24ee9a37d45c",-73803183,40706750,"PS 182 SAMANTHA SMITH - QUEENS","153-27 88th Avenue"
2,0,2,"c4ab074a-33f4-ea11-b882-24ee9a37d45c","I.S. 206 Ann Mersereau - X206 - X206 - 10X206 - 2280 AQUEDUCT AVENUE","c5ab074a-33f4-ea11-b882-24ee9a37d45c",-73906285,40859534,"I.S. 206B - BRONX","2280 AQUEDUCT AVENUE"
2,2,0,"dce8ce00-32f4-ea11-b882-24ee9a37d45c","PS 80 The Thurgood Marshall Magnet School of Multimedia and Communication - Q080 - Q080 - 28Q080 - 171-05 137TH AVENUE","dde8ce00-32f4-ea11-b882-24ee9a37d45c",-73769119,40673483,"P.S. 80 - QUEENS","171-05 137TH AVENUE"
4,2,2,"9953dd74-33f4-ea11-b882-24ee9a37d45c","Bronx Engineering and Technology Academy - X213 - X475 - 10X213 - 99 TERRACE VIEW AVENUE","9853dd74-33f4-ea11-b882-24ee9a37d45c",-73912686,40877379,"JOHN F. KENNEDY HS - X","99 TERRACE VIEW AVENUE"
4,2,2,"57ebaa73-30f4-ea11-b882-24ee9a37d45c","Ralph A. Fabrizio School - K170 - K170 - 20K170 - 619 72ND STREET","58ebaa73-30f4-ea11-b882-24ee9a37d45c",-74018719,40630373,"P.S. 170 - BROOKLYN","619 72ND STREET"
1,0,1,"1af92a2a-4afb-ea11-b883-24ee9a37d459","LONG XING DAY CARE CENTER, INC - KBQB - KBQB -  - 762 59TH STREET","1bf92a2a-4afb-ea11-b883-24ee9a37d459",-74009856,0,"LONG XING DAY CARE CENTER, INC.","762 59TH STREET"
3,0,3,"30e61462-31f4-ea11-b882-24ee9a37d45c","P.S. 138 - M138 - M090 - 75M138 - 21 JUMEL PLACE","2ce61462-31f4-ea11-b882-24ee9a37d45c",-73935815,40839139,"I.S. 90 - MANHATTAN","21 JUMEL PLACE"
3,3,0,"26af0313-32f4-ea11-b882-24ee9a37d45c","P.S./M.S. 138 Sunrise - Q138 - Q138 - 29Q138 - 251-11 WELLER AVENUE","1aaf0313-32f4-ea11-b882-24ee9a37d45c",-73734342,40659876,"P.S. 138 - QUEENS","251-11 WELLER AVENUE"
1,1,0,"9c2aa42b-33f4-ea11-b882-24ee9a37d45c","Academy of Applied Mathematics and Technology - X343 - X139 - 07X343 - 345 BROOK AVENUE","942aa42b-33f4-ea11-b882-24ee9a37d45c",-73918774,40810314,"J.H.S. 222 - BRONX","345 BROOK AVENUE"
1,0,1,"7ea5db98-30f4-ea11-b882-24ee9a37d45c","Brooklyn Science and Engineering Academy - K763 - K244 - 18K763 - 5404 TILDEN AVENUE","7fa5db98-30f4-ea11-b882-24ee9a37d45c",-73925592,40647851,"P.S. 244 - BROOKLYN","5404 TILDEN AVENUE"
2,2,0,"5d3cbf01-ebf6-ea11-b883-24ee9a37d459","P.S. 087 Bronx - X087 - X087 - 11X087 - 1935 BUSSING AVENUE","510b210d-33f4-ea11-b882-24ee9a37d45c",-73846198,40895741,"P.S. 87 - BRONX","1935 BUSSING AVENUE"
2,2,0,"a869c231-32f4-ea11-b882-24ee9a37d45c","P.S. 205 Alexander Graham Bell - Q205 - Q205 - 26Q205 - 75-25 BELL BOULEVARD","a769c231-32f4-ea11-b882-24ee9a37d45c",-73756374,40738008,"P.S. 205 - QUEENS","75-25 BELL BOULEVARD"
1,1,0,"5a9f4974-31f4-ea11-b882-24ee9a37d45c","P.S. 152 Dyckman Valley - M152 - M152 - 06M152 - 93 NAGLE AVENUE","5b9f4974-31f4-ea11-b882-24ee9a37d45c",-73927578,40859804,"P.S. 152 - MANHATTAN","93 NAGLE AVENUE"
6,6,0,"df2ece86-32f4-ea11-b882-24ee9a37d45c","Bard High School Early College Queens - Q299 - Q735 - 24Q299 - 30-20 THOMSON AVENUE","db2ece86-32f4-ea11-b882-24ee9a37d45c",-73937004,40744175,"QUEENS HIGH SCHOOL COMPLEX - Q","30-20 THOMSON AVENUE"
2,0,2,"857e21a6-ebf6-ea11-b883-24ee9a37d459","P.S. 009 - Q009 - Q277 - 75Q009 - 153-27 88th Avenue","15c73b4a-32f4-ea11-b882-24ee9a37d45c",-73803183,40706750,"PS 182 SAMANTHA SMITH - QUEENS","153-27 88th Avenue"
1,1,0,"66fdc1bd-32f4-ea11-b882-24ee9a37d45c","P.S. 21 Margaret Emery-Elm Park - R021 - R021 - 31R021 - 168 Hooker Place","67fdc1bd-32f4-ea11-b882-24ee9a37d45c",-74144599,40631165,"P.S. 21 - STATEN ISLAND","168 Hooker Place"
2,2,0,"7707e99e-31f4-ea11-b882-24ee9a37d45c","P.S. 059 Beekman Hill International - M059 - M488 - 02M059 - 231-249 EAST 56 STREET","6d07e99e-31f4-ea11-b882-24ee9a37d45c",-73967204,40759248,"MIDTOWN EAST CAMPUS - MANHATTAN","231-249 EAST 56 STREET"
1,1,0,"5ef4a0ef-eaf6-ea11-b883-24ee9a37d459","P.S. K140 - K140 - K258 - 75K140 - 141 MACON STREET","b183ff9e-30f4-ea11-b882-24ee9a37d45c",-73945600,40681920,"I.S. 258 - BROOKLYN","141 MACON STREET"
1,0,1,"cf56635c-33f4-ea11-b882-24ee9a37d45c","Bronx High School of Business - X412 - X410 - 09X412 - 240 EAST 172 STREET","c856635c-33f4-ea11-b882-24ee9a37d45c",-73911366,40839307,"WILLIAM H. TAFT HS - X","240 EAST 172 STREET"
1,1,0,"12af1f69-ebf6-ea11-b883-24ee9a37d459","District 2 Pre-K Center - M391 - M474 - 02M391 - 252 EAST 57 STREET","41a6ba98-31f4-ea11-b882-24ee9a37d45c",-73965878,40759081,"PRE-K CENTER @ EAST 57 STREET - MANHATTAN","252 EAST 57 STREET"
6,6,0,"83e03d56-33f4-ea11-b882-24ee9a37d45c","Morris Academy for Collaborative Studies - X297 - X400 - 09X297 - 1110 BOSTON ROAD","82e03d56-33f4-ea11-b882-24ee9a37d45c",-73903920,40827455,"MORRIS HS - X","1110 BOSTON ROAD"
3,0,3,"449f4974-31f4-ea11-b882-24ee9a37d45c","Future Leaders Institute Charter School - M861 - M144 - 84M861 - 134 WEST 122 STREET","459f4974-31f4-ea11-b882-24ee9a37d45c",-73948385,40806055,"P.S. 242 (OLD P144) - MANHATTAN","134 WEST 122 STREET"
4,4,0,"52767649-31f4-ea11-b882-24ee9a37d45c","P.S. 041 Greenwich Village - M041 - M041 - 02M041 - 116 WEST 11 STREET","53767649-31f4-ea11-b882-24ee9a37d45c",-73999094,40735450,"P.S. 41 - MANHATTAN","116 WEST 11 STREET"
2,2,0,"f0f22ce2-31f4-ea11-b882-24ee9a37d45c","York Early College Academy - Q284 - Q008 - 28Q284 - 108-35 167 STREET","f1f22ce2-31f4-ea11-b882-24ee9a37d45c",-73786403,40696910,"J.H.S. 8 - QUEENS","108-35 167 STREET"
2,2,0,"0b9ebaee-32f4-ea11-b882-24ee9a37d45c","P.S./M.S. 004 Crotona Park West - X004 - X004 - 09X004 - 1701 Fulton Avenue","099ebaee-32f4-ea11-b882-24ee9a37d45c",-73897943,40841758,"P.S. 4 - BRONX","1701 Fulton Avenue"
4,3,1,"969c11e8-30f4-ea11-b882-24ee9a37d45c","Park Slope Collegiate - K464 - K460 - 15K464 - 237 7 AVENUE","929c11e8-30f4-ea11-b882-24ee9a37d45c",-73978580,40669255,"John Jay Educational Campus","237 7 AVENUE"
6,3,3,"64977d2b-32f4-ea11-b882-24ee9a37d45c","J.H.S. 185 Edward Bleeker - Q185 - Q185 - 25Q185 - 147-26 25 DRIVE","ae0e6e25-32f4-ea11-b882-24ee9a37d45c",-73818607,40774906,"J.H.S. 185 - QUEENS","147-26 25 DRIVE"
1,1,0,"7953dd74-33f4-ea11-b882-24ee9a37d45c","Bronx Bridges High School - X432 - X450 - 08X432 - 1980 LAFAYETTE AVENUE","62ffcc6e-33f4-ea11-b882-24ee9a37d45c",-73855930,40821218,"Adlai E. Stevenson Educational Campus","1980 LAFAYETTE AVENUE"
4,1,3,"0a9c4c1f-32f4-ea11-b882-24ee9a37d45c","P.S. 165 Edith K. Bergtraum - Q165 - Q165 - 25Q165 - 70-35 150 Street","0b9c4c1f-32f4-ea11-b882-24ee9a37d45c",-73816966,40729746,"P.S. 165 - QUEENS","70-35 150 Street"
8,2,6,"10ba8b86-30f4-ea11-b882-24ee9a37d45c","P.S. 205 Clarion - K205 - K205 - 20K205 - 6701 20 AVENUE","11ba8b86-30f4-ea11-b882-24ee9a37d45c",-73986792,40614737,"P.S. 205 - BROOKLYN","6701 20 AVENUE"
4,3,1,"f6ce496e-31f4-ea11-b882-24ee9a37d45c","P.S. 126 Jacob August Riis - M126 - M126 - 02M126 - 80 CATHERINE STREET","f4ce496e-31f4-ea11-b882-24ee9a37d45c",-73997420,40710651,"P.S. 126 - MANHATTAN","80 CATHERINE STREET"
4,0,4,"d22ff20c-32f4-ea11-b882-24ee9a37d45c","P.S. 117 J. Keld / Briarwood School - Q117 - Q117 - 28Q117 - 85-15 143 STREET","d32ff20c-32f4-ea11-b882-24ee9a37d45c",-73812968,40710428,"P.S. 117 - QUEENS","85-15 143 STREET"
2,1,1,"48767649-31f4-ea11-b882-24ee9a37d45c","P.S. 034 Franklin D. Roosevelt - M034 - M034 - 01M034 - 730 East 12 Street","49767649-31f4-ea11-b882-24ee9a37d45c",-73975058,40726008,"P.S. 34 - MANHATTAN","730 East 12 Street"
1,1,0,"440b210d-33f4-ea11-b882-24ee9a37d45c","I.S. 232 - X232 - X082 - 09X232 - 1700 MACOMBS ROAD","3f0b210d-33f4-ea11-b882-24ee9a37d45c",-73915217,40849416,"I.S. 232 - BRONX","1700 MACOMBS ROAD"
3,3,0,"02cf496e-31f4-ea11-b882-24ee9a37d45c","Pace High School - M298 - M131 - 02M298 - 100 HESTER STREET","03cf496e-31f4-ea11-b882-24ee9a37d45c",-73993607,40716231,"I.S. 131 - MANHATTAN","100 HESTER STREET"
8,8,0,"87e2635c-32f4-ea11-b882-24ee9a37d45c","Benjamin N. Cardozo High School - Q415 - Q415 - 26Q415 - 57-00 223RD STREET","86e2635c-32f4-ea11-b882-24ee9a37d45c",-73757271,40752343,"BENJAMIN N. CARDOZO HS - Q","57-00 223RD STREET"
3,0,3,"4688e6db-30f4-ea11-b882-24ee9a37d45c","P.S. 130 The Parkside - K130 - K437 - 15K130 - 713 CATON AVENUE","4488e6db-30f4-ea11-b882-24ee9a37d45c",-73973363,40647598,"P.S./I.S. 437 - BROOKLYN","713 CATON AVENUE"
1,0,1,"bd69c231-32f4-ea11-b882-24ee9a37d45c","P.S. 212 - Q212 - Q212 - 30Q212 - 34-25 82 STREET","b969c231-32f4-ea11-b882-24ee9a37d45c",-73884458,40753035,"P.S. 212 - QUEENS","34-25 82 STREET"
2,2,0,"f677bb9f-33f4-ea11-b882-24ee9a37d45c","P.S. 083 Donald Hertz - X083 - X981 - 11X083 - 1840 BOGART AVENUE","f777bb9f-33f4-ea11-b882-24ee9a37d45c",-73858769,40849176,"P.S. 83 ANNEX - BRONX","1840 BOGART AVENUE"
1,0,1,"d2883319-32f4-ea11-b882-24ee9a37d45c","Queens Transition Center - Q752 - Q142 - 75Q752 - 142-10 LINDEN BOULEVARD","2eaf0313-32f4-ea11-b882-24ee9a37d45c",-73800875,40683473,"P.S. 752 (OLD J142) - QUEENS","142-10 LINDEN BOULEVARD"
2,2,0,"d3315367-30f4-ea11-b882-24ee9a37d45c","P.S. 130 The Parkside - K130 - K130 - 15K130 - 70 Ocean Parkway","cc315367-30f4-ea11-b882-24ee9a37d45c",-73976053,40648924,"P.S. 130 - BROOKLYN","70 Ocean Parkway"
1,1,0,"62a5db98-30f4-ea11-b882-24ee9a37d45c","Brooklyn School of Inquiry - K686 - K237 - 20K686 - 50 AVENUE P","5fa5db98-30f4-ea11-b882-24ee9a37d45c",-73986678,40606994,"LUCRETIA MARCIGLIANO CAMPUS - K","50 AVENUE P"
1,0,1,"116e3d68-31f4-ea11-b882-24ee9a37d45c","P.S. 138 - M138 - M114 - 75M138 - 331 EAST 91ST STREET","126e3d68-31f4-ea11-b882-24ee9a37d45c",-73947379,40780452,"EAST SIDE MIDDLE SCHOOL - MANHATTAN","331 EAST 91ST STREET"
8,3,5,"fc02cefa-32f4-ea11-b882-24ee9a37d45c","P.S. 035 Franz Siegel - X035 - X035 - 09X035 - 261 EAST 163 STREET","fd02cefa-32f4-ea11-b882-24ee9a37d45c",-73917705,40828009,"P.S. 35 - BRONX","261 EAST 163 STREET"
7,2,5,"d20d3c5b-30f4-ea11-b882-24ee9a37d45c","P.S. 100 The Coney Island School - K100 - K100 - 21K100 - 2951 WEST 3 STREET","ca0d3c5b-30f4-ea11-b882-24ee9a37d45c",-73970830,40577591,"P.S. 100 - BROOKLYN","2951 WEST 3 STREET"
1,0,1,"b0689025-33f4-ea11-b882-24ee9a37d45c","P.S. X012 Lewis and Clark School - X012 - X125 - 75X012 - 1111 Pugsley Avenue","af689025-33f4-ea11-b882-24ee9a37d45c",-73857882,40829153,"I.S. 125 - BRONX","1111 Pugsley Avenue"
1,0,1,"c3e0838c-31f4-ea11-b882-24ee9a37d45c","P.S./I.S. 217 Roosevelt Island - M217 - M271 - 02M217 - 645 MAIN STREET","b8e0838c-31f4-ea11-b882-24ee9a37d45c",-73956435,40753598,"P.S./I.S. 217 - MANHATTAN","645 MAIN STREET"
2,2,0,"4c9f4974-31f4-ea11-b882-24ee9a37d45c","P.S. 145, The Bloomingdale School - M145 - M145 - 03M145 - 150 West 105 Street","4a9f4974-31f4-ea11-b882-24ee9a37d45c",-73965611,40799098,"P.S. 145 - MANHATTAN","150 West 105 Street"
2,1,1,"077eed06-32f4-ea11-b882-24ee9a37d45c","P.S. 082 Hammond - Q082 - Q082 - 28Q082 - 88-02 144 STREET","e3e8ce00-32f4-ea11-b882-24ee9a37d45c",-73812200,40703897,"P.S. 82 - QUEENS","88-02 144 STREET"
1,1,0,"277eed06-32f4-ea11-b882-24ee9a37d45c","P.S. 094 David D. Porter - Q094 - Q094 - 26Q094 - 41-77 Little Neck Parkway","287eed06-32f4-ea11-b882-24ee9a37d45c",-73738703,40771258,"P.S. 94 - QUEENS","41-77 Little Neck Parkway"
1,0,1,"2e005d7a-31f4-ea11-b882-24ee9a37d45c","Mott Hall II - M862 - M165 - 03M862 - 234 West 109 Street","2f005d7a-31f4-ea11-b882-24ee9a37d45c",-73965949,40802653,"P.S. 165 - MANHATTAN","234 West 109 Street"
1,0,1,"269ebaee-32f4-ea11-b882-24ee9a37d45c","P.S. X012 Lewis and Clark School - X012 - X012 - 75X012 - 2555 TRATMAN AVENUE","279ebaee-32f4-ea11-b882-24ee9a37d45c",-73844685,40840625,"P.S. 12 - BRONX","2555 TRATMAN AVENUE"
3,2,1,"d03159fa-30f4-ea11-b882-24ee9a37d45c","Sunset Park High School - K667 - K564 - 15K667 - 153 35 Street","18fc3df4-30f4-ea11-b882-24ee9a37d45c",-74004342,40655583,"SUNSET PARK HS - BROOKLYN","153 35 Street"
1,0,1,"6034aa92-31f4-ea11-b882-24ee9a37d45c","P.S. 138 - M138 - M380 - 75M138 - 508 WEST 153RD STREET","6134aa92-31f4-ea11-b882-24ee9a37d45c",-73944846,40830415,"P.S. 380- MANHATTAN","508 WEST 153RD STREET"
1,1,0,"d6968d36-30f4-ea11-b882-24ee9a37d45c","Brooklyn Arbor Elementary School - K414 - K019 - 14K414 - 325 SOUTH 3 STREET","d7968d36-30f4-ea11-b882-24ee9a37d45c",-73954678,40710107,"P.S. 19 - BROOKLYN","325 SOUTH 3 STREET"
1,1,0,"a2eb0e7b-33f4-ea11-b882-24ee9a37d45c","Crotona International High School - X524 - X660 - 10X524 - 2474 CROTONA AVENUE","a3eb0e7b-33f4-ea11-b882-24ee9a37d45c",-73882487,40855392,"GRACE H. DODGE VOC HS - X","2474 CROTONA AVENUE"
1,0,1,"7a34aa92-31f4-ea11-b882-24ee9a37d45c","James Baldwin School, The: A School for Expeditionary Learning - M313 - M440 - 02M313 - 351 WEST 18 STREET","7834aa92-31f4-ea11-b882-24ee9a37d45c",-74002540,40743407,"BAYARD RUSTIN EDUCATIONAL COMP-M","351 WEST 18 STREET"
1,1,0,"1f6e3d68-31f4-ea11-b882-24ee9a37d45c","Tag Young Scholars - M012 - M117 - 04M012 - 240 EAST 109 STREET","1b6e3d68-31f4-ea11-b882-24ee9a37d45c",-73942285,40792556,"J.H.S. 117 - MANHATTAN","240 EAST 109 STREET"
2,0,2,"fe9dbaee-32f4-ea11-b882-24ee9a37d45c","P.S. 001 Courtlandt School - X001 - X001 - 07X001 - 335 EAST 152 STREET","ff9dbaee-32f4-ea11-b882-24ee9a37d45c",-73919634,40819331,"P.S. 1 - BRONX","335 EAST 152 STREET"
2,0,2,"6e2b3eee-30f4-ea11-b882-24ee9a37d45c","Brooklyn Community High School for Excellence and Equity - K566 - K515 - 18K566 - 6565 FLATLANDS AVENUE","6d2b3eee-30f4-ea11-b882-24ee9a37d45c",-73916927,40634451,"SOUTH SHORE EDUCATIONAL CAMPUS - K","6565 FLATLANDS AVENUE"
2,2,0,"d0ed94c3-31f4-ea11-b882-24ee9a37d45c","Leadership and Public Service High School - M425 - M894 - 02M425 - 90 TRINITY PLACE","d1ed94c3-31f4-ea11-b882-24ee9a37d45c",-74012465,40708971,"HS FOR LEADERSHIP & PUBLIC SER - M","90 TRINITY PLACE"
1,1,0,"c6b66262-32f4-ea11-b882-24ee9a37d45c","Business Technology Early College High School - Q315 - Q435 - 26Q315 - 230-17 HILLSIDE AVENUE","c4b66262-32f4-ea11-b882-24ee9a37d45c",-73739726,40733888,"MARTIN VAN BUREN HS - QUEENS","230-17 HILLSIDE AVENUE"
1,0,1,"f2fb3df4-30f4-ea11-b882-24ee9a37d45c","Brooklyn Community High School for Excellence and Equity - K566 - K516 - 18K566 - 6565 Flatlands Avenue","f3fb3df4-30f4-ea11-b882-24ee9a37d45c",-73916927,40634451,"SOUTH SHORE AF - BROOKLYN","6565 Flatlands Avenue"
5,1,4,"18f32ce2-31f4-ea11-b882-24ee9a37d45c","P.S. 019 Marino Jeantet - Q019 - Q019 - 24Q019 - 98-02 ROOSEVELT AVENUE","19f32ce2-31f4-ea11-b882-24ee9a37d45c",-73866557,40748600,"P.S. 19 - QUEENS","98-02 ROOSEVELT AVENUE"
2,1,1,"2568ee1e-31f4-ea11-b882-24ee9a37d45c","P.S./I.S. 30 Mary White Ovington - K030 - K940 - 20K030 - 415 OVINGTON AVENUE","2668ee1e-31f4-ea11-b882-24ee9a37d45c",-74023036,40633710,"I.S. 30 - BROOKLYN","415 OVINGTON AVENUE"
3,3,0,"a2886843-31f4-ea11-b882-24ee9a37d45c","Central Park East High School - M555 - M013 - 04M555 - 1573 MADISON AVENUE","98886843-31f4-ea11-b882-24ee9a37d45c",-73948488,40793649,"I.S. 13 - MANHATTAN","1573 MADISON AVENUE"
2,1,1,"de9319d7-ebf6-ea11-b883-24ee9a37d459","The Richmond Pre-K Center - R066 - R090 - 31R066 - 1535 RICHMOND AVENUE","f18521d0-32f4-ea11-b882-24ee9a37d45c",-74159152,40610497,"3K CENTER @ 1535 RICHMOND AVENUE - STATEN ISLAND","1535 RICHMOND AVENUE"
2,0,2,"c192e6d5-30f4-ea11-b882-24ee9a37d45c","Kurt Hahn Expeditionary Learning School - K569 - K415 - 18K569 - 5800 TILDEN AVENUE","5b8dbfcf-30f4-ea11-b882-24ee9a37d45c",-73922212,40647728,"SAMUEL J. TILDEN EDUCATIONAL CAMPUS - K","5800 TILDEN AVENUE"
1,0,1,"0906003e-32f4-ea11-b882-24ee9a37d45c","I.S. 230 - Q230 - Q230 - 30Q230 - 73-10 34 AVENUE","0806003e-32f4-ea11-b882-24ee9a37d45c",-73892883,40752618,"I.S. 230 - QUEENS","73-10 34 AVENUE"
1,1,0,"a62ff20c-32f4-ea11-b882-24ee9a37d45c","P.S. 102 Bayview - Q102 - Q102 - 24Q102 - 55-24 VAN HORN STREET","a72ff20c-32f4-ea11-b882-24ee9a37d45c",-73878243,40733033,"P.S./I.S. 102 - QUEENS","55-24 VAN HORN STREET"
3,1,2,"8501ce37-33f4-ea11-b882-24ee9a37d45c","Bronx Career and College Preparatory High School - X479 - X158 - 12X479 - 800 HOME STREET","8601ce37-33f4-ea11-b882-24ee9a37d45c",-73900593,40826933,"I.S. 158 - BRONX","800 HOME STREET"
5,5,0,"790e6e25-32f4-ea11-b882-24ee9a37d45c","P.S. 166 Henry Gradstein - Q166 - Q166 - 30Q166 - 33-09 35 AVENUE","7a0e6e25-32f4-ea11-b882-24ee9a37d45c",-73926249,40757497,"P.S. 166 - QUEENS","33-09 35 AVENUE"
1,0,1,"efc1392a-30f4-ea11-b882-24ee9a37d45c","P.S. 003 The Bedford Village - K003 - K003 - 13K003 - 50 JEFFERSON AVENUE","f0c1392a-30f4-ea11-b882-24ee9a37d45c",-73955219,40682311,"P.S. 3 - BROOKLYN","50 JEFFERSON AVENUE"
1,1,0,"3cceb75a-4afb-ea11-b883-24ee9a37d459","Books and Rattles Inc. Site 1 - QALW - QALW -  - 75 02 51ST AVENUE","3dceb75a-4afb-ea11-b883-24ee9a37d459",-73888167,40736282,"BOOKS AND RATTLES, INC. SITE 1","75 02 51ST AVENUE"
3,3,0,"c5fab455-31f4-ea11-b882-24ee9a37d45c","East Side Community School - M450 - M060 - 01M450 - 420 East 12 Street","c1fab455-31f4-ea11-b882-24ee9a37d45c",-73982472,40729152,"J.H.S. 60 - MANHATTAN","420 East 12 Street"
1,0,1,"b52ff20c-32f4-ea11-b882-24ee9a37d45c","P.S. 107 Thomas A Dooley - Q107 - Q107 - 25Q107 - 167-02 45 AVENUE","b62ff20c-32f4-ea11-b882-24ee9a37d45c",-73799476,40755364,"P.S. 107 - QUEENS","167-02 45 AVENUE"
2,1,1,"2ec15a75-ebf6-ea11-b883-24ee9a37d459","P.S. M226 - M226 - M824 - 75M226 - 75 BROAD STREET","760c1bb1-31f4-ea11-b882-24ee9a37d45c",-74011202,40704697,"MILLENNIUM HS - MANHATTAN","75 BROAD STREET"
1,0,1,"47416e00-31f4-ea11-b882-24ee9a37d45c","Success Academy Charter School - Bushwick - K882 - K677 - 84K882 - 139 MENAHAN STREET","48416e00-31f4-ea11-b882-24ee9a37d45c",-73919653,40695975,"P.S. 677 - BROOKLYN","139 MENAHAN STREET"
1,0,1,"97886843-31f4-ea11-b882-24ee9a37d45c","Central Park East I - M497 - M013 - 04M497 - 1573 MADISON AVENUE","98886843-31f4-ea11-b882-24ee9a37d45c",-73948488,40793649,"I.S. 13 - MANHATTAN","1573 MADISON AVENUE"
1,0,1,"419587f5-ebf6-ea11-b883-24ee9a37d459","P.S. X596 - X596 - X153 - 75X596 - 650 BAYCHESTER AVENUE","6801ce37-33f4-ea11-b882-24ee9a37d45c",-73831669,40874035,"P.S. 153 - BRONX","650 BAYCHESTER AVENUE"
1,1,0,"27005d7a-31f4-ea11-b882-24ee9a37d45c","P.S. 163 Alfred E. Smith - M163 - M163 - 03M163 - 163 West 97 Street","26005d7a-31f4-ea11-b882-24ee9a37d45c",-73968470,40795163,"P.S. 163 - MANHATTAN","163 West 97 Street"
2,0,2,"2e0410ca-32f4-ea11-b882-24ee9a37d45c","I.S. 051 Edwin Markham - R051 - R051 - 31R051 - 80 WILLOWBROOK ROAD","2f0410ca-32f4-ea11-b882-24ee9a37d45c",-74145522,40623077,"I.S. 51 - STATEN ISLAND","80 WILLOWBROOK ROAD"
1,0,1,"fc91111a-ebf6-ea11-b883-24ee9a37d459","Region 7 Adult Learning Center - E007 - K126 -  - 424 LEONARD STREET","c3315367-30f4-ea11-b882-24ee9a37d45c",-73947932,40719818,"J.H.S. 126 - BROOKLYN","424 LEONARD STREET"
1,1,0,"d28442ee-31f4-ea11-b882-24ee9a37d45c","P.S. 035 Nathaniel Woodhull - Q035 - Q035 - 29Q035 - 90-01 191 Street","bb8442ee-31f4-ea11-b882-24ee9a37d45c",-73768894,40713438,"P.S. 35 - QUEENS","191-02 90 Avenue"
2,1,1,"11af0313-32f4-ea11-b882-24ee9a37d45c","P.S. 132 Ralph Bunche - Q132 - Q132 - 29Q132 - 132-15 218 STREET","12af0313-32f4-ea11-b882-24ee9a37d45c",-73749300,40681948,"P.S. 132 - QUEENS","132-15 218 STREET"
1,1,0,"fe77931f-33f4-ea11-b882-24ee9a37d45c","School of Performing Arts - X217 - X116 - 12X217 - 977 FOX STREET","fd77931f-33f4-ea11-b882-24ee9a37d45c",-73894368,40822056,"I.S. 216 - BRONX","977 FOX STREET"
1,0,1,"3f8dbfcf-30f4-ea11-b882-24ee9a37d45c","International High School at Lafayette - K337 - K400 - 21K337 - 2630 BENSON AVENUE","3a8dbfcf-30f4-ea11-b882-24ee9a37d45c",-73986313,40593028,"Lafayette Educational Campus","2630 BENSON AVENUE"
1,1,0,"1bc0c20d-ecf6-ea11-b883-24ee9a37d459","Pathways to Graduation - Q950 - X989 - 79Q950 - 2007 MAPES AVE.","ff77bb9f-33f4-ea11-b882-24ee9a37d45c",-73887410,40844943,"MARY MITCHELL- X","2007 MAPES AVE."
1,1,0,"d7b66262-32f4-ea11-b882-24ee9a37d45c","William Cullen Bryant High School - Q445 - Q445 - 30Q445 - 48-10 31 AVENUE","d8b66262-32f4-ea11-b882-24ee9a37d45c",-73911165,40757072,"WILLIAM C. BRYANT HS - Q","48-10 31 AVENUE"
1,1,0,"418dbfcf-30f4-ea11-b882-24ee9a37d45c","Kingsborough Early College School - K468 - K400 - 21K468 - 2630 BENSON AVENUE","3a8dbfcf-30f4-ea11-b882-24ee9a37d45c",-73986313,40593028,"Lafayette Educational Campus","2630 BENSON AVENUE"
2,0,2,"79886843-31f4-ea11-b882-24ee9a37d45c","P.S. 001 Alfred E. Smith - M001 - M001 - 02M001 - 8 HENRY STREET","7a886843-31f4-ea11-b882-24ee9a37d45c",-73997478,40712550,"P.S. 1 - MANHATTAN","8 HENRY STREET"
3,2,1,"e72ece86-32f4-ea11-b882-24ee9a37d45c","Civic Leadership Academy - Q293 - Q744 - 24Q293 - 45-10 94th Street","e22ece86-32f4-ea11-b882-24ee9a37d45c",-73871505,40743228,"ELMHURST EDUCATIONAL CAMPUS - Q","45-10 94th Street"
1,0,1,"dfaeb707-ecf6-ea11-b883-24ee9a37d459","P.S. X596 - X596 - X498 - 75X596 - 1640 BRONXDALE AVE","7eeb0e7b-33f4-ea11-b882-24ee9a37d45c",-73857989,40845023,"THE LT. CURTIS MEYRAN AND JOHN BELLEW ED COMPLEX","1640 BRONXDALE AVE"
1,0,1,"58767649-31f4-ea11-b882-24ee9a37d45c","Urban Assembly School for the Performing Arts - M369 - M043 - 05M369 - 509 WEST 129 STREET","59767649-31f4-ea11-b882-24ee9a37d45c",-73955520,40815747,"I.S. 172 (OLD 43) - MANHATTAN","509 WEST 129 STREET"
2,2,0,"17af0313-32f4-ea11-b882-24ee9a37d45c","P.S. 134 Hollis - Q134 - Q134 - 29Q134 - 203-02 109 Avenue","10af0313-32f4-ea11-b882-24ee9a37d45c",-73754747,40707535,"P.S. 134 - QUEENS","203-02 109 Avenue"
8,7,1,"0dba8b86-30f4-ea11-b882-24ee9a37d45c","P.S. 204 Vince Lombardi - K204 - K204 - 20K204 - 8101 15 AVENUE","0eba8b86-30f4-ea11-b882-24ee9a37d45c",-74006137,40613535,"P.S. 204 - BROOKLYN","8101 15 AVENUE"
2,2,0,"cc2ff20c-32f4-ea11-b882-24ee9a37d45c","The James J. Ambrose School - Q115 - Q115 - 26Q115 - 80-51 261 STREET","cd2ff20c-32f4-ea11-b882-24ee9a37d45c",-73709404,40744201,"The James J. Ambrose School","80-51 261 STREET"
4,3,1,"ffbdf08c-32f4-ea11-b882-24ee9a37d45c","Baccalaureate School for Global Education - Q580 - Q798 - 30Q580 - 34-12 36 AVENUE","00bef08c-32f4-ea11-b882-24ee9a37d45c",-73926977,40754975,"BACCALAUREATE SCL FOR GLOBAL ED-Q","34-12 36 AVENUE"
3,3,0,"a132c3fb-eaf6-ea11-b883-24ee9a37d459","P.S. 085 Judge Charles Vallone - Q085 - Q085 - 30Q085 - 23-70 31 STREET","0a7eed06-32f4-ea11-b882-24ee9a37d45c",-73915039,40773126,"P.S. 85 - QUEENS","23-70 31 STREET"
3,0,3,"d9e0a4fb-ebf6-ea11-b883-24ee9a37d459","P.S. 723 - X723 - X189 - 75X723 - 3441 STEENWICK AVENUE","018b0044-33f4-ea11-b882-24ee9a37d45c",-73830616,40882778,"P.S./I.S. 189 - BRONX","3441 STEENWICK AVENUE"
1,0,1,"48242fe3-ebf6-ea11-b883-24ee9a37d459","P.S. X010 - X010 - X015 - 75X010 - 2195 ANDREWS AVENUE","219ebaee-32f4-ea11-b882-24ee9a37d45c",-73909763,40859243,"P.S. 15 - BRONX","2195 ANDREWS AVENUE"
2,0,2,"5e34aa92-31f4-ea11-b882-24ee9a37d45c","The Peck Slip School - M343 - M343 - 02M343 - 1 PECK SLIP","e7e0838c-31f4-ea11-b882-24ee9a37d45c",-74002407,40708774,"THE PECK SLIP SCHOOL - MANHATTAN","1 PECK SLIP"
2,2,0,"70977d2b-32f4-ea11-b882-24ee9a37d45c","J.H.S. 189 Daniel Carter Beard - Q189 - Q189 - 25Q189 - 144-80 BARCLAY AVENUE","6b977d2b-32f4-ea11-b882-24ee9a37d45c",-73818399,40759963,"J.H.S. 189 - QUEENS","144-80 BARCLAY AVENUE"
1,0,1,"4ab225fb-6c0c-ed11-b091-088e901ef405","P186X Walter J. Damrosch School - X186 - X050 - 75X186 - 1550 VYSE AVENUE","5836d900-33f4-ea11-b882-24ee9a37d45c",-73886995,40834188,"P.S. 50 - BRONX","1550 VYSE AVENUE"
1,1,0,"8d32c3fb-eaf6-ea11-b883-24ee9a37d459","Special Music School - M859 - M932 - 03M859 - 129 WEST 67 STREET","f2ed94c3-31f4-ea11-b882-24ee9a37d45c",-73982976,40775256,"P.S. 199 ANNEX - MANHATTAN","129 WEST 67 STREET"
2,2,0,"15a6ba98-31f4-ea11-b882-24ee9a37d45c","Gramercy Arts High School - M374 - M460 - 02M374 - 40 IRVING PLACE","16a6ba98-31f4-ea11-b882-24ee9a37d45c",-73987064,40735361,"WASHINGTON IRVING HS - MANHATTAN","40 IRVING PLACE"
4,1,3,"d9fab455-31f4-ea11-b882-24ee9a37d45c","Earth School - M364 - M064 - 01M364 - 600 EAST 6 STREET","d3fab455-31f4-ea11-b882-24ee9a37d45c",-73981597,40723130,"P.S. 64 (OLD 71) - MANHATTAN","600 EAST 6 STREET"
1,1,0,"d1d10307-33f4-ea11-b882-24ee9a37d45c","P.S. 063 Author's Academy - X063 - X063 - 09X063 - 1260 FRANKLIN AVENUE","8736d900-33f4-ea11-b882-24ee9a37d45c",-73901859,40830930,"P.S. 63 - BRONX","1260 FRANKLIN AVENUE"
1,1,0,"ce92e6d5-30f4-ea11-b882-24ee9a37d45c","Cypress Hills Collegiate Preparatory School - K659 - K420 - 19K659 - 999 JAMAICA AVENUE","c692e6d5-30f4-ea11-b882-24ee9a37d45c",-73869305,40693002,"FRANKLIN K. LANE HS - K","999 JAMAICA AVENUE"
2,1,1,"fdd0de79-30f4-ea11-b882-24ee9a37d45c","P.S. 172 Beacon School of Excellence - K172 - K172 - 15K172 - 825 4 AVENUE","fed0de79-30f4-ea11-b882-24ee9a37d45c",-74000191,40657682,"P.S. 172 - BROOKLYN","825 4 AVENUE"
1,0,1,"e9e0a4fb-ebf6-ea11-b883-24ee9a37d459","P.S. X721 - Stephen McSweeney School - X721 - X368 - 75X721 - 2975 TIBBETT AVENUE","74e03d56-33f4-ea11-b882-24ee9a37d45c",-73913694,40877935,"M.S./H.S. 368 - BRONX","2975 TIBBETT AVENUE"
2,0,2,"2c06003e-32f4-ea11-b882-24ee9a37d45c","P.S. 242 Leonard P. Stavisky Early Childhood School - Q242 - Q242 - 25Q242 - 29-66 137 STREET","2d06003e-32f4-ea11-b882-24ee9a37d45c",-73832005,40769752,"P.S. 242 - (ECC) - QUEENS","29-66 137 STREET"
2,1,1,"4f474313-33f4-ea11-b882-24ee9a37d45c","P.S. 100 Isaac Clason - X100 - X100 - 08X100 - 800 TAYLOR AVENUE","50474313-33f4-ea11-b882-24ee9a37d45c",-73862760,40822552,"P.S. 100 - BRONX","800 TAYLOR AVENUE"
4,3,1,"f3ed94c3-31f4-ea11-b882-24ee9a37d45c","Paula Hedbavny School - M278 - M918 - 06M278 - 421 W 219th St","f4ed94c3-31f4-ea11-b882-24ee9a37d45c",-73912339,40871673,"P.S./IS 278 - MANHATTAN","421 W 219th St"
1,0,1,"50953aac-ebf6-ea11-b883-24ee9a37d459","Pathways to Graduation - Q950 - Q400 - 79Q950 - 156-10 BAISLEY BOULEVARD","a9eb6056-32f4-ea11-b882-24ee9a37d45c",-73782684,40673949,"AUGUST MARTIN HS - QUEENS","156-10 BAISLEY BOULEVARD"
2,2,0,"4b0b210d-33f4-ea11-b882-24ee9a37d45c","P.S. 083 Donald Hertz - X083 - X083 - 11X083 - 950 RHINELANDER AVENUE","4c0b210d-33f4-ea11-b882-24ee9a37d45c",-73858769,40849176,"P.S. 83 - BRONX","950 RHINELANDER AVENUE"
1,1,0,"5af4a0ef-eaf6-ea11-b883-24ee9a37d459","P.S. K771 - K771 - K225 - 75K771 - 1075 OCEAN VIEW AVENUE","e521d292-30f4-ea11-b882-24ee9a37d45c",-73955856,40580260,"P.S. 225 - BROOKLYN","1075 OCEAN VIEW AVENUE"
1,0,1,"8f886843-31f4-ea11-b882-24ee9a37d45c","P.S. 007 Samuel Stern - M007 - M007 - 04M007 - 160 EAST 120 STREET","90886843-31f4-ea11-b882-24ee9a37d45c",-73939374,40800616,"P.S. 7 - MANHATTAN","160 EAST 120 STREET"
1,0,1,"3d0410ca-32f4-ea11-b882-24ee9a37d45c","P.S. 56 The Louis Desario School - R056 - R056 - 31R056 - 250 KRAMER AVENUE","3e0410ca-32f4-ea11-b882-24ee9a37d45c",-74213943,40541856,"P.S. 56 - STATEN ISLAND","250 KRAMER AVENUE"
2,0,2,"68f4a0ef-eaf6-ea11-b883-24ee9a37d459","P.S. K811 Connie Lekas School - K811 - K286 - 75K811 - 2525 HARING STREET","6e283fb1-30f4-ea11-b882-24ee9a37d45c",-73938610,40591132,"P.S. 811 (OLD P286) - BROOKLYN","2525 HARING STREET"
1,1,0,"08af0313-32f4-ea11-b882-24ee9a37d45c","P.S. 129 Patricia Larkin - Q129 - Q129 - 25Q129 - 128-02 7 Avenue","09af0313-32f4-ea11-b882-24ee9a37d45c",-73839505,40789926,"P.S. 129 - QUEENS","128-02 7 Avenue"
1,0,1,"8128a20c-31f4-ea11-b882-24ee9a37d45c","Achievement First Endeavor Charter School - K508 - K784 - 84K508 - 510 WAVERLY AVENUE","8228a20c-31f4-ea11-b882-24ee9a37d45c",-73965928,40682422,"ACHIEVEMENT FIRST ENDEAVOR CHARTER SCHOOL - K","510 WAVERLY AVENUE"
1,1,0,"26bef08c-32f4-ea11-b882-24ee9a37d45c","P.S. 199 Maurice A. Fitzgerald - Q199 - Q841 - 24Q199 - 48-25 37th Street","27bef08c-32f4-ea11-b882-24ee9a37d45c",-73928640,40739438,"P.S. 199 ANNEX - QUEENS","48-25 37th Street"
8,5,3,"b9b66262-32f4-ea11-b882-24ee9a37d45c","John Bowne High School - Q425 - Q425 - 25Q425 - 63-25 MAIN STREET","bab66262-32f4-ea11-b882-24ee9a37d45c",-73823841,40737448,"JOHN BOWNE HS - QUEENS","63-25 MAIN STREET"
4,0,4,"34e85c61-30f4-ea11-b882-24ee9a37d45c","P.S. 116 Elizabeth L Farrell - K116 - K116 - 32K116 - 515 KNICKERBOCKER AVENUE","35e85c61-30f4-ea11-b882-24ee9a37d45c",-73916563,40698077,"P.S. 116 - BROOKLYN","515 KNICKERBOCKER AVENUE"
1,1,0,"18af1f69-ebf6-ea11-b883-24ee9a37d459","Special Music School - M859 - M490 - 03M859 - 122 AMSTERDAM AVENUE","7c07e99e-31f4-ea11-b882-24ee9a37d45c",-73985608,40774891,"MARTIN LUTHER KING, JR. HS - M","122 AMSTERDAM AVENUE"
1,0,1,"9241e65b-31f4-ea11-b882-24ee9a37d45c","Wadleigh Secondary School for the Performing & Visual Arts - M415 - M088 - 03M415 - 215 WEST 114 STREET","8841e65b-31f4-ea11-b882-24ee9a37d45c",-73954152,40802610,"I.S. 88 - MANHATTAN","215 WEST 114 STREET"
3,1,2,"0618b7f4-32f4-ea11-b882-24ee9a37d45c","P.S./M.S. 029 Melrose School - X029 - X029 - 07X029 - 758 COURTLANDT AVENUE","0718b7f4-32f4-ea11-b882-24ee9a37d45c",-73916419,40821544,"P.S. 29 - BRONX","758 COURTLANDT AVENUE"
6,6,0,"150410ca-32f4-ea11-b882-24ee9a37d45c","Gaynor McCown Expeditionary Learning School - R064 - R043 - 31R064 - 100 ESSEX DRIVE","a0a9d9c3-32f4-ea11-b882-24ee9a37d45c",-74159343,40581958,"JEROME PARKER CAMPUS - S.I.","100 ESSEX DRIVE"
1,0,1,"b5b36d80-30f4-ea11-b882-24ee9a37d45c","P.S. 179 Kensington - K179 - K179 - 20K179 - 202 AVENUE C","13d1de79-30f4-ea11-b882-24ee9a37d45c",-73977260,40640127,"P.S. 179 - BROOKLYN","202 AVENUE C"
2,1,1,"df968d36-30f4-ea11-b882-24ee9a37d45c","Brooklyn Arts and Science Elementary School - K705 - K022 - 17K705 - 443 ST MARKS AVENUE","e0968d36-30f4-ea11-b882-24ee9a37d45c",-73960093,40677100,"P.S. 22 - BROOKLYN","443 ST MARKS AVENUE"
2,0,2,"35767649-31f4-ea11-b882-24ee9a37d45c","Lower East Side Preparatory High School - M515 - M025 - 01M515 - 145 Stanton Street","29767649-31f4-ea11-b882-24ee9a37d45c",-73986038,40720040,"J.H.S. 25 - MANHATTAN","145 Stanton Street"
1,0,1,"e3315367-30f4-ea11-b882-24ee9a37d45c","P.S. 138 Brooklyn - K138 - K138 - 17K138 - 760 PROSPECT PLACE","e4315367-30f4-ea11-b882-24ee9a37d45c",-73951559,40673943,"P.S. 138 - BROOKLYN","760 PROSPECT PLACE"
1,0,1,"622b3eee-30f4-ea11-b882-24ee9a37d45c","Urban Action Academy - K642 - K500 - 18K642 - 1600 ROCKAWAY PARKWAY","5e2b3eee-30f4-ea11-b882-24ee9a37d45c",-73898601,40640543,"CANARSIE HS - K","1600 ROCKAWAY PARKWAY"
10,7,3,"b572c880-32f4-ea11-b882-24ee9a37d45c","P.S. Q016 The Nancy DeBenedittis School - Q016 - Q721 - 24Q016 - 41-15 104 STREET","b672c880-32f4-ea11-b882-24ee9a37d45c",-73860547,40748996,"P.S. 16 (OLD Q721 SPED) - QUEENS","41-15 104 STREET"
1,0,1,"45416e00-31f4-ea11-b882-24ee9a37d45c","District 20 Pre-K Center - K768 - K678 - 20K768 - 1423 62ND STREET","46416e00-31f4-ea11-b882-24ee9a37d45c",-73996423,40625978,"PRE-K CENTER @62ND STREET - BROOKLYN","1423 62ND STREET"
3,1,2,"bbba3c50-33f4-ea11-b882-24ee9a37d45c","Comprehensive Model School Project M.S. 327 - X327 - X240 - 09X327 - 1501 JEROME AVENUE","baba3c50-33f4-ea11-b882-24ee9a37d45c",-73916084,40842503,"DOE NEW SETTLEMENT COMMUNITY CAMPUS - X","1501 JEROME AVENUE"
1,1,0,"3e0b210d-33f4-ea11-b882-24ee9a37d45c","I.S. X303 Leadership & Community Service - X303 - X082 - 09X303 - 1700 MACOMBS ROAD","3f0b210d-33f4-ea11-b882-24ee9a37d45c",-73915217,40849416,"I.S. 232 - BRONX","1700 MACOMBS ROAD"
4,2,2,"24b4977a-32f4-ea11-b882-24ee9a37d45c","Middle College High School at LaGuardia Community College - Q520 - Q520 - 24Q520 - 45-35 VAN DAM STREET","22b4977a-32f4-ea11-b882-24ee9a37d45c",-73933316,40743253,"MIDDLE COLLEGE CAMPUS - QUEENS","45-35 VAN DAM STREET"
1,1,0,"7407e99e-31f4-ea11-b882-24ee9a37d45c","Jacqueline Kennedy Onassis High School - M529 - M486 - 02M529 - 120 WEST 46 STREET","7507e99e-31f4-ea11-b882-24ee9a37d45c",-73983460,40757626,"J. K. ONASSIS HS FOR INT CAREERS-M","120 WEST 46 STREET"
1,1,0,"13ff3d8d-33f4-ea11-b882-24ee9a37d45c","P.S. 205 Fiorello LaGuardia - X205 - X864 - 10X205 - 2375 SOUTHERN BOULEVARD","14ff3d8d-33f4-ea11-b882-24ee9a37d45c",-73882372,40853238,"P.S. 205B (ECF) - BRONX","2375 SOUTHERN BOULEVARD"
1,1,0,"bf315367-30f4-ea11-b882-24ee9a37d45c","P.S. 123 Suydam - K123 - K123 - 32K123 - 100 IRVING AVENUE","bb315367-30f4-ea11-b882-24ee9a37d45c",-73922388,40704076,"P.S. 123 - BROOKLYN","100 IRVING AVENUE"
5,5,0,"5707e99e-31f4-ea11-b882-24ee9a37d45c","Institute for Collaborative Education - M407 - M475 - 02M407 - 345 East 15th Street","5607e99e-31f4-ea11-b882-24ee9a37d45c",-73982590,40732665,"HEALTH PROFESSIONS HS (OL STY) - M","345 East 15th Street"
1,0,1,"270b210d-33f4-ea11-b882-24ee9a37d45c","P.S. 195 - X195 - X077 - 12X195 - 1250 WARD AVENUE","230b210d-33f4-ea11-b882-24ee9a37d45c",-73877305,40830811,"P.S. 195 - BRONX","1250 WARD AVENUE"
3,0,3,"e4f57030-30f4-ea11-b882-24ee9a37d45c","Ronald Edmonds Learning Center II - K484 - K012 - 17K484 - 430 HOWARD AVENUE","def57030-30f4-ea11-b882-24ee9a37d45c",-73920095,40673124,"P.S. 12 - BROOKLYN","430 HOWARD AVENUE"
1,1,0,"aaab074a-33f4-ea11-b882-24ee9a37d45c","Urban Institute of Mathematics - X371 - X192 - 08X371 - 650 HOLLYWOOD AVENUE","078b0044-33f4-ea11-b882-24ee9a37d45c",-73818083,40826794,"I.S. 192 - BRONX","650 HOLLYWOOD AVENUE"
7,3,4,"84476368-32f4-ea11-b882-24ee9a37d45c","Long Island City High School - Q450 - Q452 - 30Q450 - 14-30 BROADWAY","81476368-32f4-ea11-b882-24ee9a37d45c",-73933907,40765881,"LONG ISLAND CITY HS(NEW)-Q","14-30 BROADWAY"
1,1,0,"df9aeff9-49fb-ea11-b883-24ee9a37d459","Imagine Early Learning Center @ the Louis Green and Evely Green Davis Child Care Center - MANH - MASX -  - 60-62 E 97TH STREET","e09aeff9-49fb-ea11-b883-24ee9a37d459",-73952972,40787363,"Imagine Early Learning Center","60-62 E 97TH STREET"
1,1,0,"380d6d19-33f4-ea11-b882-24ee9a37d45c","P.S. 105 Sen Abraham Bernstein - X105 - X105 - 11X105 - 725 Brady Avenue","390d6d19-33f4-ea11-b882-24ee9a37d45c",-73866264,40853075,"P.S. 105 - BRONX","725 Brady Avenue"
3,0,3,"a2d810ab-31f4-ea11-b882-24ee9a37d45c","Manhattan Academy For Arts & Language - M427 - M620 - 02M427 - 111 EAST 33RD STREET","a0d810ab-31f4-ea11-b882-24ee9a37d45c",-73981070,40746510,"NORMAN THOMAS HS (ECF) - MANHATTAN","111 EAST 33RD STREET"
1,0,1,"db454b50-32f4-ea11-b882-24ee9a37d45c","M.S. 358 - Q358 - Q314 - 28Q358 - 88-08 164TH STREET","d5454b50-32f4-ea11-b882-24ee9a37d45c",-73797981,40708698,"P.S./ I.S. 314 - Queens","88-08 164TH STREET"
1,0,1,"4fa10a44-32f4-ea11-b882-24ee9a37d45c","P.S./I.S. 268 - Q268 - Q268 - 29Q268 - 92-07 175 STREET","4ea10a44-32f4-ea11-b882-24ee9a37d45c",-73785210,40707648,"P.S. 268 - QUEENS","92-07 175 STREET"
1,1,0,"1fa198c3-30f4-ea11-b882-24ee9a37d45c","Sunset Park Avenues Elementary School - K516 - K333 - 15K516 - 4222 4th Avenue","20a198c3-30f4-ea11-b882-24ee9a37d45c",-74008106,40650793,"P.S. 516 SUNSET PARK AVENUES ELEMENTARY SCHOOL - B","4222 4th Avenue"
4,1,3,"33e61462-31f4-ea11-b882-24ee9a37d45c","M.S. 324 - Patria Mirabal - M324 - M090 - 06M324 - 21 JUMEL PLACE","2ce61462-31f4-ea11-b882-24ee9a37d45c",-73935815,40839139,"I.S. 90 - MANHATTAN","21 JUMEL PLACE"
1,0,1,"db17b7f4-32f4-ea11-b882-24ee9a37d45c","P.S. 168 - X168 - X020 - 75X168 - 3050 WEBSTER AVENUE","d817b7f4-32f4-ea11-b882-24ee9a37d45c",-73878731,40869482,"P.S. 20 - BRONX","3050 WEBSTER AVENUE"
3,3,0,"546e70b7-31f4-ea11-b882-24ee9a37d45c","Millennium High School - M418 - M824 - 02M418 - 75 BROAD STREET","760c1bb1-31f4-ea11-b882-24ee9a37d45c",-74011202,40704697,"MILLENNIUM HS - MANHATTAN","75 BROAD STREET"
3,1,2,"980e6e25-32f4-ea11-b882-24ee9a37d45c","P.S. 176 Cambria Heights - Q176 - Q176 - 29Q176 - 120-45 235 Street","990e6e25-32f4-ea11-b882-24ee9a37d45c",-73729226,40684987,"P.S. 176 - QUEENS","120-45 235 Street"
1,1,0,"009c4c1f-32f4-ea11-b882-24ee9a37d45c","P.S. 162 John Golden - Q162 - Q162 - 26Q162 - 201-02 53 AVENUE","019c4c1f-32f4-ea11-b882-24ee9a37d45c",-73776576,40748405,"P.S. 162 - QUEENS","201-02 53 AVENUE"
1,1,0,"9072c880-32f4-ea11-b882-24ee9a37d45c","Eagle Academy for Young Men III - Q327 - Q633 - 29Q327 - 171-10 Linden Boulevard","9172c880-32f4-ea11-b882-24ee9a37d45c",-73778924,40691720,"EAGLE ACADEMY - QUEENS","171-10 Linden Boulevard"
2,1,1,"40474313-33f4-ea11-b882-24ee9a37d45c","P.S. 097 Bronx - X097 - X097 - 11X097 - 1375 Mace Avenue","41474313-33f4-ea11-b882-24ee9a37d45c",-73846768,40863524,"P.S. 97 - BRONX","1375 Mace Avenue"
1,0,1,"693cbf01-ebf6-ea11-b883-24ee9a37d459","P.S. X017 - X017 - X184 - 75X017 - 778 FOREST AVENUE","f88a0044-33f4-ea11-b882-24ee9a37d45c",-73905389,40818703,"I.S. 184 - BRONX","778 FOREST AVENUE"
3,0,3,"fa77931f-33f4-ea11-b882-24ee9a37d45c","Academy For Personal Leadership And Excellence - X363 - X115 - 10X363 - 120 EAST 184 STREET","5b0d6d19-33f4-ea11-b882-24ee9a37d45c",-73900490,40859496,"I.S. 399 (OLD X HS/X115) - BRONX","120 EAST 184 STREET"
1,0,1,"a4d810ab-31f4-ea11-b882-24ee9a37d45c","Murray Hill Academy - M432 - M620 - 02M432 - 111 EAST 33RD STREET","a0d810ab-31f4-ea11-b882-24ee9a37d45c",-73981070,40746510,"NORMAN THOMAS HS (ECF) - MANHATTAN","111 EAST 33RD STREET"
1,0,1,"499587f5-ebf6-ea11-b883-24ee9a37d459","P.S. X017 - X017 - X161 - 75X017 - 628 TINTON AVENUE","ff2dd53d-33f4-ea11-b882-24ee9a37d45c",-73905233,40814168,"P.S. 161 - BRONX","628 TINTON AVENUE"
4,1,3,"0506003e-32f4-ea11-b882-24ee9a37d45c","P.S. 229 Emanuel Kaplan - Q229 - Q229 - 24Q229 - 67-25 51 ROAD","0106003e-32f4-ea11-b882-24ee9a37d45c",-73897108,40734682,"P.S. 229 - QUEENS","67-25 51 ROAD"
1,0,1,"15497593-33f4-ea11-b882-24ee9a37d45c","P.S. 9 Ryer Avenue Elementary School - X009 - X930 - 10X009 - 230 EAST 183 STREET","16497593-33f4-ea11-b882-24ee9a37d45c",-73898821,40856440,"P.S. 9 TEMP. C.R. BLDG. - X","230 EAST 183 STREET"
3,1,2,"1f7eed06-32f4-ea11-b882-24ee9a37d45c","P.S. 091 Richard Arkwright - Q091 - Q091 - 24Q091 - 68-10 CENTRAL AVE","207eed06-32f4-ea11-b882-24ee9a37d45c",-73883995,40703503,"P.S. 91 - QUEENS","68-10 CENTRAL AVE"
1,0,1,"1e9ebaee-32f4-ea11-b882-24ee9a37d45c","P.S. 9 Ryer Avenue Elementary School - X009 - X009 - 10X009 - 230 EAST 183 STREET","169ebaee-32f4-ea11-b882-24ee9a37d45c",-73898821,40856440,"P.S. 9 (OLD 115) - BRONX","230 EAST 183 STREET"
2,1,1,"6a9d7c62-33f4-ea11-b882-24ee9a37d45c","Bronx High School for Writing and Communication Arts - X253 - X425 - 11X253 - 800 EAST GUN HILL ROAD","699d7c62-33f4-ea11-b882-24ee9a37d45c",-73861649,40875172,"EVANDER CHILDS HS - X","800 EAST GUN HILL ROAD"
2,1,1,"39474313-33f4-ea11-b882-24ee9a37d45c","P.S. 095 Sheila Mencher - X095 - X095 - 10X095 - 3961 HILLMAN AVENUE","34474313-33f4-ea11-b882-24ee9a37d45c",-73891664,40883049,"P.S. 95 - BRONX","3961 HILLMAN AVENUE"
1,1,0,"ceb36d80-30f4-ea11-b882-24ee9a37d45c","P.S. 185 Walter Kassenbrock - K185 - K185 - 20K185 - 8601 RIDGE BOULEVARD","cfb36d80-30f4-ea11-b882-24ee9a37d45c",-74033429,40623598,"P.S. 185 - BROOKLYN","8601 RIDGE BOULEVARD"
2,0,2,"3088e6db-30f4-ea11-b882-24ee9a37d45c","Brooklyn Technical High School - K430 - K430 - 13K430 - 29 FT GREENE PLACE","3188e6db-30f4-ea11-b882-24ee9a37d45c",-73976435,40688896,"BROOKLYN TECH HS - K","29 FT GREENE PLACE"
1,1,0,"c1ab074a-33f4-ea11-b882-24ee9a37d45c","P.S. 205 Fiorello LaGuardia - X205 - X205 - 10X205 - 2475 Southern Boulevard","c2ab074a-33f4-ea11-b882-24ee9a37d45c",-73881753,40855759,"P.S. 205A (ECF) - BRONX","2475 Southern Boulevard"
1,1,0,"72d92255-30f4-ea11-b882-24ee9a37d45c","P.S. 086 The Irvington - K086 - K086 - 32K086 - 220 IRVING AVENUE","71d92255-30f4-ea11-b882-24ee9a37d45c",-73917804,40700595,"P.S. 86 - BROOKLYN","220 IRVING AVENUE"
1,1,0,"580d6d19-33f4-ea11-b882-24ee9a37d45c","Leaders of Tomorrow - X370 - X113 - 11X370 - 3710 BARNES AVENUE","520d6d19-33f4-ea11-b882-24ee9a37d45c",-73860126,40880649,"I.S. 113 - BRONX","3710 BARNES AVENUE"
1,1,0,"1c7eed06-32f4-ea11-b882-24ee9a37d45c","P.S. 090 Horace Mann - Q090 - Q090 - 27Q090 - 86-50 109 STREET","1d7eed06-32f4-ea11-b882-24ee9a37d45c",-73839517,40696653,"P.S. 90 - QUEENS","86-50 109 STREET"
4,2,2,"dae0838c-31f4-ea11-b882-24ee9a37d45c","M.S. 297 - M297 - M323 - 02M297 - 75 MORTON STREET","d8e0838c-31f4-ea11-b882-24ee9a37d45c",-74007192,40731006,"75 Morton Campus","75 MORTON STREET"
3,1,2,"c2fc24e8-31f4-ea11-b882-24ee9a37d45c","World Journalism Preparatory: A College Board School - Q285 - Q025 - 25Q285 - 34-65 192 STREET","befc24e8-31f4-ea11-b882-24ee9a37d45c",-73789365,40764884,"J.H.S. 25 - QUEENS","34-65 192 STREET"
1,1,0,"79e2635c-32f4-ea11-b882-24ee9a37d45c","Rockaway Park High School for Environmental Sustainability - Q324 - Q410 - 27Q324 - 100-00 BEACH CHANNEL DRIVE","71e2635c-32f4-ea11-b882-24ee9a37d45c",-73825317,40586012,"Beach Channel Educational Campus","100-00 BEACH CHANNEL DRIVE"
3,1,2,"7441e65b-31f4-ea11-b882-24ee9a37d45c","P.S. 076 A. Philip Randolph - M076 - M076 - 03M076 - 220 WEST 121 STREET","7241e65b-31f4-ea11-b882-24ee9a37d45c",-73951451,40806534,"P.S. 76 - MANHATTAN","220 WEST 121 STREET"
4,2,2,"4de61462-31f4-ea11-b882-24ee9a37d45c","Innovation Charter High School - M433 - M099 - 84M433 - 410 EAST 100 STREET","3de61462-31f4-ea11-b882-24ee9a37d45c",-73942154,40785107,"I.S. 99 - MANHATTAN","410 EAST 100 STREET"
1,0,1,"e8d27c6d-30f4-ea11-b882-24ee9a37d45c","P.S. 150 Christopher - K150 - K150 - 23K150 - 364 SACKMAN STREET","e6d27c6d-30f4-ea11-b882-24ee9a37d45c",-73905140,40668768,"P.S. 150 - BROOKLYN","364 SACKMAN STREET"
1,1,0,"a29c11e8-30f4-ea11-b882-24ee9a37d45c","High School for Youth and Community Development at Erasmus - K537 - K465 - 17K537 - 911 FLATBUSH AVENUE","9d9c11e8-30f4-ea11-b882-24ee9a37d45c",-73957173,40649602,"ERASMUS HALL CAMPUS - K","911 FLATBUSH AVENUE"
1,1,0,"2d6e3d68-31f4-ea11-b882-24ee9a37d45c","P.S. 38 Roberto Clemente - M038 - M121 - 04M038 - 232 EAST 103 STREET","2b6e3d68-31f4-ea11-b882-24ee9a37d45c",-73944762,40788668,"P.S. 38 (OLD M121) - MANHATTAN","232 EAST 103 STREET"
1,0,1,"8e72d598-49fb-ea11-b883-24ee9a37d459","ROSA VEGA - APT1H - XBIV - XBIV -  - 1025 GERARD AVENUE","8f72d598-49fb-ea11-b883-24ee9a37d459",-73923092,40831238,"1025 GERARD AVENUE","1025 GERARD AVENUE"
2,1,1,"37767649-31f4-ea11-b882-24ee9a37d45c","P.S. 138 - M138 - M030 - 75M138 - 144-176 EAST 128 STREET","38767649-31f4-ea11-b882-24ee9a37d45c",-73935461,40805653,"P.S. 30 - MANHATTAN","144-176 EAST 128 STREET"
1,1,0,"6b283fb1-30f4-ea11-b882-24ee9a37d45c","The Gregory Jocko Jackson School of Sports, Art, and Technology - K284 - K284 - 23K284 - 213 OSBORN STREET","fd201dab-30f4-ea11-b882-24ee9a37d45c",-73907634,40666942,"P.S. 284 - BROOKLYN","213 OSBORN STREET"
2,0,2,"b8315367-30f4-ea11-b882-24ee9a37d45c","P.S. 368 - K368 - K120 - 75K368 - 18 Beaver Street","b2315367-30f4-ea11-b882-24ee9a37d45c",-73937888,40700819,"P.S. 120 - BROOKLYN","18 Beaver Street"
1,0,1,"87e03d56-33f4-ea11-b882-24ee9a37d45c","School for Excellence - X404 - X400 - 09X404 - 1110 BOSTON ROAD","82e03d56-33f4-ea11-b882-24ee9a37d45c",-73903920,40827455,"MORRIS HS - X","1110 BOSTON ROAD"
3,1,2,"90c280bd-31f4-ea11-b882-24ee9a37d45c","Harvest Collegiate High School - M534 - M883 - 02M534 - 34 WEST 14 STREET","8fc280bd-31f4-ea11-b882-24ee9a37d45c",-73995731,40736416,"LEGACY HS FOR INTEGR. STUDIES - M","34 WEST 14 STREET"
3,2,1,"64bc9674-32f4-ea11-b882-24ee9a37d45c","Richmond Hill High School - Q475 - Q475 - 27Q475 - 89-30 114 Street","3002926e-32f4-ea11-b882-24ee9a37d45c",-73833815,40695171,"RICHMOND HILL HS - Q","89-30 114 Street"
2,1,1,"85283fb1-30f4-ea11-b882-24ee9a37d45c","J.H.S. 291 Roland Hayes - K291 - K291 - 32K291 - 231 PALMETTO STREET","83283fb1-30f4-ea11-b882-24ee9a37d45c",-73915217,40695875,"I.S. 291 - BROOKLYN","231 PALMETTO STREET"
3,2,1,"9553dd74-33f4-ea11-b882-24ee9a37d45c","University Heights Secondary School - X495 - X470 - 07X495 - 701 ST. ANNS AVENUE","9253dd74-33f4-ea11-b882-24ee9a37d45c",-73911633,40818041,"SOUTH BRONX EDUCATIONAL CAMPUS (OLD 38) - X","701 ST. ANNS AVENUE"
2,1,1,"e6454b50-32f4-ea11-b882-24ee9a37d45c","Queens Explorers Elementary School - Q316 - Q316 - 27Q316 - 90-07 101ST AVENUE","e7454b50-32f4-ea11-b882-24ee9a37d45c",-73850123,40683112,"THE OZONE PARK EDUCATIONAL CAMPUS - QUEENS","90-07 101ST AVENUE"
1,1,0,"209ebaee-32f4-ea11-b882-24ee9a37d45c","P.S. X015 Institute for Environmental Learning - X015 - X015 - 10X015 - 2195 ANDREWS AVENUE","219ebaee-32f4-ea11-b882-24ee9a37d45c",-73909763,40859243,"P.S. 15 - BRONX","2195 ANDREWS AVENUE"
1,0,1,"5d9f4974-31f4-ea11-b882-24ee9a37d45c","P.S. 153 Adam Clayton Powell - M153 - M153 - 06M153 - 1750 AMSTERDAM AVENUE","589f4974-31f4-ea11-b882-24ee9a37d45c",-73947599,40826514,"P.S. 153 - MANHATTAN","1750 AMSTERDAM AVENUE"
1,0,1,"1b78931f-33f4-ea11-b882-24ee9a37d45c","P.S. 121 Throop - X121 - X121 - 11X121 - 2750 THROOP AVENUE","1c78931f-33f4-ea11-b882-24ee9a37d45c",-73850510,40866474,"P.S. 121 - BRONX","2750 THROOP AVENUE"
1,1,0,"f2c669c3-8c3d-eb11-b88a-24ee9a37d45c","BAMBI LAND GROUP FAMILY DAYCARE - KDSH - KDFR -  - 735 THOMAS BOYLAND ST","f3c669c3-8c3d-eb11-b88a-24ee9a37d45c",-73911536,0,"735 THOMAS BOYLAND ST","735 THOMAS BOYLAND ST"
1,1,0,"af9c11e8-30f4-ea11-b882-24ee9a37d45c","Brooklyn Institute for Liberal Arts - K745 - K470 - 17K745 - 600 KINGSTON AVENUE","aa9c11e8-30f4-ea11-b882-24ee9a37d45c",-73943839,40658671,"GEORGE W. WINGATE HS - K","600 KINGSTON AVENUE"
1,0,1,"51953aac-ebf6-ea11-b883-24ee9a37d459","The Riverview School - Q277 - Q404 - 75Q277 - 1-50 51ST AVENUE","65e2635c-32f4-ea11-b882-24ee9a37d45c",-73959183,40742964,"HUNTERS POINT CAMPUS - QUEENS","1-50 51ST AVENUE"
1,0,1,"950e6e25-32f4-ea11-b882-24ee9a37d45c","P.S. 175 The Lynn Gross Discovery School - Q175 - Q175 - 28Q175 - 64-35 102 STREET","960e6e25-32f4-ea11-b882-24ee9a37d45c",-73852210,40731016,"P.S. 175 - QUEENS","64-35 102 STREET"
1,1,0,"e2b36d80-30f4-ea11-b882-24ee9a37d45c","P.S. 191 Paul Robeson - K191 - K191 - 17K191 - 1600 PARK PLACE","e0b36d80-30f4-ea11-b882-24ee9a37d45c",-73924127,40671730,"P.S. 191 - BROOKLYN","1600 PARK PLACE"
1,0,1,"7af4a0ef-eaf6-ea11-b883-24ee9a37d459","Brooklyn Academy High School - K553 - K458 - 13K553 - 832 MARCY AVENUE","050ae2e1-30f4-ea11-b882-24ee9a37d45c",-73947873,40684654,"BOYS HS (OLD) - K","832 MARCY AVENUE"
2,0,2,"2f06003e-32f4-ea11-b882-24ee9a37d45c","The Active Learning Elementary School - Q244 - Q244 - 25Q244 - 137-20 FRANKLIN AVENUE","2b06003e-32f4-ea11-b882-24ee9a37d45c",-73826192,40754483,"P.S. 244 ECC (@ FRANKLIN AVE) - Q","137-20 FRANKLIN AVENUE"
1,0,1,"f5c4bd60-4afb-ea11-b883-24ee9a37d459","Happy MaryAnn Day School - QBHP - QBHP -  - 132-18 41st Avenue","f6c4bd60-4afb-ea11-b883-24ee9a37d459",-73832993,40756623,"Happy MaryAnn Day School","132-18 41st Avenue"
4,4,0,"9fa9d9c3-32f4-ea11-b882-24ee9a37d45c","Marsh Avenue School for Expeditionary Learning - R063 - R043 - 31R063 - 100 ESSEX DRIVE","a0a9d9c3-32f4-ea11-b882-24ee9a37d45c",-74159343,40581958,"JEROME PARKER CAMPUS - S.I.","100 ESSEX DRIVE"
1,0,1,"16af1f69-ebf6-ea11-b883-24ee9a37d459","Teachers College Community School - M517 - M484 - 05M517 - 223-233 WEST 132 STREET","6f07e99e-31f4-ea11-b882-24ee9a37d45c",-73946027,40814020,"Teacher’s College Community School Annex – Manhatt","223-233 WEST 132 STREET"
1,1,0,"20a6ba98-31f4-ea11-b882-24ee9a37d45c","Academy for Software Engineering - M546 - M460 - 02M546 - 40 IRVING PLACE","16a6ba98-31f4-ea11-b882-24ee9a37d45c",-73987064,40735361,"WASHINGTON IRVING HS - MANHATTAN","40 IRVING PLACE"
1,0,1,"e4e0838c-31f4-ea11-b882-24ee9a37d45c","Sixth Avenue Elementary School - M340 - M340 - 02M340 - 64 WEST 17 STREET","e3e0838c-31f4-ea11-b882-24ee9a37d45c",-73995534,40739145,"THE SIXTH AVENUE EDUCATIONAL CAMPUS - MANHATTAN","64 WEST 17 STREET"
3,0,3,"7841e65b-31f4-ea11-b882-24ee9a37d45c","P.S. M079 - Horan School - M079 - M079 - 75M079 - 55 East 120 Street","7741e65b-31f4-ea11-b882-24ee9a37d45c",-73942009,40802547,"P.S. 79 (MULT. HANDICAP) - M","55 East 120 Street"
4,2,2,"837e21a6-ebf6-ea11-b883-24ee9a37d459","Robert E. Peary School - Q075 - Q276 - 75Q075 - 108-29 155 STREET","0ec73b4a-32f4-ea11-b882-24ee9a37d45c",-73796358,40693736,"THE WILLIAM WORDSWORTH EDUCATIONAL COMPLEX","108-29 155 STREET"
1,0,1,"a7778cb8-ebf6-ea11-b883-24ee9a37d459","The Ezra Jack Keats Pre-K Center - Q335 - Q608 - 28Q335 - 83-30 KEW GARDENS ROAD","3fb4977a-32f4-ea11-b882-24ee9a37d45c",-73830193,40713425,"PRE-K CENTER @KEW GARDENS ROAD - QUEENS","83-30 KEW GARDENS ROAD"
1,0,1,"52ef7338-ebf6-ea11-b883-24ee9a37d459","Pathways to Graduation - Q950 - K458 - 79Q950 - 832 MARCY AVENUE","050ae2e1-30f4-ea11-b882-24ee9a37d45c",-73947873,40684654,"BOYS HS (OLD) - K","832 MARCY AVENUE"
3,0,3,"9f32c3fb-eaf6-ea11-b883-24ee9a37d459","Robert E. Peary School - Q075 - Q075 - 75Q075 - 16-66 HANCOCK STREET","cae8ce00-32f4-ea11-b882-24ee9a37d45c",-73904888,40698699,"P.S. 75 (R PERRY SCHOOL)-QUEENS","16-66 HANCOCK STREET"
2,0,2,"2e9ebaee-32f4-ea11-b882-24ee9a37d45c","P.S. 291 - X291 - X015 - 10X291 - 2195 ANDREWS AVENUE","219ebaee-32f4-ea11-b882-24ee9a37d45c",-73909763,40859243,"P.S. 15 - BRONX","2195 ANDREWS AVENUE"
1,1,0,"410d6d19-33f4-ea11-b882-24ee9a37d45c","Mott Hall III - X128 - X110 - 09X128 - 580 CROTONA PARK SOUTH","420d6d19-33f4-ea11-b882-24ee9a37d45c",-73900654,40834470,"P.S. 110 - BRONX","580 CROTONA PARK SOUTH"
1,0,1,"8b32c3fb-eaf6-ea11-b883-24ee9a37d459","Teachers College Community School - M517 - M916 - 05M517 - 168 MORNINGSIDE AVENUE","f0ed94c3-31f4-ea11-b882-24ee9a37d45c",-73953317,40812428,"TEACHERS COLLEGE COMMUNITY SCHOOL - MANHATTAN","168 MORNINGSIDE AVENUE"
5,4,1,"ed1aad3c-30f4-ea11-b882-24ee9a37d45c","P.S. 029 John M. Harrigan - K029 - K029 - 15K029 - 425 HENRY STREET","ee1aad3c-30f4-ea11-b882-24ee9a37d45c",-73997447,40686843,"P.S. 29 - BROOKLYN","425 HENRY STREET"
2,0,2,"339ebaee-32f4-ea11-b882-24ee9a37d45c","P.S. 016 Wakefield - X016 - X016 - 11X016 - 4550 CARPENTER AVENUE","349ebaee-32f4-ea11-b882-24ee9a37d45c",-73854231,40902311,"P.S. 16 - BRONX","4550 CARPENTER AVENUE"
3,3,0,"aeab074a-33f4-ea11-b882-24ee9a37d45c","P.S. 211 - X211 - X193 - 12X211 - 1919 PROSPECT AVENUE","afab074a-33f4-ea11-b882-24ee9a37d45c",-73890145,40843705,"P.S. 211 - BRONX","1919 PROSPECT AVENUE"
1,1,0,"14af0313-32f4-ea11-b882-24ee9a37d45c","P.S. 133 Queens - Q133 - Q133 - 26Q133 - 248-05 86 AVENUE","15af0313-32f4-ea11-b882-24ee9a37d45c",-73717819,40732458,"P.S. 133 - QUEENS","248-05 86 AVENUE"
1,1,0,"848946f4-31f4-ea11-b882-24ee9a37d45c","P.S. 58 - The School of Heroes - Q058 - Q058 - 24Q058 - 72-24 GRAND AVENUE","808946f4-31f4-ea11-b882-24ee9a37d45c",-73890638,40728517,"P.S. 58 - QUEENS","72-24 GRAND AVENUE"
5,4,1,"13ba8b86-30f4-ea11-b882-24ee9a37d45c","P.S. 206 Joseph F Lamb - K206 - K206 - 22K206 - 2200 GRAVESEND NECK ROAD","14ba8b86-30f4-ea11-b882-24ee9a37d45c",-73948453,40596876,"P.S. 206 - BROOKLYN","2200 GRAVESEND NECK ROAD"
1,0,1,"47474313-33f4-ea11-b882-24ee9a37d45c","Bronx Envision Academy - X511 - X098 - 12X511 - 1619 BOSTON ROAD","3c474313-33f4-ea11-b882-24ee9a37d45c",-73890591,40836245,"I.S. 98 - BRONX","1619 BOSTON ROAD"
1,1,0,"caba3c50-33f4-ea11-b882-24ee9a37d45c","Jonas Bronck Academy - X228 - X283 - 10X228 - 400 EAST FORDHAM ROAD","cbba3c50-33f4-ea11-b882-24ee9a37d45c",-73891562,40860987,"Jonas Bronck Academy","400 EAST FORDHAM ROAD"
1,0,1,"fdce496e-31f4-ea11-b882-24ee9a37d45c","School of Earth Exploration and Discovery Harlem (SEED Harlem) - M371 - M129 - 05M371 - 425 WEST 130 STREET","fece496e-31f4-ea11-b882-24ee9a37d45c",-73952020,40814914,"P.S. 129 - MANHATTAN","425 WEST 130 STREET"
2,0,2,"7fe657bd-30f4-ea11-b882-24ee9a37d45c","P.S. 309 The George E. Wibecan Preparatory Academy - K309 - K309 - 16K309 - 794 MONROE STREET","7ee657bd-30f4-ea11-b882-24ee9a37d45c",-73924422,40688100,"P.S. 309 - BROOKLYN","794 MONROE STREET"
1,1,0,"e237fba4-31f4-ea11-b882-24ee9a37d45c","The Urban Assembly School for Emergency Management - M135 - M520 - 02M135 - 411 PEARL STREET","e037fba4-31f4-ea11-b882-24ee9a37d45c",-74000851,40711441,"MURRY BERGTRAUM HS (ECF) - M","411 PEARL STREET"
2,0,2,"5fbe7adc-32f4-ea11-b882-24ee9a37d45c","Concord High School - R470 - R470 - 31R470 - 109 RHINE AVENUE","60be7adc-32f4-ea11-b882-24ee9a37d45c",-74087072,40610620,"CONCORD HS (OLD 12) - S.I.","109 RHINE AVENUE"
1,0,1,"ae56635c-33f4-ea11-b882-24ee9a37d45c","New Visions AIM Charter High School II - X200 - X401 - 84X200 - 1010 REV. J. A. POLITE AVENUE","8ce03d56-33f4-ea11-b882-24ee9a37d45c",-73898265,40823124,"BRONX REGIONAL HS (OLD 133) - X","1010 REV. J. A. POLITE AVENUE"
2,0,2,"492b3eee-30f4-ea11-b882-24ee9a37d45c","High School of Telecommunication Arts and Technology - K485 - K485 - 20K485 - 350 67 STREET","bf9c11e8-30f4-ea11-b882-24ee9a37d45c",-74023419,40636721,"TELECOM. ARTS & TECH. - K","350 67 STREET"
3,3,0,"16a198c3-30f4-ea11-b882-24ee9a37d45c","P.S./I.S. 30 Mary White Ovington - K030 - K331 - 20K030 - 7002 4TH AVENUE","15a198c3-30f4-ea11-b882-24ee9a37d45c",-74023950,40633598,"P.S./I.S.30 MARY WHITE OVINGTON - BROOKLYN","7002 4TH AVENUE"
1,0,1,"43de5eb7-30f4-ea11-b882-24ee9a37d45c","P.S. 299 Thomas Warren Field - K299 - K299 - 32K299 - 88 WOODBINE STREET","44de5eb7-30f4-ea11-b882-24ee9a37d45c",-73917899,40690755,"P.S. 299 - BROOKLYN","88 WOODBINE STREET"
1,1,0,"919c11e8-30f4-ea11-b882-24ee9a37d45c","Cyberarts Studio Academy - K463 - K460 - 15K463 - 237 7 AVENUE","929c11e8-30f4-ea11-b882-24ee9a37d45c",-73978580,40669255,"John Jay Educational Campus","237 7 AVENUE"
1,0,1,"d917b7f4-32f4-ea11-b882-24ee9a37d45c","PS/MS 20 P.O.George J. Werdann, III - X020 - X020 - 10X020 - 3050 WEBSTER AVENUE","d817b7f4-32f4-ea11-b882-24ee9a37d45c",-73878731,40869482,"P.S. 20 - BRONX","3050 WEBSTER AVENUE"
2,0,2,"cbfab455-31f4-ea11-b882-24ee9a37d45c","The Children's Workshop School - M361 - M061 - 01M361 - 610 EAST 12 STREET","c8fab455-31f4-ea11-b882-24ee9a37d45c",-73978254,40727537,"P.S. 61 - MANHATTAN","610 EAST 12 STREET"
1,1,0,"aa28a20c-31f4-ea11-b882-24ee9a37d45c","P.S. 089 Cypress Hills - K089 - K814 - 19K089 - 265 WARWICK STREET","a928a20c-31f4-ea11-b882-24ee9a37d45c",-73886712,40677707,"CYPRESS HILLS COMMUNITY SCHOOL - BROOKLYN","265 WARWICK STREET"
2,0,2,"60507380-31f4-ea11-b882-24ee9a37d45c","P.S. 138 - M138 - M189 - 75M138 - 2580 AMSTERDAM AVENUE","5f507380-31f4-ea11-b882-24ee9a37d45c",-73928048,40853045,"P.S. 189 - MANHATTAN","2580 AMSTERDAM AVENUE"
1,0,1,"96d810ab-31f4-ea11-b882-24ee9a37d45c","The High School of Fashion Industries - M600 - M600 - 02M600 - 225 WEST 24 STREET","94d810ab-31f4-ea11-b882-24ee9a37d45c",-73996354,40745677,"FASHION INDUSTRIES VOC HS - M","225 WEST 24 STREET"
2,1,1,"16a31781-33f4-ea11-b882-24ee9a37d45c","Bronx Leadership Academy II High School - X527 - X790 - 07X527 - 730 CONCOURSE VILLAGE WEST","0ea31781-33f4-ea11-b882-24ee9a37d45c",-73922366,40821828,"MOTT HAVEN EDUCATIONAL CAMPUS - BRONX","730 CONCOURSE VILLAGE WEST"
